F41,F40,F43,F42,F45,F44,F140,F47,F141,F46,F142,F49,F143,F48,F126,F127,F128,F129,F50,F52,F51,F36,F130,F35,F131,F38,F132,F37,F133,F134,F39,F135,F136,F137,F138,F139,
6,0.0,0,1,5,7,27495,11488,391078,0.0021186517232864997,119131,789,0.0364935219113182,3799,25,2,5,32,16076,0.01690738535345433,7689,0,23,0,0.015657252526419512,0,740,0,297,139,0,1176,443,0.06376836079537176,241357,122226,
6,0.0,0,1,5,7,27495,11488,391078,0.0021186517232864997,119131,789,0.0364935219113182,3799,25,2,5,32,16076,0.01690738535345433,7689,0,23,0,0.015657252526419512,0,740,0,297,139,0,1176,443,0.06376836079537176,241357,122226,
6,0.0,0,1,5,7,27495,11488,391078,0.0021186517232864997,119131,789,0.0364935219113182,3799,2,5,0,7,16076,0.01690738535345433,7689,0,-3,0,0.017014971927635684,0,740,0,297,139,0,1176,443,0.06376836079537176,241357,122226,
6,0.0,0,1,5,7,27495,11488,391078,0.0021186517232864997,119131,789,0.0364935219113182,3799,2,5,0,7,16076,0.01690738535345433,7689,0,-3,0,0.017014971927635684,0,740,0,297,139,0,1176,443,0.06376836079537176,241357,122226,
6,0.0,0,1,5,7,27495,11488,391078,0.0021186517232864997,119131,789,0.0364935219113182,3799,140,3,0,143,16076,0.01690738535345433,7689,0,137,0,0.4198987453224741,0,740,0,297,139,0,1176,443,0.06376836079537176,241357,122226,
6,0.0,0,1,5,7,27495,11488,391078,0.0021186517232864997,119131,789,0.0364935219113182,3799,140,3,0,143,16076,0.01690738535345433,7689,0,137,0,0.4198987453224741,0,740,0,297,139,0,1176,443,0.06376836079537176,241357,122226,
6,0.0,0,1,5,7,27495,11488,391078,0.0021186517232864997,119131,789,0.0364935219113182,3799,140,3,0,143,16076,0.01690738535345433,7689,0,137,0,0.4198987453224741,0,740,0,297,139,0,1176,443,0.06376836079537176,241357,122226,
6,0.0,0,1,5,7,27495,11488,391078,0.0021186517232864997,119131,789,0.0364935219113182,3799,39,0,0,39,16076,0.01690738535345433,7689,0,39,0,0.18932038834951456,0,740,0,297,139,0,1176,443,0.06376836079537176,241357,122226,
6,0.012448132780082987,0,1,5,7,27495,11488,391078,0.0021186517232864997,119131,789,0.0364935219113182,3799,277,192,127,596,16076,0.01690738535345433,7689,1,85,2,0.04258938042156995,3,740,0,297,139,1,1176,443,0.06376836079537176,241357,122226,
6,0.01509433962264151,0,1,5,7,27495,11488,391078,0.0021186517232864997,119131,789,0.0364935219113182,3799,200,95,7,302,16076,0.01690738535345433,7689,0,105,4,0.024952985685528967,4,740,0,297,139,4,1176,443,0.06376836079537176,241357,122226,
13,0.0,16,11,2,40,27495,11488,391078,0.012019903485372322,119131,789,0.0364935219113182,3799,76,19,4,99,16076,0.01690738535345433,7689,0,57,0,0.11522611057547949,0,1286,0,187,59,0,1532,1099,0.042489600614697844,241357,122226,
13,0.0,16,11,2,40,27495,11488,391078,0.012019903485372322,119131,789,0.0364935219113182,3799,76,19,4,99,16076,0.01690738535345433,7689,0,57,0,0.11522611057547949,0,1286,0,187,59,0,1532,1099,0.042489600614697844,241357,122226,
13,0.18571428571428572,16,11,2,40,27495,11488,391078,0.012019903485372322,119131,789,0.0364935219113182,3799,170,32,25,227,16076,0.01690738535345433,7689,5,138,7,0.13859035841286088,20,1286,8,187,59,2,1532,1099,0.042489600614697844,241357,122226,
13,0.18571428571428572,16,11,2,40,27495,11488,391078,0.012019903485372322,119131,789,0.0364935219113182,3799,170,32,25,227,16076,0.01690738535345433,7689,5,138,7,0.13859035841286088,20,1286,8,187,59,2,1532,1099,0.042489600614697844,241357,122226,
13,0.18571428571428572,16,11,2,40,27495,11488,391078,0.012019903485372322,119131,789,0.0364935219113182,3799,170,32,25,227,16076,0.01690738535345433,7689,5,138,7,0.13859035841286088,20,1286,8,187,59,2,1532,1099,0.042489600614697844,241357,122226,
13,0.12408759124087591,16,11,2,40,27495,11488,391078,0.012019903485372322,119131,789,0.0364935219113182,3799,256,13,11,280,16076,0.01690738535345433,7689,5,243,4,0.0831236157580809,17,1286,8,187,59,-1,1532,1099,0.042489600614697844,241357,122226,
0,0.0,0,0,0,0,27495,11488,391078,0.0,119131,789,0.0364935219113182,3799,0,0,0,0,16076,0.01690738535345433,7689,0,0,0,0.0,0,0,0,0,0,0,0,0,0.0,241357,122226,
31,0.2857142857142857,0,51,-20,82,27495,11488,391078,0.02580921267131009,119131,789,0.0364935219113182,3799,285,213,62,560,16076,0.01690738535345433,7689,12,72,22,0.1506545193352358,34,1265,0,457,88,10,1810,808,0.09076015289101758,241357,122226,
31,0.2857142857142857,0,51,-20,82,27495,11488,391078,0.02580921267131009,119131,789,0.0364935219113182,3799,285,213,62,560,16076,0.01690738535345433,7689,12,72,22,0.1506545193352358,34,1265,0,457,88,10,1810,808,0.09076015289101758,241357,122226,
31,0.0,0,51,-20,82,27495,11488,391078,0.02580921267131009,119131,789,0.0364935219113182,3799,149,35,4,188,16076,0.01690738535345433,7689,0,114,0,0.030729506682025585,0,1265,0,457,88,0,1810,808,0.09076015289101758,241357,122226,
31,0.0,0,51,-20,82,27495,11488,391078,0.02580921267131009,119131,789,0.0364935219113182,3799,234,0,0,234,16076,0.01690738535345433,7689,0,234,0,0.65,0,1265,0,457,88,0,1810,808,0.09076015289101758,241357,122226,
31,0.0,0,51,-20,82,27495,11488,391078,0.02580921267131009,119131,789,0.0364935219113182,3799,234,0,0,234,16076,0.01690738535345433,7689,0,234,0,0.65,0,1265,0,457,88,0,1810,808,0.09076015289101758,241357,122226,
31,0.0,0,51,-20,82,27495,11488,391078,0.02580921267131009,119131,789,0.0364935219113182,3799,234,0,0,234,16076,0.01690738535345433,7689,0,234,0,0.65,0,1265,0,457,88,0,1810,808,0.09076015289101758,241357,122226,
31,0.0,0,51,-20,82,27495,11488,391078,0.02580921267131009,119131,789,0.0364935219113182,3799,234,0,0,234,16076,0.01690738535345433,7689,0,234,0,0.65,0,1265,0,457,88,0,1810,808,0.09076015289101758,241357,122226,
9,0.0,0,4,5,13,27495,11488,391078,0.006364531501330407,119131,789,0.0364935219113182,3799,52,35,0,87,16076,0.01690738535345433,7689,0,17,0,0.08486939321180331,0,3505,0,971,600,0,5076,2534,0.04465136137772993,241357,122226,
31,0.0,0,51,-20,82,27495,11488,391078,0.02580921267131009,119131,789,0.0364935219113182,3799,45,30,5,80,16076,0.01690738535345433,7689,0,15,0,0.04483287948386545,0,1265,0,457,88,0,1810,808,0.09076015289101758,241357,122226,
31,0.0,0,51,-20,82,27495,11488,391078,0.02580921267131009,119131,789,0.0364935219113182,3799,45,30,5,80,16076,0.01690738535345433,7689,0,15,0,0.04483287948386545,0,1265,0,457,88,0,1810,808,0.09076015289101758,241357,122226,
6,0.3723404255319149,27,2,4,35,27495,11488,391078,0.18617021276595744,119131,789,0.0364935219113182,3799,95,83,29,207,16076,0.01690738535345433,7689,2,12,6,0.06373206433299565,35,199,27,122,30,4,351,77,0.043973172571197,241357,122226,
6,0.0,27,2,4,35,27495,11488,391078,0.18617021276595744,119131,789,0.0364935219113182,3799,104,39,1,144,16076,0.01690738535345433,7689,0,65,0,0.024214280809398345,0,199,0,122,30,0,351,77,0.043973172571197,241357,122226,
6,0.0,27,2,4,35,27495,11488,391078,0.18617021276595744,119131,789,0.0364935219113182,3799,104,39,1,144,16076,0.01690738535345433,7689,0,65,0,0.024214280809398345,0,199,0,122,30,0,351,77,0.043973172571197,241357,122226,
6,0.0,27,2,4,35,27495,11488,391078,0.18617021276595744,119131,789,0.0364935219113182,3799,104,39,1,144,16076,0.01690738535345433,7689,0,65,0,0.024214280809398345,0,199,0,122,30,0,351,77,0.043973172571197,241357,122226,
19,0.14285714285714285,2,9,10,30,27495,11488,391078,0.025207248891459418,119131,789,0.0364935219113182,3799,180,4,0,184,16076,0.01690738535345433,7689,4,176,5,0.4285714285714286,9,2162,0,312,205,1,2679,1850,0.09667795327592942,241357,122226,
19,0.13157894736842105,2,9,10,30,27495,11488,391078,0.025207248891459418,119131,789,0.0364935219113182,3799,379,92,93,564,16076,0.01690738535345433,7689,0,287,4,0.18961334809180075,5,2162,1,312,205,4,2679,1850,0.09667795327592942,241357,122226,
19,0.0,2,9,10,30,27495,11488,391078,0.025207248891459418,119131,789,0.0364935219113182,3799,48,2,4,54,16076,0.01690738535345433,7689,0,46,0,0.04280765843069902,0,2162,0,312,205,0,2679,1850,0.09667795327592942,241357,122226,
19,0.0,2,9,10,30,27495,11488,391078,0.025207248891459418,119131,789,0.0364935219113182,3799,0,0,0,0,16076,0.01690738535345433,7689,0,0,0,0.0,0,2162,0,312,205,0,2679,1850,0.09667795327592942,241357,122226,
19,0.0,2,9,10,30,27495,11488,391078,0.025207248891459418,119131,789,0.0364935219113182,3799,179,6,0,185,16076,0.01690738535345433,7689,0,173,0,0.016490413877054168,0,2162,0,312,205,0,2679,1850,0.09667795327592942,241357,122226,
19,0.0,2,9,10,30,27495,11488,391078,0.025207248891459418,119131,789,0.0364935219113182,3799,187,0,0,187,16076,0.01690738535345433,7689,0,187,0,0.08465368945224083,0,2162,0,312,205,0,2679,1850,0.09667795327592942,241357,122226,
19,0.0,2,9,10,30,27495,11488,391078,0.025207248891459418,119131,789,0.0364935219113182,3799,187,0,0,187,16076,0.01690738535345433,7689,0,187,0,0.08465368945224083,0,2162,0,312,205,0,2679,1850,0.09667795327592942,241357,122226,
19,0.0,2,9,10,30,27495,11488,391078,0.025207248891459418,119131,789,0.0364935219113182,3799,16,0,0,16,16076,0.01690738535345433,7689,0,16,0,0.2962962962962963,0,2162,0,312,205,0,2679,1850,0.09667795327592942,241357,122226,
19,0.0,2,9,10,30,27495,11488,391078,0.025207248891459418,119131,789,0.0364935219113182,3799,16,0,0,16,16076,0.01690738535345433,7689,0,16,0,0.2962962962962963,0,2162,0,312,205,0,2679,1850,0.09667795327592942,241357,122226,
19,0.38095238095238093,2,9,10,30,27495,11488,391078,0.025207248891459418,119131,789,0.0364935219113182,3799,85,5,1,91,16076,0.01690738535345433,7689,5,80,10,0.22334209757522638,16,2162,1,312,205,5,2679,1850,0.09667795327592942,241357,122226,
19,0.0,2,9,10,30,27495,11488,391078,0.025207248891459418,119131,789,0.0364935219113182,3799,318,1,0,319,16076,0.01690738535345433,7689,0,317,0,0.21980676328502413,0,2162,0,312,205,0,2679,1850,0.09667795327592942,241357,122226,
19,0.0,2,9,10,30,27495,11488,391078,0.025207248891459418,119131,789,0.0364935219113182,3799,49,16,2,67,16076,0.01690738535345433,7689,0,33,0,0.13106894480045786,0,2162,0,312,205,0,2679,1850,0.09667795327592942,241357,122226,
19,0.0,2,9,10,30,27495,11488,391078,0.025207248891459418,119131,789,0.0364935219113182,3799,49,16,2,67,16076,0.01690738535345433,7689,0,33,0,0.13106894480045786,0,2162,0,312,205,0,2679,1850,0.09667795327592942,241357,122226,
19,0.0,2,9,10,30,27495,11488,391078,0.025207248891459418,119131,789,0.0364935219113182,3799,137,0,0,137,16076,0.01690738535345433,7689,0,137,0,0.029505860313227786,0,2162,0,312,205,0,2679,1850,0.09667795327592942,241357,122226,
19,0.0,2,9,10,30,27495,11488,391078,0.025207248891459418,119131,789,0.0364935219113182,3799,137,0,0,137,16076,0.01690738535345433,7689,0,137,0,0.029505860313227786,0,2162,0,312,205,0,2679,1850,0.09667795327592942,241357,122226,
19,0.0,2,9,10,30,27495,11488,391078,0.025207248891459418,119131,789,0.0364935219113182,3799,137,0,0,137,16076,0.01690738535345433,7689,0,137,0,0.029505860313227786,0,2162,0,312,205,0,2679,1850,0.09667795327592942,241357,122226,
19,0.0,2,9,10,30,27495,11488,391078,0.025207248891459418,119131,789,0.0364935219113182,3799,137,0,0,137,16076,0.01690738535345433,7689,0,137,0,0.029505860313227786,0,2162,0,312,205,0,2679,1850,0.09667795327592942,241357,122226,
140,0.15773161457065987,2,49,91,191,27495,11488,391078,0.03378158774219646,119131,789,0.0364935219113182,3799,3194,2228,392,5814,16076,0.01690738535345433,7689,10,966,30,0.1794964093049724,42,8831,2,5350,1996,20,16177,3481,0.0948130234151262,241357,122226,
140,0.15773161457065987,2,49,91,191,27495,11488,391078,0.03378158774219646,119131,789,0.0364935219113182,3799,3194,2228,392,5814,16076,0.01690738535345433,7689,10,966,30,0.1794964093049724,42,8831,2,5350,1996,20,16177,3481,0.0948130234151262,241357,122226,
140,0.15773161457065987,2,49,91,191,27495,11488,391078,0.03378158774219646,119131,789,0.0364935219113182,3799,3194,2228,392,5814,16076,0.01690738535345433,7689,10,966,30,0.1794964093049724,42,8831,2,5350,1996,20,16177,3481,0.0948130234151262,241357,122226,
140,0.15773161457065987,2,49,91,191,27495,11488,391078,0.03378158774219646,119131,789,0.0364935219113182,3799,3194,2228,392,5814,16076,0.01690738535345433,7689,10,966,30,0.1794964093049724,42,8831,2,5350,1996,20,16177,3481,0.0948130234151262,241357,122226,
140,0.15773161457065987,2,49,91,191,27495,11488,391078,0.03378158774219646,119131,789,0.0364935219113182,3799,3194,2228,392,5814,16076,0.01690738535345433,7689,10,966,30,0.1794964093049724,42,8831,2,5350,1996,20,16177,3481,0.0948130234151262,241357,122226,
140,0.0,2,49,91,191,27495,11488,391078,0.03378158774219646,119131,789,0.0364935219113182,3799,345,308,53,706,16076,0.01690738535345433,7689,0,37,0,0.06472531243975391,0,8831,0,5350,1996,0,16177,3481,0.0948130234151262,241357,122226,
140,0.0,2,49,91,191,27495,11488,391078,0.03378158774219646,119131,789,0.0364935219113182,3799,345,308,53,706,16076,0.01690738535345433,7689,0,37,0,0.06472531243975391,0,8831,0,5350,1996,0,16177,3481,0.0948130234151262,241357,122226,
140,0.1872351743691584,2,49,91,191,27495,11488,391078,0.03378158774219646,119131,789,0.0364935219113182,3799,3465,1919,1491,6875,16076,0.01690738535345433,7689,26,1546,79,0.13936687527338545,105,8831,0,5350,1996,53,16177,3481,0.0948130234151262,241357,122226,
140,0.1872351743691584,2,49,91,191,27495,11488,391078,0.03378158774219646,119131,789,0.0364935219113182,3799,3465,1919,1491,6875,16076,0.01690738535345433,7689,26,1546,79,0.13936687527338545,105,8831,0,5350,1996,53,16177,3481,0.0948130234151262,241357,122226,
140,0.1872351743691584,2,49,91,191,27495,11488,391078,0.03378158774219646,119131,789,0.0364935219113182,3799,3465,1919,1491,6875,16076,0.01690738535345433,7689,26,1546,79,0.13936687527338545,105,8831,0,5350,1996,53,16177,3481,0.0948130234151262,241357,122226,
140,0.1872351743691584,2,49,91,191,27495,11488,391078,0.03378158774219646,119131,789,0.0364935219113182,3799,3465,1919,1491,6875,16076,0.01690738535345433,7689,26,1546,79,0.13936687527338545,105,8831,0,5350,1996,53,16177,3481,0.0948130234151262,241357,122226,
140,0.1872351743691584,2,49,91,191,27495,11488,391078,0.03378158774219646,119131,789,0.0364935219113182,3799,3465,1919,1491,6875,16076,0.01690738535345433,7689,26,1546,79,0.13936687527338545,105,8831,0,5350,1996,53,16177,3481,0.0948130234151262,241357,122226,
140,0.1872351743691584,2,49,91,191,27495,11488,391078,0.03378158774219646,119131,789,0.0364935219113182,3799,3465,1919,1491,6875,16076,0.01690738535345433,7689,26,1546,79,0.13936687527338545,105,8831,0,5350,1996,53,16177,3481,0.0948130234151262,241357,122226,
140,0.1872351743691584,2,49,91,191,27495,11488,391078,0.03378158774219646,119131,789,0.0364935219113182,3799,3465,1919,1491,6875,16076,0.01690738535345433,7689,26,1546,79,0.13936687527338545,105,8831,0,5350,1996,53,16177,3481,0.0948130234151262,241357,122226,
140,0.15037593984962405,2,49,91,191,27495,11488,391078,0.03378158774219646,119131,789,0.0364935219113182,3799,128,165,4,297,16076,0.01690738535345433,7689,10,-37,10,0.034735095197884626,20,8831,0,5350,1996,0,16177,3481,0.0948130234151262,241357,122226,
140,0.0,2,49,91,191,27495,11488,391078,0.03378158774219646,119131,789,0.0364935219113182,3799,135,12,0,147,16076,0.01690738535345433,7689,0,123,0,0.14108588461451094,0,8831,0,5350,1996,0,16177,3481,0.0948130234151262,241357,122226,
140,0.1833855799373041,2,49,91,191,27495,11488,391078,0.03378158774219646,119131,789,0.0364935219113182,3799,119,4,0,123,16076,0.01690738535345433,7689,2,115,8,0.14469437406657398,10,8831,0,5350,1996,6,16177,3481,0.0948130234151262,241357,122226,
1950,0.0,31,275,1675,2256,27495,11488,391078,0.06093752369331605,119131,789,0.0364935219113182,3799,39,0,0,39,16076,0.01690738535345433,7689,0,39,0,0.26,0,6195,0,1982,246,0,8423,4213,0.08518667195478115,241357,122226,
1950,0.0,31,275,1675,2256,27495,11488,391078,0.06093752369331605,119131,789,0.0364935219113182,3799,39,0,0,39,16076,0.01690738535345433,7689,0,39,0,0.26,0,6195,0,1982,246,0,8423,4213,0.08518667195478115,241357,122226,
1950,0.07142857142857142,31,275,1675,2256,27495,11488,391078,0.06093752369331605,119131,789,0.0364935219113182,3799,306,1,1,308,16076,0.01690738535345433,7689,0,305,1,0.17151823503638072,2,6195,1,1982,246,1,8423,4213,0.08518667195478115,241357,122226,
1950,0.0689507577925444,31,275,1675,2256,27495,11488,391078,0.06093752369331605,119131,789,0.0364935219113182,3799,103,18,5,126,16076,0.01690738535345433,7689,15,85,52,0.06894669321709677,71,6195,4,1982,246,37,8423,4213,0.08518667195478115,241357,122226,
1950,0.0689507577925444,31,275,1675,2256,27495,11488,391078,0.06093752369331605,119131,789,0.0364935219113182,3799,103,18,5,126,16076,0.01690738535345433,7689,15,85,52,0.06894669321709677,71,6195,4,1982,246,37,8423,4213,0.08518667195478115,241357,122226,
1950,0.0689507577925444,31,275,1675,2256,27495,11488,391078,0.06093752369331605,119131,789,0.0364935219113182,3799,103,18,5,126,16076,0.01690738535345433,7689,15,85,52,0.06894669321709677,71,6195,4,1982,246,37,8423,4213,0.08518667195478115,241357,122226,
1950,0.0689507577925444,31,275,1675,2256,27495,11488,391078,0.06093752369331605,119131,789,0.0364935219113182,3799,103,18,5,126,16076,0.01690738535345433,7689,15,85,52,0.06894669321709677,71,6195,4,1982,246,37,8423,4213,0.08518667195478115,241357,122226,
1950,0.13333333333333333,31,275,1675,2256,27495,11488,391078,0.06093752369331605,119131,789,0.0364935219113182,3799,384,71,116,571,16076,0.01690738535345433,7689,1,313,1,0.29855394426782594,2,6195,0,1982,246,0,8423,4213,0.08518667195478115,241357,122226,
1950,0.13333333333333333,31,275,1675,2256,27495,11488,391078,0.06093752369331605,119131,789,0.0364935219113182,3799,384,71,116,571,16076,0.01690738535345433,7689,1,313,1,0.29855394426782594,2,6195,0,1982,246,0,8423,4213,0.08518667195478115,241357,122226,
1950,0.13333333333333333,31,275,1675,2256,27495,11488,391078,0.06093752369331605,119131,789,0.0364935219113182,3799,384,71,116,571,16076,0.01690738535345433,7689,1,313,1,0.29855394426782594,2,6195,0,1982,246,0,8423,4213,0.08518667195478115,241357,122226,
1950,0.13333333333333333,31,275,1675,2256,27495,11488,391078,0.06093752369331605,119131,789,0.0364935219113182,3799,384,71,116,571,16076,0.01690738535345433,7689,1,313,1,0.29855394426782594,2,6195,0,1982,246,0,8423,4213,0.08518667195478115,241357,122226,
1950,0.13333333333333333,31,275,1675,2256,27495,11488,391078,0.06093752369331605,119131,789,0.0364935219113182,3799,384,71,116,571,16076,0.01690738535345433,7689,1,313,1,0.29855394426782594,2,6195,0,1982,246,0,8423,4213,0.08518667195478115,241357,122226,
1950,0.13333333333333333,31,275,1675,2256,27495,11488,391078,0.06093752369331605,119131,789,0.0364935219113182,3799,384,71,116,571,16076,0.01690738535345433,7689,1,313,1,0.29855394426782594,2,6195,0,1982,246,0,8423,4213,0.08518667195478115,241357,122226,
1950,0.13333333333333333,31,275,1675,2256,27495,11488,391078,0.06093752369331605,119131,789,0.0364935219113182,3799,384,71,116,571,16076,0.01690738535345433,7689,1,313,1,0.29855394426782594,2,6195,0,1982,246,0,8423,4213,0.08518667195478115,241357,122226,
1950,0.2967504598405886,31,275,1675,2256,27495,11488,391078,0.06093752369331605,119131,789,0.0364935219113182,3799,484,0,0,484,16076,0.01690738535345433,7689,0,484,484,0.2967504598405886,484,6195,0,1982,246,484,8423,4213,0.08518667195478115,241357,122226,
1950,0.2967504598405886,31,275,1675,2256,27495,11488,391078,0.06093752369331605,119131,789,0.0364935219113182,3799,484,0,0,484,16076,0.01690738535345433,7689,0,484,484,0.2967504598405886,484,6195,0,1982,246,484,8423,4213,0.08518667195478115,241357,122226,
1950,0.2967504598405886,31,275,1675,2256,27495,11488,391078,0.06093752369331605,119131,789,0.0364935219113182,3799,484,0,0,484,16076,0.01690738535345433,7689,0,484,484,0.2967504598405886,484,6195,0,1982,246,484,8423,4213,0.08518667195478115,241357,122226,
1950,0.2967504598405886,31,275,1675,2256,27495,11488,391078,0.06093752369331605,119131,789,0.0364935219113182,3799,484,0,0,484,16076,0.01690738535345433,7689,0,484,484,0.2967504598405886,484,6195,0,1982,246,484,8423,4213,0.08518667195478115,241357,122226,
1950,0.2967504598405886,31,275,1675,2256,27495,11488,391078,0.06093752369331605,119131,789,0.0364935219113182,3799,484,0,0,484,16076,0.01690738535345433,7689,0,484,484,0.2967504598405886,484,6195,0,1982,246,484,8423,4213,0.08518667195478115,241357,122226,
1950,0.2967504598405886,31,275,1675,2256,27495,11488,391078,0.06093752369331605,119131,789,0.0364935219113182,3799,484,0,0,484,16076,0.01690738535345433,7689,0,484,484,0.2967504598405886,484,6195,0,1982,246,484,8423,4213,0.08518667195478115,241357,122226,
1950,0.12421328671328671,31,275,1675,2256,27495,11488,391078,0.06093752369331605,119131,789,0.0364935219113182,3799,80,45,1,126,16076,0.01690738535345433,7689,21,35,28,0.09433096977241874,49,6195,0,1982,246,7,8423,4213,0.08518667195478115,241357,122226,
1950,0.575,31,275,1675,2256,27495,11488,391078,0.06093752369331605,119131,789,0.0364935219113182,3799,138,0,0,138,16076,0.01690738535345433,7689,0,138,138,0.575,138,6195,0,1982,246,138,8423,4213,0.08518667195478115,241357,122226,
1950,0.575,31,275,1675,2256,27495,11488,391078,0.06093752369331605,119131,789,0.0364935219113182,3799,138,0,0,138,16076,0.01690738535345433,7689,0,138,138,0.575,138,6195,0,1982,246,138,8423,4213,0.08518667195478115,241357,122226,
1950,0.575,31,275,1675,2256,27495,11488,391078,0.06093752369331605,119131,789,0.0364935219113182,3799,138,0,0,138,16076,0.01690738535345433,7689,0,138,138,0.575,138,6195,0,1982,246,138,8423,4213,0.08518667195478115,241357,122226,
1950,0.575,31,275,1675,2256,27495,11488,391078,0.06093752369331605,119131,789,0.0364935219113182,3799,138,0,0,138,16076,0.01690738535345433,7689,0,138,138,0.575,138,6195,0,1982,246,138,8423,4213,0.08518667195478115,241357,122226,
1950,0.575,31,275,1675,2256,27495,11488,391078,0.06093752369331605,119131,789,0.0364935219113182,3799,138,0,0,138,16076,0.01690738535345433,7689,0,138,138,0.575,138,6195,0,1982,246,138,8423,4213,0.08518667195478115,241357,122226,
1950,0.575,31,275,1675,2256,27495,11488,391078,0.06093752369331605,119131,789,0.0364935219113182,3799,138,0,0,138,16076,0.01690738535345433,7689,0,138,138,0.575,138,6195,0,1982,246,138,8423,4213,0.08518667195478115,241357,122226,
1950,0.0,31,275,1675,2256,27495,11488,391078,0.06093752369331605,119131,789,0.0364935219113182,3799,0,0,0,0,16076,0.01690738535345433,7689,0,0,0,0.0,0,6195,0,1982,246,0,8423,4213,0.08518667195478115,241357,122226,
1950,0.0,31,275,1675,2256,27495,11488,391078,0.06093752369331605,119131,789,0.0364935219113182,3799,0,0,0,0,16076,0.01690738535345433,7689,0,0,0,0.0,0,6195,0,1982,246,0,8423,4213,0.08518667195478115,241357,122226,
1950,0.0,31,275,1675,2256,27495,11488,391078,0.06093752369331605,119131,789,0.0364935219113182,3799,0,0,0,0,16076,0.01690738535345433,7689,0,0,0,0.0,0,6195,0,1982,246,0,8423,4213,0.08518667195478115,241357,122226,
1950,0.0,31,275,1675,2256,27495,11488,391078,0.06093752369331605,119131,789,0.0364935219113182,3799,0,0,0,0,16076,0.01690738535345433,7689,0,0,0,0.0,0,6195,0,1982,246,0,8423,4213,0.08518667195478115,241357,122226,
1950,0.0,31,275,1675,2256,27495,11488,391078,0.06093752369331605,119131,789,0.0364935219113182,3799,0,0,0,0,16076,0.01690738535345433,7689,0,0,0,0.0,0,6195,0,1982,246,0,8423,4213,0.08518667195478115,241357,122226,
1950,0.0,31,275,1675,2256,27495,11488,391078,0.06093752369331605,119131,789,0.0364935219113182,3799,0,0,0,0,16076,0.01690738535345433,7689,0,0,0,0.0,0,6195,0,1982,246,0,8423,4213,0.08518667195478115,241357,122226,
1950,0.0,31,275,1675,2256,27495,11488,391078,0.06093752369331605,119131,789,0.0364935219113182,3799,0,0,0,0,16076,0.01690738535345433,7689,0,0,0,0.0,0,6195,0,1982,246,0,8423,4213,0.08518667195478115,241357,122226,
1950,0.0,31,275,1675,2256,27495,11488,391078,0.06093752369331605,119131,789,0.0364935219113182,3799,0,0,0,0,16076,0.01690738535345433,7689,0,0,0,0.0,0,6195,0,1982,246,0,8423,4213,0.08518667195478115,241357,122226,
1950,0.0,31,275,1675,2256,27495,11488,391078,0.06093752369331605,119131,789,0.0364935219113182,3799,0,0,0,0,16076,0.01690738535345433,7689,0,0,0,0.0,0,6195,0,1982,246,0,8423,4213,0.08518667195478115,241357,122226,
1950,0.0,31,275,1675,2256,27495,11488,391078,0.06093752369331605,119131,789,0.0364935219113182,3799,0,0,0,0,16076,0.01690738535345433,7689,0,0,0,0.0,0,6195,0,1982,246,0,8423,4213,0.08518667195478115,241357,122226,
1950,0.0,31,275,1675,2256,27495,11488,391078,0.06093752369331605,119131,789,0.0364935219113182,3799,0,0,0,0,16076,0.01690738535345433,7689,0,0,0,0.0,0,6195,0,1982,246,0,8423,4213,0.08518667195478115,241357,122226,
1950,0.0,31,275,1675,2256,27495,11488,391078,0.06093752369331605,119131,789,0.0364935219113182,3799,0,0,0,0,16076,0.01690738535345433,7689,0,0,0,0.0,0,6195,0,1982,246,0,8423,4213,0.08518667195478115,241357,122226,
1950,0.0,31,275,1675,2256,27495,11488,391078,0.06093752369331605,119131,789,0.0364935219113182,3799,0,0,0,0,16076,0.01690738535345433,7689,0,0,0,0.0,0,6195,0,1982,246,0,8423,4213,0.08518667195478115,241357,122226,
1950,0.0,31,275,1675,2256,27495,11488,391078,0.06093752369331605,119131,789,0.0364935219113182,3799,0,0,0,0,16076,0.01690738535345433,7689,0,0,0,0.0,0,6195,0,1982,246,0,8423,4213,0.08518667195478115,241357,122226,
1950,0.0,31,275,1675,2256,27495,11488,391078,0.06093752369331605,119131,789,0.0364935219113182,3799,0,0,0,0,16076,0.01690738535345433,7689,0,0,0,0.0,0,6195,0,1982,246,0,8423,4213,0.08518667195478115,241357,122226,
1950,0.0,31,275,1675,2256,27495,11488,391078,0.06093752369331605,119131,789,0.0364935219113182,3799,0,0,0,0,16076,0.01690738535345433,7689,0,0,0,0.0,0,6195,0,1982,246,0,8423,4213,0.08518667195478115,241357,122226,
1950,0.0,31,275,1675,2256,27495,11488,391078,0.06093752369331605,119131,789,0.0364935219113182,3799,0,0,0,0,16076,0.01690738535345433,7689,0,0,0,0.0,0,6195,0,1982,246,0,8423,4213,0.08518667195478115,241357,122226,
1950,0.0,31,275,1675,2256,27495,11488,391078,0.06093752369331605,119131,789,0.0364935219113182,3799,0,0,0,0,16076,0.01690738535345433,7689,0,0,0,0.0,0,6195,0,1982,246,0,8423,4213,0.08518667195478115,241357,122226,
1950,0.0,31,275,1675,2256,27495,11488,391078,0.06093752369331605,119131,789,0.0364935219113182,3799,0,0,0,0,16076,0.01690738535345433,7689,0,0,0,0.0,0,6195,0,1982,246,0,8423,4213,0.08518667195478115,241357,122226,
1950,0.0,31,275,1675,2256,27495,11488,391078,0.06093752369331605,119131,789,0.0364935219113182,3799,0,0,0,0,16076,0.01690738535345433,7689,0,0,0,0.0,0,6195,0,1982,246,0,8423,4213,0.08518667195478115,241357,122226,
1950,0.0,31,275,1675,2256,27495,11488,391078,0.06093752369331605,119131,789,0.0364935219113182,3799,0,0,0,0,16076,0.01690738535345433,7689,0,0,0,0.0,0,6195,0,1982,246,0,8423,4213,0.08518667195478115,241357,122226,
1950,0.0,31,275,1675,2256,27495,11488,391078,0.06093752369331605,119131,789,0.0364935219113182,3799,0,0,0,0,16076,0.01690738535345433,7689,0,0,0,0.0,0,6195,0,1982,246,0,8423,4213,0.08518667195478115,241357,122226,
1950,0.0,31,275,1675,2256,27495,11488,391078,0.06093752369331605,119131,789,0.0364935219113182,3799,0,0,0,0,16076,0.01690738535345433,7689,0,0,0,0.0,0,6195,0,1982,246,0,8423,4213,0.08518667195478115,241357,122226,
1950,0.0,31,275,1675,2256,27495,11488,391078,0.06093752369331605,119131,789,0.0364935219113182,3799,0,0,0,0,16076,0.01690738535345433,7689,0,0,0,0.0,0,6195,0,1982,246,0,8423,4213,0.08518667195478115,241357,122226,
1950,0.0,31,275,1675,2256,27495,11488,391078,0.06093752369331605,119131,789,0.0364935219113182,3799,0,0,0,0,16076,0.01690738535345433,7689,0,0,0,0.0,0,6195,0,1982,246,0,8423,4213,0.08518667195478115,241357,122226,
1950,0.0,31,275,1675,2256,27495,11488,391078,0.06093752369331605,119131,789,0.0364935219113182,3799,0,0,0,0,16076,0.01690738535345433,7689,0,0,0,0.0,0,6195,0,1982,246,0,8423,4213,0.08518667195478115,241357,122226,
1950,0.0,31,275,1675,2256,27495,11488,391078,0.06093752369331605,119131,789,0.0364935219113182,3799,0,0,0,0,16076,0.01690738535345433,7689,0,0,0,0.0,0,6195,0,1982,246,0,8423,4213,0.08518667195478115,241357,122226,
1950,0.0,31,275,1675,2256,27495,11488,391078,0.06093752369331605,119131,789,0.0364935219113182,3799,0,0,0,0,16076,0.01690738535345433,7689,0,0,0,0.0,0,6195,0,1982,246,0,8423,4213,0.08518667195478115,241357,122226,
1950,0.0,31,275,1675,2256,27495,11488,391078,0.06093752369331605,119131,789,0.0364935219113182,3799,0,0,0,0,16076,0.01690738535345433,7689,0,0,0,0.0,0,6195,0,1982,246,0,8423,4213,0.08518667195478115,241357,122226,
1950,0.0,31,275,1675,2256,27495,11488,391078,0.06093752369331605,119131,789,0.0364935219113182,3799,0,0,0,0,16076,0.01690738535345433,7689,0,0,0,0.0,0,6195,0,1982,246,0,8423,4213,0.08518667195478115,241357,122226,
1950,0.0,31,275,1675,2256,27495,11488,391078,0.06093752369331605,119131,789,0.0364935219113182,3799,0,0,0,0,16076,0.01690738535345433,7689,0,0,0,0.0,0,6195,0,1982,246,0,8423,4213,0.08518667195478115,241357,122226,
1950,0.0,31,275,1675,2256,27495,11488,391078,0.06093752369331605,119131,789,0.0364935219113182,3799,0,0,0,0,16076,0.01690738535345433,7689,0,0,0,0.0,0,6195,0,1982,246,0,8423,4213,0.08518667195478115,241357,122226,
1950,0.0,31,275,1675,2256,27495,11488,391078,0.06093752369331605,119131,789,0.0364935219113182,3799,0,0,0,0,16076,0.01690738535345433,7689,0,0,0,0.0,0,6195,0,1982,246,0,8423,4213,0.08518667195478115,241357,122226,
1950,0.0,31,275,1675,2256,27495,11488,391078,0.06093752369331605,119131,789,0.0364935219113182,3799,0,0,0,0,16076,0.01690738535345433,7689,0,0,0,0.0,0,6195,0,1982,246,0,8423,4213,0.08518667195478115,241357,122226,
1950,0.0,31,275,1675,2256,27495,11488,391078,0.06093752369331605,119131,789,0.0364935219113182,3799,0,0,0,0,16076,0.01690738535345433,7689,0,0,0,0.0,0,6195,0,1982,246,0,8423,4213,0.08518667195478115,241357,122226,
1950,0.0,31,275,1675,2256,27495,11488,391078,0.06093752369331605,119131,789,0.0364935219113182,3799,0,0,0,0,16076,0.01690738535345433,7689,0,0,0,0.0,0,6195,0,1982,246,0,8423,4213,0.08518667195478115,241357,122226,
1950,0.0,31,275,1675,2256,27495,11488,391078,0.06093752369331605,119131,789,0.0364935219113182,3799,0,0,0,0,16076,0.01690738535345433,7689,0,0,0,0.0,0,6195,0,1982,246,0,8423,4213,0.08518667195478115,241357,122226,
1950,0.0,31,275,1675,2256,27495,11488,391078,0.06093752369331605,119131,789,0.0364935219113182,3799,0,0,0,0,16076,0.01690738535345433,7689,0,0,0,0.0,0,6195,0,1982,246,0,8423,4213,0.08518667195478115,241357,122226,
1950,0.0,31,275,1675,2256,27495,11488,391078,0.06093752369331605,119131,789,0.0364935219113182,3799,0,0,0,0,16076,0.01690738535345433,7689,0,0,0,0.0,0,6195,0,1982,246,0,8423,4213,0.08518667195478115,241357,122226,
1950,0.0,31,275,1675,2256,27495,11488,391078,0.06093752369331605,119131,789,0.0364935219113182,3799,0,0,0,0,16076,0.01690738535345433,7689,0,0,0,0.0,0,6195,0,1982,246,0,8423,4213,0.08518667195478115,241357,122226,
1950,0.0,31,275,1675,2256,27495,11488,391078,0.06093752369331605,119131,789,0.0364935219113182,3799,0,0,0,0,16076,0.01690738535345433,7689,0,0,0,0.0,0,6195,0,1982,246,0,8423,4213,0.08518667195478115,241357,122226,
1950,0.0,31,275,1675,2256,27495,11488,391078,0.06093752369331605,119131,789,0.0364935219113182,3799,0,0,0,0,16076,0.01690738535345433,7689,0,0,0,0.0,0,6195,0,1982,246,0,8423,4213,0.08518667195478115,241357,122226,
1950,0.0,31,275,1675,2256,27495,11488,391078,0.06093752369331605,119131,789,0.0364935219113182,3799,0,0,0,0,16076,0.01690738535345433,7689,0,0,0,0.0,0,6195,0,1982,246,0,8423,4213,0.08518667195478115,241357,122226,
1950,0.0,31,275,1675,2256,27495,11488,391078,0.06093752369331605,119131,789,0.0364935219113182,3799,0,0,0,0,16076,0.01690738535345433,7689,0,0,0,0.0,0,6195,0,1982,246,0,8423,4213,0.08518667195478115,241357,122226,
1950,0.0,31,275,1675,2256,27495,11488,391078,0.06093752369331605,119131,789,0.0364935219113182,3799,0,0,0,0,16076,0.01690738535345433,7689,0,0,0,0.0,0,6195,0,1982,246,0,8423,4213,0.08518667195478115,241357,122226,
1950,0.0,31,275,1675,2256,27495,11488,391078,0.06093752369331605,119131,789,0.0364935219113182,3799,0,0,0,0,16076,0.01690738535345433,7689,0,0,0,0.0,0,6195,0,1982,246,0,8423,4213,0.08518667195478115,241357,122226,
1950,0.0,31,275,1675,2256,27495,11488,391078,0.06093752369331605,119131,789,0.0364935219113182,3799,0,0,0,0,16076,0.01690738535345433,7689,0,0,0,0.0,0,6195,0,1982,246,0,8423,4213,0.08518667195478115,241357,122226,
1950,0.0,31,275,1675,2256,27495,11488,391078,0.06093752369331605,119131,789,0.0364935219113182,3799,0,0,0,0,16076,0.01690738535345433,7689,0,0,0,0.0,0,6195,0,1982,246,0,8423,4213,0.08518667195478115,241357,122226,
1950,0.0,31,275,1675,2256,27495,11488,391078,0.06093752369331605,119131,789,0.0364935219113182,3799,0,0,0,0,16076,0.01690738535345433,7689,0,0,0,0.0,0,6195,0,1982,246,0,8423,4213,0.08518667195478115,241357,122226,
1950,0.0,31,275,1675,2256,27495,11488,391078,0.06093752369331605,119131,789,0.0364935219113182,3799,0,0,0,0,16076,0.01690738535345433,7689,0,0,0,0.0,0,6195,0,1982,246,0,8423,4213,0.08518667195478115,241357,122226,
1950,0.0,31,275,1675,2256,27495,11488,391078,0.06093752369331605,119131,789,0.0364935219113182,3799,0,0,0,0,16076,0.01690738535345433,7689,0,0,0,0.0,0,6195,0,1982,246,0,8423,4213,0.08518667195478115,241357,122226,
1950,0.0,31,275,1675,2256,27495,11488,391078,0.06093752369331605,119131,789,0.0364935219113182,3799,0,0,0,0,16076,0.01690738535345433,7689,0,0,0,0.0,0,6195,0,1982,246,0,8423,4213,0.08518667195478115,241357,122226,
1950,0.0,31,275,1675,2256,27495,11488,391078,0.06093752369331605,119131,789,0.0364935219113182,3799,0,0,0,0,16076,0.01690738535345433,7689,0,0,0,0.0,0,6195,0,1982,246,0,8423,4213,0.08518667195478115,241357,122226,
1950,0.0,31,275,1675,2256,27495,11488,391078,0.06093752369331605,119131,789,0.0364935219113182,3799,0,0,0,0,16076,0.01690738535345433,7689,0,0,0,0.0,0,6195,0,1982,246,0,8423,4213,0.08518667195478115,241357,122226,
1950,0.0,31,275,1675,2256,27495,11488,391078,0.06093752369331605,119131,789,0.0364935219113182,3799,0,0,0,0,16076,0.01690738535345433,7689,0,0,0,0.0,0,6195,0,1982,246,0,8423,4213,0.08518667195478115,241357,122226,
1950,0.0,31,275,1675,2256,27495,11488,391078,0.06093752369331605,119131,789,0.0364935219113182,3799,0,0,0,0,16076,0.01690738535345433,7689,0,0,0,0.0,0,6195,0,1982,246,0,8423,4213,0.08518667195478115,241357,122226,
1950,0.0,31,275,1675,2256,27495,11488,391078,0.06093752369331605,119131,789,0.0364935219113182,3799,0,0,0,0,16076,0.01690738535345433,7689,0,0,0,0.0,0,6195,0,1982,246,0,8423,4213,0.08518667195478115,241357,122226,
1950,0.0,31,275,1675,2256,27495,11488,391078,0.06093752369331605,119131,789,0.0364935219113182,3799,0,0,0,0,16076,0.01690738535345433,7689,0,0,0,0.0,0,6195,0,1982,246,0,8423,4213,0.08518667195478115,241357,122226,
1950,0.0,31,275,1675,2256,27495,11488,391078,0.06093752369331605,119131,789,0.0364935219113182,3799,0,0,0,0,16076,0.01690738535345433,7689,0,0,0,0.0,0,6195,0,1982,246,0,8423,4213,0.08518667195478115,241357,122226,
1950,0.0,31,275,1675,2256,27495,11488,391078,0.06093752369331605,119131,789,0.0364935219113182,3799,0,0,0,0,16076,0.01690738535345433,7689,0,0,0,0.0,0,6195,0,1982,246,0,8423,4213,0.08518667195478115,241357,122226,
1950,0.0,31,275,1675,2256,27495,11488,391078,0.06093752369331605,119131,789,0.0364935219113182,3799,0,0,0,0,16076,0.01690738535345433,7689,0,0,0,0.0,0,6195,0,1982,246,0,8423,4213,0.08518667195478115,241357,122226,
1950,0.0,31,275,1675,2256,27495,11488,391078,0.06093752369331605,119131,789,0.0364935219113182,3799,0,0,0,0,16076,0.01690738535345433,7689,0,0,0,0.0,0,6195,0,1982,246,0,8423,4213,0.08518667195478115,241357,122226,
1950,0.0,31,275,1675,2256,27495,11488,391078,0.06093752369331605,119131,789,0.0364935219113182,3799,0,0,0,0,16076,0.01690738535345433,7689,0,0,0,0.0,0,6195,0,1982,246,0,8423,4213,0.08518667195478115,241357,122226,
1950,0.0,31,275,1675,2256,27495,11488,391078,0.06093752369331605,119131,789,0.0364935219113182,3799,0,0,0,0,16076,0.01690738535345433,7689,0,0,0,0.0,0,6195,0,1982,246,0,8423,4213,0.08518667195478115,241357,122226,
1950,0.0,31,275,1675,2256,27495,11488,391078,0.06093752369331605,119131,789,0.0364935219113182,3799,0,0,0,0,16076,0.01690738535345433,7689,0,0,0,0.0,0,6195,0,1982,246,0,8423,4213,0.08518667195478115,241357,122226,
1950,0.0,31,275,1675,2256,27495,11488,391078,0.06093752369331605,119131,789,0.0364935219113182,3799,0,0,0,0,16076,0.01690738535345433,7689,0,0,0,0.0,0,6195,0,1982,246,0,8423,4213,0.08518667195478115,241357,122226,
1950,0.0,31,275,1675,2256,27495,11488,391078,0.06093752369331605,119131,789,0.0364935219113182,3799,0,0,0,0,16076,0.01690738535345433,7689,0,0,0,0.0,0,6195,0,1982,246,0,8423,4213,0.08518667195478115,241357,122226,
1950,0.0,31,275,1675,2256,27495,11488,391078,0.06093752369331605,119131,789,0.0364935219113182,3799,0,0,0,0,16076,0.01690738535345433,7689,0,0,0,0.0,0,6195,0,1982,246,0,8423,4213,0.08518667195478115,241357,122226,
1950,0.0,31,275,1675,2256,27495,11488,391078,0.06093752369331605,119131,789,0.0364935219113182,3799,0,0,0,0,16076,0.01690738535345433,7689,0,0,0,0.0,0,6195,0,1982,246,0,8423,4213,0.08518667195478115,241357,122226,
1950,0.0,31,275,1675,2256,27495,11488,391078,0.06093752369331605,119131,789,0.0364935219113182,3799,0,0,0,0,16076,0.01690738535345433,7689,0,0,0,0.0,0,6195,0,1982,246,0,8423,4213,0.08518667195478115,241357,122226,
1950,0.0,31,275,1675,2256,27495,11488,391078,0.06093752369331605,119131,789,0.0364935219113182,3799,0,0,0,0,16076,0.01690738535345433,7689,0,0,0,0.0,0,6195,0,1982,246,0,8423,4213,0.08518667195478115,241357,122226,
1950,0.0,31,275,1675,2256,27495,11488,391078,0.06093752369331605,119131,789,0.0364935219113182,3799,0,0,0,0,16076,0.01690738535345433,7689,0,0,0,0.0,0,6195,0,1982,246,0,8423,4213,0.08518667195478115,241357,122226,
1950,0.0,31,275,1675,2256,27495,11488,391078,0.06093752369331605,119131,789,0.0364935219113182,3799,0,0,0,0,16076,0.01690738535345433,7689,0,0,0,0.0,0,6195,0,1982,246,0,8423,4213,0.08518667195478115,241357,122226,
1950,0.0,31,275,1675,2256,27495,11488,391078,0.06093752369331605,119131,789,0.0364935219113182,3799,0,0,0,0,16076,0.01690738535345433,7689,0,0,0,0.0,0,6195,0,1982,246,0,8423,4213,0.08518667195478115,241357,122226,
1950,0.0,31,275,1675,2256,27495,11488,391078,0.06093752369331605,119131,789,0.0364935219113182,3799,0,0,0,0,16076,0.01690738535345433,7689,0,0,0,0.0,0,6195,0,1982,246,0,8423,4213,0.08518667195478115,241357,122226,
1950,0.0,31,275,1675,2256,27495,11488,391078,0.06093752369331605,119131,789,0.0364935219113182,3799,0,0,0,0,16076,0.01690738535345433,7689,0,0,0,0.0,0,6195,0,1982,246,0,8423,4213,0.08518667195478115,241357,122226,
1950,0.0,31,275,1675,2256,27495,11488,391078,0.06093752369331605,119131,789,0.0364935219113182,3799,0,0,0,0,16076,0.01690738535345433,7689,0,0,0,0.0,0,6195,0,1982,246,0,8423,4213,0.08518667195478115,241357,122226,
1950,0.0,31,275,1675,2256,27495,11488,391078,0.06093752369331605,119131,789,0.0364935219113182,3799,0,0,0,0,16076,0.01690738535345433,7689,0,0,0,0.0,0,6195,0,1982,246,0,8423,4213,0.08518667195478115,241357,122226,
1950,0.0,31,275,1675,2256,27495,11488,391078,0.06093752369331605,119131,789,0.0364935219113182,3799,0,0,0,0,16076,0.01690738535345433,7689,0,0,0,0.0,0,6195,0,1982,246,0,8423,4213,0.08518667195478115,241357,122226,
1950,0.0,31,275,1675,2256,27495,11488,391078,0.06093752369331605,119131,789,0.0364935219113182,3799,0,0,0,0,16076,0.01690738535345433,7689,0,0,0,0.0,0,6195,0,1982,246,0,8423,4213,0.08518667195478115,241357,122226,
1950,0.0,31,275,1675,2256,27495,11488,391078,0.06093752369331605,119131,789,0.0364935219113182,3799,0,0,0,0,16076,0.01690738535345433,7689,0,0,0,0.0,0,6195,0,1982,246,0,8423,4213,0.08518667195478115,241357,122226,
1950,0.0,31,275,1675,2256,27495,11488,391078,0.06093752369331605,119131,789,0.0364935219113182,3799,0,0,0,0,16076,0.01690738535345433,7689,0,0,0,0.0,0,6195,0,1982,246,0,8423,4213,0.08518667195478115,241357,122226,
1950,0.0,31,275,1675,2256,27495,11488,391078,0.06093752369331605,119131,789,0.0364935219113182,3799,0,0,0,0,16076,0.01690738535345433,7689,0,0,0,0.0,0,6195,0,1982,246,0,8423,4213,0.08518667195478115,241357,122226,
1950,0.0,31,275,1675,2256,27495,11488,391078,0.06093752369331605,119131,789,0.0364935219113182,3799,0,0,0,0,16076,0.01690738535345433,7689,0,0,0,0.0,0,6195,0,1982,246,0,8423,4213,0.08518667195478115,241357,122226,
1950,0.0,31,275,1675,2256,27495,11488,391078,0.06093752369331605,119131,789,0.0364935219113182,3799,0,0,0,0,16076,0.01690738535345433,7689,0,0,0,0.0,0,6195,0,1982,246,0,8423,4213,0.08518667195478115,241357,122226,
1950,0.0,31,275,1675,2256,27495,11488,391078,0.06093752369331605,119131,789,0.0364935219113182,3799,0,0,0,0,16076,0.01690738535345433,7689,0,0,0,0.0,0,6195,0,1982,246,0,8423,4213,0.08518667195478115,241357,122226,
1950,0.0,31,275,1675,2256,27495,11488,391078,0.06093752369331605,119131,789,0.0364935219113182,3799,0,0,0,0,16076,0.01690738535345433,7689,0,0,0,0.0,0,6195,0,1982,246,0,8423,4213,0.08518667195478115,241357,122226,
1950,0.0,31,275,1675,2256,27495,11488,391078,0.06093752369331605,119131,789,0.0364935219113182,3799,0,0,0,0,16076,0.01690738535345433,7689,0,0,0,0.0,0,6195,0,1982,246,0,8423,4213,0.08518667195478115,241357,122226,
1950,0.0,31,275,1675,2256,27495,11488,391078,0.06093752369331605,119131,789,0.0364935219113182,3799,0,0,0,0,16076,0.01690738535345433,7689,0,0,0,0.0,0,6195,0,1982,246,0,8423,4213,0.08518667195478115,241357,122226,
1950,0.0,31,275,1675,2256,27495,11488,391078,0.06093752369331605,119131,789,0.0364935219113182,3799,0,0,0,0,16076,0.01690738535345433,7689,0,0,0,0.0,0,6195,0,1982,246,0,8423,4213,0.08518667195478115,241357,122226,
1950,0.0,31,275,1675,2256,27495,11488,391078,0.06093752369331605,119131,789,0.0364935219113182,3799,0,0,0,0,16076,0.01690738535345433,7689,0,0,0,0.0,0,6195,0,1982,246,0,8423,4213,0.08518667195478115,241357,122226,
1950,0.0,31,275,1675,2256,27495,11488,391078,0.06093752369331605,119131,789,0.0364935219113182,3799,0,0,0,0,16076,0.01690738535345433,7689,0,0,0,0.0,0,6195,0,1982,246,0,8423,4213,0.08518667195478115,241357,122226,
1950,0.0,31,275,1675,2256,27495,11488,391078,0.06093752369331605,119131,789,0.0364935219113182,3799,0,0,0,0,16076,0.01690738535345433,7689,0,0,0,0.0,0,6195,0,1982,246,0,8423,4213,0.08518667195478115,241357,122226,
1950,0.0,31,275,1675,2256,27495,11488,391078,0.06093752369331605,119131,789,0.0364935219113182,3799,0,0,0,0,16076,0.01690738535345433,7689,0,0,0,0.0,0,6195,0,1982,246,0,8423,4213,0.08518667195478115,241357,122226,
1950,0.0,31,275,1675,2256,27495,11488,391078,0.06093752369331605,119131,789,0.0364935219113182,3799,0,0,0,0,16076,0.01690738535345433,7689,0,0,0,0.0,0,6195,0,1982,246,0,8423,4213,0.08518667195478115,241357,122226,
1950,0.0,31,275,1675,2256,27495,11488,391078,0.06093752369331605,119131,789,0.0364935219113182,3799,0,0,0,0,16076,0.01690738535345433,7689,0,0,0,0.0,0,6195,0,1982,246,0,8423,4213,0.08518667195478115,241357,122226,
1950,0.0,31,275,1675,2256,27495,11488,391078,0.06093752369331605,119131,789,0.0364935219113182,3799,0,0,0,0,16076,0.01690738535345433,7689,0,0,0,0.0,0,6195,0,1982,246,0,8423,4213,0.08518667195478115,241357,122226,
1950,0.0,31,275,1675,2256,27495,11488,391078,0.06093752369331605,119131,789,0.0364935219113182,3799,0,0,0,0,16076,0.01690738535345433,7689,0,0,0,0.0,0,6195,0,1982,246,0,8423,4213,0.08518667195478115,241357,122226,
1950,0.0,31,275,1675,2256,27495,11488,391078,0.06093752369331605,119131,789,0.0364935219113182,3799,0,0,0,0,16076,0.01690738535345433,7689,0,0,0,0.0,0,6195,0,1982,246,0,8423,4213,0.08518667195478115,241357,122226,
1950,0.0,31,275,1675,2256,27495,11488,391078,0.06093752369331605,119131,789,0.0364935219113182,3799,0,0,0,0,16076,0.01690738535345433,7689,0,0,0,0.0,0,6195,0,1982,246,0,8423,4213,0.08518667195478115,241357,122226,
1950,0.0,31,275,1675,2256,27495,11488,391078,0.06093752369331605,119131,789,0.0364935219113182,3799,0,0,0,0,16076,0.01690738535345433,7689,0,0,0,0.0,0,6195,0,1982,246,0,8423,4213,0.08518667195478115,241357,122226,
1950,0.0,31,275,1675,2256,27495,11488,391078,0.06093752369331605,119131,789,0.0364935219113182,3799,0,0,0,0,16076,0.01690738535345433,7689,0,0,0,0.0,0,6195,0,1982,246,0,8423,4213,0.08518667195478115,241357,122226,
1950,0.0,31,275,1675,2256,27495,11488,391078,0.06093752369331605,119131,789,0.0364935219113182,3799,0,0,0,0,16076,0.01690738535345433,7689,0,0,0,0.0,0,6195,0,1982,246,0,8423,4213,0.08518667195478115,241357,122226,
1950,0.0,31,275,1675,2256,27495,11488,391078,0.06093752369331605,119131,789,0.0364935219113182,3799,0,0,0,0,16076,0.01690738535345433,7689,0,0,0,0.0,0,6195,0,1982,246,0,8423,4213,0.08518667195478115,241357,122226,
1950,0.0,31,275,1675,2256,27495,11488,391078,0.06093752369331605,119131,789,0.0364935219113182,3799,0,0,0,0,16076,0.01690738535345433,7689,0,0,0,0.0,0,6195,0,1982,246,0,8423,4213,0.08518667195478115,241357,122226,
1950,0.0,31,275,1675,2256,27495,11488,391078,0.06093752369331605,119131,789,0.0364935219113182,3799,0,0,0,0,16076,0.01690738535345433,7689,0,0,0,0.0,0,6195,0,1982,246,0,8423,4213,0.08518667195478115,241357,122226,
1950,0.0,31,275,1675,2256,27495,11488,391078,0.06093752369331605,119131,789,0.0364935219113182,3799,0,0,0,0,16076,0.01690738535345433,7689,0,0,0,0.0,0,6195,0,1982,246,0,8423,4213,0.08518667195478115,241357,122226,
1950,0.0,31,275,1675,2256,27495,11488,391078,0.06093752369331605,119131,789,0.0364935219113182,3799,0,0,0,0,16076,0.01690738535345433,7689,0,0,0,0.0,0,6195,0,1982,246,0,8423,4213,0.08518667195478115,241357,122226,
1950,0.0,31,275,1675,2256,27495,11488,391078,0.06093752369331605,119131,789,0.0364935219113182,3799,0,0,0,0,16076,0.01690738535345433,7689,0,0,0,0.0,0,6195,0,1982,246,0,8423,4213,0.08518667195478115,241357,122226,
1950,0.0,31,275,1675,2256,27495,11488,391078,0.06093752369331605,119131,789,0.0364935219113182,3799,0,0,0,0,16076,0.01690738535345433,7689,0,0,0,0.0,0,6195,0,1982,246,0,8423,4213,0.08518667195478115,241357,122226,
1950,0.0,31,275,1675,2256,27495,11488,391078,0.06093752369331605,119131,789,0.0364935219113182,3799,0,0,0,0,16076,0.01690738535345433,7689,0,0,0,0.0,0,6195,0,1982,246,0,8423,4213,0.08518667195478115,241357,122226,
1950,0.0,31,275,1675,2256,27495,11488,391078,0.06093752369331605,119131,789,0.0364935219113182,3799,0,0,0,0,16076,0.01690738535345433,7689,0,0,0,0.0,0,6195,0,1982,246,0,8423,4213,0.08518667195478115,241357,122226,
1950,0.0,31,275,1675,2256,27495,11488,391078,0.06093752369331605,119131,789,0.0364935219113182,3799,0,0,0,0,16076,0.01690738535345433,7689,0,0,0,0.0,0,6195,0,1982,246,0,8423,4213,0.08518667195478115,241357,122226,
1950,0.0,31,275,1675,2256,27495,11488,391078,0.06093752369331605,119131,789,0.0364935219113182,3799,0,0,0,0,16076,0.01690738535345433,7689,0,0,0,0.0,0,6195,0,1982,246,0,8423,4213,0.08518667195478115,241357,122226,
1950,0.0,31,275,1675,2256,27495,11488,391078,0.06093752369331605,119131,789,0.0364935219113182,3799,0,0,0,0,16076,0.01690738535345433,7689,0,0,0,0.0,0,6195,0,1982,246,0,8423,4213,0.08518667195478115,241357,122226,
1950,0.0,31,275,1675,2256,27495,11488,391078,0.06093752369331605,119131,789,0.0364935219113182,3799,0,0,0,0,16076,0.01690738535345433,7689,0,0,0,0.0,0,6195,0,1982,246,0,8423,4213,0.08518667195478115,241357,122226,
1950,0.0,31,275,1675,2256,27495,11488,391078,0.06093752369331605,119131,789,0.0364935219113182,3799,0,0,0,0,16076,0.01690738535345433,7689,0,0,0,0.0,0,6195,0,1982,246,0,8423,4213,0.08518667195478115,241357,122226,
1950,0.0,31,275,1675,2256,27495,11488,391078,0.06093752369331605,119131,789,0.0364935219113182,3799,0,0,0,0,16076,0.01690738535345433,7689,0,0,0,0.0,0,6195,0,1982,246,0,8423,4213,0.08518667195478115,241357,122226,
1950,0.0,31,275,1675,2256,27495,11488,391078,0.06093752369331605,119131,789,0.0364935219113182,3799,0,0,0,0,16076,0.01690738535345433,7689,0,0,0,0.0,0,6195,0,1982,246,0,8423,4213,0.08518667195478115,241357,122226,
1950,0.0,31,275,1675,2256,27495,11488,391078,0.06093752369331605,119131,789,0.0364935219113182,3799,0,0,0,0,16076,0.01690738535345433,7689,0,0,0,0.0,0,6195,0,1982,246,0,8423,4213,0.08518667195478115,241357,122226,
1950,0.0,31,275,1675,2256,27495,11488,391078,0.06093752369331605,119131,789,0.0364935219113182,3799,0,0,0,0,16076,0.01690738535345433,7689,0,0,0,0.0,0,6195,0,1982,246,0,8423,4213,0.08518667195478115,241357,122226,
1950,0.0,31,275,1675,2256,27495,11488,391078,0.06093752369331605,119131,789,0.0364935219113182,3799,0,0,0,0,16076,0.01690738535345433,7689,0,0,0,0.0,0,6195,0,1982,246,0,8423,4213,0.08518667195478115,241357,122226,
1950,0.0,31,275,1675,2256,27495,11488,391078,0.06093752369331605,119131,789,0.0364935219113182,3799,0,0,0,0,16076,0.01690738535345433,7689,0,0,0,0.0,0,6195,0,1982,246,0,8423,4213,0.08518667195478115,241357,122226,
1950,0.0,31,275,1675,2256,27495,11488,391078,0.06093752369331605,119131,789,0.0364935219113182,3799,0,0,0,0,16076,0.01690738535345433,7689,0,0,0,0.0,0,6195,0,1982,246,0,8423,4213,0.08518667195478115,241357,122226,
1950,0.0,31,275,1675,2256,27495,11488,391078,0.06093752369331605,119131,789,0.0364935219113182,3799,0,0,0,0,16076,0.01690738535345433,7689,0,0,0,0.0,0,6195,0,1982,246,0,8423,4213,0.08518667195478115,241357,122226,
1950,0.0,31,275,1675,2256,27495,11488,391078,0.06093752369331605,119131,789,0.0364935219113182,3799,0,0,0,0,16076,0.01690738535345433,7689,0,0,0,0.0,0,6195,0,1982,246,0,8423,4213,0.08518667195478115,241357,122226,
1950,0.0,31,275,1675,2256,27495,11488,391078,0.06093752369331605,119131,789,0.0364935219113182,3799,0,0,0,0,16076,0.01690738535345433,7689,0,0,0,0.0,0,6195,0,1982,246,0,8423,4213,0.08518667195478115,241357,122226,
1950,0.0,31,275,1675,2256,27495,11488,391078,0.06093752369331605,119131,789,0.0364935219113182,3799,0,0,0,0,16076,0.01690738535345433,7689,0,0,0,0.0,0,6195,0,1982,246,0,8423,4213,0.08518667195478115,241357,122226,
1950,0.0,31,275,1675,2256,27495,11488,391078,0.06093752369331605,119131,789,0.0364935219113182,3799,0,0,0,0,16076,0.01690738535345433,7689,0,0,0,0.0,0,6195,0,1982,246,0,8423,4213,0.08518667195478115,241357,122226,
1950,0.0,31,275,1675,2256,27495,11488,391078,0.06093752369331605,119131,789,0.0364935219113182,3799,0,0,0,0,16076,0.01690738535345433,7689,0,0,0,0.0,0,6195,0,1982,246,0,8423,4213,0.08518667195478115,241357,122226,
1950,0.0,31,275,1675,2256,27495,11488,391078,0.06093752369331605,119131,789,0.0364935219113182,3799,0,0,0,0,16076,0.01690738535345433,7689,0,0,0,0.0,0,6195,0,1982,246,0,8423,4213,0.08518667195478115,241357,122226,
1950,0.0,31,275,1675,2256,27495,11488,391078,0.06093752369331605,119131,789,0.0364935219113182,3799,0,0,0,0,16076,0.01690738535345433,7689,0,0,0,0.0,0,6195,0,1982,246,0,8423,4213,0.08518667195478115,241357,122226,
1950,0.0,31,275,1675,2256,27495,11488,391078,0.06093752369331605,119131,789,0.0364935219113182,3799,0,0,0,0,16076,0.01690738535345433,7689,0,0,0,0.0,0,6195,0,1982,246,0,8423,4213,0.08518667195478115,241357,122226,
1950,0.0,31,275,1675,2256,27495,11488,391078,0.06093752369331605,119131,789,0.0364935219113182,3799,0,0,0,0,16076,0.01690738535345433,7689,0,0,0,0.0,0,6195,0,1982,246,0,8423,4213,0.08518667195478115,241357,122226,
1950,0.0,31,275,1675,2256,27495,11488,391078,0.06093752369331605,119131,789,0.0364935219113182,3799,0,0,0,0,16076,0.01690738535345433,7689,0,0,0,0.0,0,6195,0,1982,246,0,8423,4213,0.08518667195478115,241357,122226,
1950,0.0,31,275,1675,2256,27495,11488,391078,0.06093752369331605,119131,789,0.0364935219113182,3799,0,0,0,0,16076,0.01690738535345433,7689,0,0,0,0.0,0,6195,0,1982,246,0,8423,4213,0.08518667195478115,241357,122226,
1950,0.0,31,275,1675,2256,27495,11488,391078,0.06093752369331605,119131,789,0.0364935219113182,3799,0,0,0,0,16076,0.01690738535345433,7689,0,0,0,0.0,0,6195,0,1982,246,0,8423,4213,0.08518667195478115,241357,122226,
1950,0.0,31,275,1675,2256,27495,11488,391078,0.06093752369331605,119131,789,0.0364935219113182,3799,0,0,0,0,16076,0.01690738535345433,7689,0,0,0,0.0,0,6195,0,1982,246,0,8423,4213,0.08518667195478115,241357,122226,
1950,0.0,31,275,1675,2256,27495,11488,391078,0.06093752369331605,119131,789,0.0364935219113182,3799,0,0,0,0,16076,0.01690738535345433,7689,0,0,0,0.0,0,6195,0,1982,246,0,8423,4213,0.08518667195478115,241357,122226,
1950,0.0,31,275,1675,2256,27495,11488,391078,0.06093752369331605,119131,789,0.0364935219113182,3799,0,0,0,0,16076,0.01690738535345433,7689,0,0,0,0.0,0,6195,0,1982,246,0,8423,4213,0.08518667195478115,241357,122226,
1950,0.0,31,275,1675,2256,27495,11488,391078,0.06093752369331605,119131,789,0.0364935219113182,3799,0,0,0,0,16076,0.01690738535345433,7689,0,0,0,0.0,0,6195,0,1982,246,0,8423,4213,0.08518667195478115,241357,122226,
1950,0.0,31,275,1675,2256,27495,11488,391078,0.06093752369331605,119131,789,0.0364935219113182,3799,0,0,0,0,16076,0.01690738535345433,7689,0,0,0,0.0,0,6195,0,1982,246,0,8423,4213,0.08518667195478115,241357,122226,
1950,0.0,31,275,1675,2256,27495,11488,391078,0.06093752369331605,119131,789,0.0364935219113182,3799,0,0,0,0,16076,0.01690738535345433,7689,0,0,0,0.0,0,6195,0,1982,246,0,8423,4213,0.08518667195478115,241357,122226,
1950,0.0,31,275,1675,2256,27495,11488,391078,0.06093752369331605,119131,789,0.0364935219113182,3799,0,0,0,0,16076,0.01690738535345433,7689,0,0,0,0.0,0,6195,0,1982,246,0,8423,4213,0.08518667195478115,241357,122226,
1950,0.0,31,275,1675,2256,27495,11488,391078,0.06093752369331605,119131,789,0.0364935219113182,3799,0,0,0,0,16076,0.01690738535345433,7689,0,0,0,0.0,0,6195,0,1982,246,0,8423,4213,0.08518667195478115,241357,122226,
1950,0.0,31,275,1675,2256,27495,11488,391078,0.06093752369331605,119131,789,0.0364935219113182,3799,0,0,0,0,16076,0.01690738535345433,7689,0,0,0,0.0,0,6195,0,1982,246,0,8423,4213,0.08518667195478115,241357,122226,
1950,0.0,31,275,1675,2256,27495,11488,391078,0.06093752369331605,119131,789,0.0364935219113182,3799,0,0,0,0,16076,0.01690738535345433,7689,0,0,0,0.0,0,6195,0,1982,246,0,8423,4213,0.08518667195478115,241357,122226,
1950,0.0,31,275,1675,2256,27495,11488,391078,0.06093752369331605,119131,789,0.0364935219113182,3799,0,0,0,0,16076,0.01690738535345433,7689,0,0,0,0.0,0,6195,0,1982,246,0,8423,4213,0.08518667195478115,241357,122226,
1950,0.0,31,275,1675,2256,27495,11488,391078,0.06093752369331605,119131,789,0.0364935219113182,3799,0,0,0,0,16076,0.01690738535345433,7689,0,0,0,0.0,0,6195,0,1982,246,0,8423,4213,0.08518667195478115,241357,122226,
1950,0.0,31,275,1675,2256,27495,11488,391078,0.06093752369331605,119131,789,0.0364935219113182,3799,0,0,0,0,16076,0.01690738535345433,7689,0,0,0,0.0,0,6195,0,1982,246,0,8423,4213,0.08518667195478115,241357,122226,
1950,0.0,31,275,1675,2256,27495,11488,391078,0.06093752369331605,119131,789,0.0364935219113182,3799,0,0,0,0,16076,0.01690738535345433,7689,0,0,0,0.0,0,6195,0,1982,246,0,8423,4213,0.08518667195478115,241357,122226,
1950,0.0,31,275,1675,2256,27495,11488,391078,0.06093752369331605,119131,789,0.0364935219113182,3799,0,0,0,0,16076,0.01690738535345433,7689,0,0,0,0.0,0,6195,0,1982,246,0,8423,4213,0.08518667195478115,241357,122226,
1950,0.0,31,275,1675,2256,27495,11488,391078,0.06093752369331605,119131,789,0.0364935219113182,3799,0,0,0,0,16076,0.01690738535345433,7689,0,0,0,0.0,0,6195,0,1982,246,0,8423,4213,0.08518667195478115,241357,122226,
1950,0.0,31,275,1675,2256,27495,11488,391078,0.06093752369331605,119131,789,0.0364935219113182,3799,0,0,0,0,16076,0.01690738535345433,7689,0,0,0,0.0,0,6195,0,1982,246,0,8423,4213,0.08518667195478115,241357,122226,
1950,0.0,31,275,1675,2256,27495,11488,391078,0.06093752369331605,119131,789,0.0364935219113182,3799,0,0,0,0,16076,0.01690738535345433,7689,0,0,0,0.0,0,6195,0,1982,246,0,8423,4213,0.08518667195478115,241357,122226,
1950,0.0,31,275,1675,2256,27495,11488,391078,0.06093752369331605,119131,789,0.0364935219113182,3799,0,0,0,0,16076,0.01690738535345433,7689,0,0,0,0.0,0,6195,0,1982,246,0,8423,4213,0.08518667195478115,241357,122226,
1950,0.0,31,275,1675,2256,27495,11488,391078,0.06093752369331605,119131,789,0.0364935219113182,3799,0,0,0,0,16076,0.01690738535345433,7689,0,0,0,0.0,0,6195,0,1982,246,0,8423,4213,0.08518667195478115,241357,122226,
1950,0.0,31,275,1675,2256,27495,11488,391078,0.06093752369331605,119131,789,0.0364935219113182,3799,0,0,0,0,16076,0.01690738535345433,7689,0,0,0,0.0,0,6195,0,1982,246,0,8423,4213,0.08518667195478115,241357,122226,
1950,0.0,31,275,1675,2256,27495,11488,391078,0.06093752369331605,119131,789,0.0364935219113182,3799,0,0,0,0,16076,0.01690738535345433,7689,0,0,0,0.0,0,6195,0,1982,246,0,8423,4213,0.08518667195478115,241357,122226,
1950,0.0,31,275,1675,2256,27495,11488,391078,0.06093752369331605,119131,789,0.0364935219113182,3799,0,0,0,0,16076,0.01690738535345433,7689,0,0,0,0.0,0,6195,0,1982,246,0,8423,4213,0.08518667195478115,241357,122226,
1950,0.0,31,275,1675,2256,27495,11488,391078,0.06093752369331605,119131,789,0.0364935219113182,3799,0,0,0,0,16076,0.01690738535345433,7689,0,0,0,0.0,0,6195,0,1982,246,0,8423,4213,0.08518667195478115,241357,122226,
1950,0.0,31,275,1675,2256,27495,11488,391078,0.06093752369331605,119131,789,0.0364935219113182,3799,0,0,0,0,16076,0.01690738535345433,7689,0,0,0,0.0,0,6195,0,1982,246,0,8423,4213,0.08518667195478115,241357,122226,
1950,0.0,31,275,1675,2256,27495,11488,391078,0.06093752369331605,119131,789,0.0364935219113182,3799,0,0,0,0,16076,0.01690738535345433,7689,0,0,0,0.0,0,6195,0,1982,246,0,8423,4213,0.08518667195478115,241357,122226,
1950,0.0,31,275,1675,2256,27495,11488,391078,0.06093752369331605,119131,789,0.0364935219113182,3799,0,0,0,0,16076,0.01690738535345433,7689,0,0,0,0.0,0,6195,0,1982,246,0,8423,4213,0.08518667195478115,241357,122226,
1950,0.0,31,275,1675,2256,27495,11488,391078,0.06093752369331605,119131,789,0.0364935219113182,3799,0,0,0,0,16076,0.01690738535345433,7689,0,0,0,0.0,0,6195,0,1982,246,0,8423,4213,0.08518667195478115,241357,122226,
1950,0.0,31,275,1675,2256,27495,11488,391078,0.06093752369331605,119131,789,0.0364935219113182,3799,0,0,0,0,16076,0.01690738535345433,7689,0,0,0,0.0,0,6195,0,1982,246,0,8423,4213,0.08518667195478115,241357,122226,
1950,0.0,31,275,1675,2256,27495,11488,391078,0.06093752369331605,119131,789,0.0364935219113182,3799,0,0,0,0,16076,0.01690738535345433,7689,0,0,0,0.0,0,6195,0,1982,246,0,8423,4213,0.08518667195478115,241357,122226,
1950,0.0,31,275,1675,2256,27495,11488,391078,0.06093752369331605,119131,789,0.0364935219113182,3799,0,0,0,0,16076,0.01690738535345433,7689,0,0,0,0.0,0,6195,0,1982,246,0,8423,4213,0.08518667195478115,241357,122226,
1950,0.0,31,275,1675,2256,27495,11488,391078,0.06093752369331605,119131,789,0.0364935219113182,3799,0,0,0,0,16076,0.01690738535345433,7689,0,0,0,0.0,0,6195,0,1982,246,0,8423,4213,0.08518667195478115,241357,122226,
1950,0.0,31,275,1675,2256,27495,11488,391078,0.06093752369331605,119131,789,0.0364935219113182,3799,0,0,0,0,16076,0.01690738535345433,7689,0,0,0,0.0,0,6195,0,1982,246,0,8423,4213,0.08518667195478115,241357,122226,
1950,0.0,31,275,1675,2256,27495,11488,391078,0.06093752369331605,119131,789,0.0364935219113182,3799,0,0,0,0,16076,0.01690738535345433,7689,0,0,0,0.0,0,6195,0,1982,246,0,8423,4213,0.08518667195478115,241357,122226,
1950,0.0,31,275,1675,2256,27495,11488,391078,0.06093752369331605,119131,789,0.0364935219113182,3799,0,0,0,0,16076,0.01690738535345433,7689,0,0,0,0.0,0,6195,0,1982,246,0,8423,4213,0.08518667195478115,241357,122226,
1950,0.0,31,275,1675,2256,27495,11488,391078,0.06093752369331605,119131,789,0.0364935219113182,3799,0,0,0,0,16076,0.01690738535345433,7689,0,0,0,0.0,0,6195,0,1982,246,0,8423,4213,0.08518667195478115,241357,122226,
1950,0.0,31,275,1675,2256,27495,11488,391078,0.06093752369331605,119131,789,0.0364935219113182,3799,0,0,0,0,16076,0.01690738535345433,7689,0,0,0,0.0,0,6195,0,1982,246,0,8423,4213,0.08518667195478115,241357,122226,
1950,0.0,31,275,1675,2256,27495,11488,391078,0.06093752369331605,119131,789,0.0364935219113182,3799,0,0,0,0,16076,0.01690738535345433,7689,0,0,0,0.0,0,6195,0,1982,246,0,8423,4213,0.08518667195478115,241357,122226,
1950,0.0,31,275,1675,2256,27495,11488,391078,0.06093752369331605,119131,789,0.0364935219113182,3799,0,0,0,0,16076,0.01690738535345433,7689,0,0,0,0.0,0,6195,0,1982,246,0,8423,4213,0.08518667195478115,241357,122226,
1950,0.0,31,275,1675,2256,27495,11488,391078,0.06093752369331605,119131,789,0.0364935219113182,3799,0,0,0,0,16076,0.01690738535345433,7689,0,0,0,0.0,0,6195,0,1982,246,0,8423,4213,0.08518667195478115,241357,122226,
1950,0.0,31,275,1675,2256,27495,11488,391078,0.06093752369331605,119131,789,0.0364935219113182,3799,0,0,0,0,16076,0.01690738535345433,7689,0,0,0,0.0,0,6195,0,1982,246,0,8423,4213,0.08518667195478115,241357,122226,
1950,0.0,31,275,1675,2256,27495,11488,391078,0.06093752369331605,119131,789,0.0364935219113182,3799,0,0,0,0,16076,0.01690738535345433,7689,0,0,0,0.0,0,6195,0,1982,246,0,8423,4213,0.08518667195478115,241357,122226,
1950,0.0,31,275,1675,2256,27495,11488,391078,0.06093752369331605,119131,789,0.0364935219113182,3799,0,0,0,0,16076,0.01690738535345433,7689,0,0,0,0.0,0,6195,0,1982,246,0,8423,4213,0.08518667195478115,241357,122226,
1950,0.0,31,275,1675,2256,27495,11488,391078,0.06093752369331605,119131,789,0.0364935219113182,3799,0,0,0,0,16076,0.01690738535345433,7689,0,0,0,0.0,0,6195,0,1982,246,0,8423,4213,0.08518667195478115,241357,122226,
1950,0.0,31,275,1675,2256,27495,11488,391078,0.06093752369331605,119131,789,0.0364935219113182,3799,0,0,0,0,16076,0.01690738535345433,7689,0,0,0,0.0,0,6195,0,1982,246,0,8423,4213,0.08518667195478115,241357,122226,
1950,0.0,31,275,1675,2256,27495,11488,391078,0.06093752369331605,119131,789,0.0364935219113182,3799,0,0,0,0,16076,0.01690738535345433,7689,0,0,0,0.0,0,6195,0,1982,246,0,8423,4213,0.08518667195478115,241357,122226,
1950,0.0,31,275,1675,2256,27495,11488,391078,0.06093752369331605,119131,789,0.0364935219113182,3799,0,0,0,0,16076,0.01690738535345433,7689,0,0,0,0.0,0,6195,0,1982,246,0,8423,4213,0.08518667195478115,241357,122226,
1950,0.0,31,275,1675,2256,27495,11488,391078,0.06093752369331605,119131,789,0.0364935219113182,3799,0,0,0,0,16076,0.01690738535345433,7689,0,0,0,0.0,0,6195,0,1982,246,0,8423,4213,0.08518667195478115,241357,122226,
1950,0.0,31,275,1675,2256,27495,11488,391078,0.06093752369331605,119131,789,0.0364935219113182,3799,0,0,0,0,16076,0.01690738535345433,7689,0,0,0,0.0,0,6195,0,1982,246,0,8423,4213,0.08518667195478115,241357,122226,
1950,0.0,31,275,1675,2256,27495,11488,391078,0.06093752369331605,119131,789,0.0364935219113182,3799,0,0,0,0,16076,0.01690738535345433,7689,0,0,0,0.0,0,6195,0,1982,246,0,8423,4213,0.08518667195478115,241357,122226,
1950,0.0,31,275,1675,2256,27495,11488,391078,0.06093752369331605,119131,789,0.0364935219113182,3799,0,0,0,0,16076,0.01690738535345433,7689,0,0,0,0.0,0,6195,0,1982,246,0,8423,4213,0.08518667195478115,241357,122226,
1950,0.0,31,275,1675,2256,27495,11488,391078,0.06093752369331605,119131,789,0.0364935219113182,3799,0,0,0,0,16076,0.01690738535345433,7689,0,0,0,0.0,0,6195,0,1982,246,0,8423,4213,0.08518667195478115,241357,122226,
1950,0.0,31,275,1675,2256,27495,11488,391078,0.06093752369331605,119131,789,0.0364935219113182,3799,0,0,0,0,16076,0.01690738535345433,7689,0,0,0,0.0,0,6195,0,1982,246,0,8423,4213,0.08518667195478115,241357,122226,
1950,0.0,31,275,1675,2256,27495,11488,391078,0.06093752369331605,119131,789,0.0364935219113182,3799,0,0,0,0,16076,0.01690738535345433,7689,0,0,0,0.0,0,6195,0,1982,246,0,8423,4213,0.08518667195478115,241357,122226,
1950,0.0,31,275,1675,2256,27495,11488,391078,0.06093752369331605,119131,789,0.0364935219113182,3799,0,0,0,0,16076,0.01690738535345433,7689,0,0,0,0.0,0,6195,0,1982,246,0,8423,4213,0.08518667195478115,241357,122226,
1950,0.0,31,275,1675,2256,27495,11488,391078,0.06093752369331605,119131,789,0.0364935219113182,3799,0,0,0,0,16076,0.01690738535345433,7689,0,0,0,0.0,0,6195,0,1982,246,0,8423,4213,0.08518667195478115,241357,122226,
1950,0.0,31,275,1675,2256,27495,11488,391078,0.06093752369331605,119131,789,0.0364935219113182,3799,0,0,0,0,16076,0.01690738535345433,7689,0,0,0,0.0,0,6195,0,1982,246,0,8423,4213,0.08518667195478115,241357,122226,
1950,0.0,31,275,1675,2256,27495,11488,391078,0.06093752369331605,119131,789,0.0364935219113182,3799,0,0,0,0,16076,0.01690738535345433,7689,0,0,0,0.0,0,6195,0,1982,246,0,8423,4213,0.08518667195478115,241357,122226,
1950,0.0,31,275,1675,2256,27495,11488,391078,0.06093752369331605,119131,789,0.0364935219113182,3799,0,0,0,0,16076,0.01690738535345433,7689,0,0,0,0.0,0,6195,0,1982,246,0,8423,4213,0.08518667195478115,241357,122226,
1950,0.0,31,275,1675,2256,27495,11488,391078,0.06093752369331605,119131,789,0.0364935219113182,3799,0,0,0,0,16076,0.01690738535345433,7689,0,0,0,0.0,0,6195,0,1982,246,0,8423,4213,0.08518667195478115,241357,122226,
1950,0.0,31,275,1675,2256,27495,11488,391078,0.06093752369331605,119131,789,0.0364935219113182,3799,0,0,0,0,16076,0.01690738535345433,7689,0,0,0,0.0,0,6195,0,1982,246,0,8423,4213,0.08518667195478115,241357,122226,
1950,0.0,31,275,1675,2256,27495,11488,391078,0.06093752369331605,119131,789,0.0364935219113182,3799,0,0,0,0,16076,0.01690738535345433,7689,0,0,0,0.0,0,6195,0,1982,246,0,8423,4213,0.08518667195478115,241357,122226,
1950,0.0,31,275,1675,2256,27495,11488,391078,0.06093752369331605,119131,789,0.0364935219113182,3799,0,0,0,0,16076,0.01690738535345433,7689,0,0,0,0.0,0,6195,0,1982,246,0,8423,4213,0.08518667195478115,241357,122226,
1950,0.0,31,275,1675,2256,27495,11488,391078,0.06093752369331605,119131,789,0.0364935219113182,3799,0,0,0,0,16076,0.01690738535345433,7689,0,0,0,0.0,0,6195,0,1982,246,0,8423,4213,0.08518667195478115,241357,122226,
1950,0.0,31,275,1675,2256,27495,11488,391078,0.06093752369331605,119131,789,0.0364935219113182,3799,0,0,0,0,16076,0.01690738535345433,7689,0,0,0,0.0,0,6195,0,1982,246,0,8423,4213,0.08518667195478115,241357,122226,
1950,0.0,31,275,1675,2256,27495,11488,391078,0.06093752369331605,119131,789,0.0364935219113182,3799,0,0,0,0,16076,0.01690738535345433,7689,0,0,0,0.0,0,6195,0,1982,246,0,8423,4213,0.08518667195478115,241357,122226,
1950,0.0,31,275,1675,2256,27495,11488,391078,0.06093752369331605,119131,789,0.0364935219113182,3799,0,0,0,0,16076,0.01690738535345433,7689,0,0,0,0.0,0,6195,0,1982,246,0,8423,4213,0.08518667195478115,241357,122226,
1950,0.0,31,275,1675,2256,27495,11488,391078,0.06093752369331605,119131,789,0.0364935219113182,3799,0,0,0,0,16076,0.01690738535345433,7689,0,0,0,0.0,0,6195,0,1982,246,0,8423,4213,0.08518667195478115,241357,122226,
1950,0.0,31,275,1675,2256,27495,11488,391078,0.06093752369331605,119131,789,0.0364935219113182,3799,0,0,0,0,16076,0.01690738535345433,7689,0,0,0,0.0,0,6195,0,1982,246,0,8423,4213,0.08518667195478115,241357,122226,
1950,0.0,31,275,1675,2256,27495,11488,391078,0.06093752369331605,119131,789,0.0364935219113182,3799,0,0,0,0,16076,0.01690738535345433,7689,0,0,0,0.0,0,6195,0,1982,246,0,8423,4213,0.08518667195478115,241357,122226,
1950,0.0,31,275,1675,2256,27495,11488,391078,0.06093752369331605,119131,789,0.0364935219113182,3799,0,0,0,0,16076,0.01690738535345433,7689,0,0,0,0.0,0,6195,0,1982,246,0,8423,4213,0.08518667195478115,241357,122226,
1950,0.0,31,275,1675,2256,27495,11488,391078,0.06093752369331605,119131,789,0.0364935219113182,3799,0,0,0,0,16076,0.01690738535345433,7689,0,0,0,0.0,0,6195,0,1982,246,0,8423,4213,0.08518667195478115,241357,122226,
1950,0.0,31,275,1675,2256,27495,11488,391078,0.06093752369331605,119131,789,0.0364935219113182,3799,0,0,0,0,16076,0.01690738535345433,7689,0,0,0,0.0,0,6195,0,1982,246,0,8423,4213,0.08518667195478115,241357,122226,
1950,0.0,31,275,1675,2256,27495,11488,391078,0.06093752369331605,119131,789,0.0364935219113182,3799,0,0,0,0,16076,0.01690738535345433,7689,0,0,0,0.0,0,6195,0,1982,246,0,8423,4213,0.08518667195478115,241357,122226,
1950,0.0,31,275,1675,2256,27495,11488,391078,0.06093752369331605,119131,789,0.0364935219113182,3799,0,0,0,0,16076,0.01690738535345433,7689,0,0,0,0.0,0,6195,0,1982,246,0,8423,4213,0.08518667195478115,241357,122226,
1950,0.0,31,275,1675,2256,27495,11488,391078,0.06093752369331605,119131,789,0.0364935219113182,3799,0,0,0,0,16076,0.01690738535345433,7689,0,0,0,0.0,0,6195,0,1982,246,0,8423,4213,0.08518667195478115,241357,122226,
1950,0.0,31,275,1675,2256,27495,11488,391078,0.06093752369331605,119131,789,0.0364935219113182,3799,0,0,0,0,16076,0.01690738535345433,7689,0,0,0,0.0,0,6195,0,1982,246,0,8423,4213,0.08518667195478115,241357,122226,
1950,0.0,31,275,1675,2256,27495,11488,391078,0.06093752369331605,119131,789,0.0364935219113182,3799,0,0,0,0,16076,0.01690738535345433,7689,0,0,0,0.0,0,6195,0,1982,246,0,8423,4213,0.08518667195478115,241357,122226,
1950,0.0,31,275,1675,2256,27495,11488,391078,0.06093752369331605,119131,789,0.0364935219113182,3799,0,0,0,0,16076,0.01690738535345433,7689,0,0,0,0.0,0,6195,0,1982,246,0,8423,4213,0.08518667195478115,241357,122226,
1950,0.0,31,275,1675,2256,27495,11488,391078,0.06093752369331605,119131,789,0.0364935219113182,3799,0,0,0,0,16076,0.01690738535345433,7689,0,0,0,0.0,0,6195,0,1982,246,0,8423,4213,0.08518667195478115,241357,122226,
1950,0.0,31,275,1675,2256,27495,11488,391078,0.06093752369331605,119131,789,0.0364935219113182,3799,0,0,0,0,16076,0.01690738535345433,7689,0,0,0,0.0,0,6195,0,1982,246,0,8423,4213,0.08518667195478115,241357,122226,
1950,0.0,31,275,1675,2256,27495,11488,391078,0.06093752369331605,119131,789,0.0364935219113182,3799,0,0,0,0,16076,0.01690738535345433,7689,0,0,0,0.0,0,6195,0,1982,246,0,8423,4213,0.08518667195478115,241357,122226,
1950,0.0,31,275,1675,2256,27495,11488,391078,0.06093752369331605,119131,789,0.0364935219113182,3799,0,0,0,0,16076,0.01690738535345433,7689,0,0,0,0.0,0,6195,0,1982,246,0,8423,4213,0.08518667195478115,241357,122226,
1950,0.0,31,275,1675,2256,27495,11488,391078,0.06093752369331605,119131,789,0.0364935219113182,3799,0,0,0,0,16076,0.01690738535345433,7689,0,0,0,0.0,0,6195,0,1982,246,0,8423,4213,0.08518667195478115,241357,122226,
1950,0.0,31,275,1675,2256,27495,11488,391078,0.06093752369331605,119131,789,0.0364935219113182,3799,0,0,0,0,16076,0.01690738535345433,7689,0,0,0,0.0,0,6195,0,1982,246,0,8423,4213,0.08518667195478115,241357,122226,
1950,0.0,31,275,1675,2256,27495,11488,391078,0.06093752369331605,119131,789,0.0364935219113182,3799,0,0,0,0,16076,0.01690738535345433,7689,0,0,0,0.0,0,6195,0,1982,246,0,8423,4213,0.08518667195478115,241357,122226,
1950,0.0,31,275,1675,2256,27495,11488,391078,0.06093752369331605,119131,789,0.0364935219113182,3799,0,0,0,0,16076,0.01690738535345433,7689,0,0,0,0.0,0,6195,0,1982,246,0,8423,4213,0.08518667195478115,241357,122226,
1950,0.0,31,275,1675,2256,27495,11488,391078,0.06093752369331605,119131,789,0.0364935219113182,3799,0,0,0,0,16076,0.01690738535345433,7689,0,0,0,0.0,0,6195,0,1982,246,0,8423,4213,0.08518667195478115,241357,122226,
1950,0.0,31,275,1675,2256,27495,11488,391078,0.06093752369331605,119131,789,0.0364935219113182,3799,0,0,0,0,16076,0.01690738535345433,7689,0,0,0,0.0,0,6195,0,1982,246,0,8423,4213,0.08518667195478115,241357,122226,
1950,0.0,31,275,1675,2256,27495,11488,391078,0.06093752369331605,119131,789,0.0364935219113182,3799,0,0,0,0,16076,0.01690738535345433,7689,0,0,0,0.0,0,6195,0,1982,246,0,8423,4213,0.08518667195478115,241357,122226,
1950,0.0,31,275,1675,2256,27495,11488,391078,0.06093752369331605,119131,789,0.0364935219113182,3799,0,0,0,0,16076,0.01690738535345433,7689,0,0,0,0.0,0,6195,0,1982,246,0,8423,4213,0.08518667195478115,241357,122226,
1950,0.0,31,275,1675,2256,27495,11488,391078,0.06093752369331605,119131,789,0.0364935219113182,3799,0,0,0,0,16076,0.01690738535345433,7689,0,0,0,0.0,0,6195,0,1982,246,0,8423,4213,0.08518667195478115,241357,122226,
1950,0.0,31,275,1675,2256,27495,11488,391078,0.06093752369331605,119131,789,0.0364935219113182,3799,0,0,0,0,16076,0.01690738535345433,7689,0,0,0,0.0,0,6195,0,1982,246,0,8423,4213,0.08518667195478115,241357,122226,
1950,0.0,31,275,1675,2256,27495,11488,391078,0.06093752369331605,119131,789,0.0364935219113182,3799,0,0,0,0,16076,0.01690738535345433,7689,0,0,0,0.0,0,6195,0,1982,246,0,8423,4213,0.08518667195478115,241357,122226,
1950,0.0,31,275,1675,2256,27495,11488,391078,0.06093752369331605,119131,789,0.0364935219113182,3799,0,0,0,0,16076,0.01690738535345433,7689,0,0,0,0.0,0,6195,0,1982,246,0,8423,4213,0.08518667195478115,241357,122226,
1950,0.0,31,275,1675,2256,27495,11488,391078,0.06093752369331605,119131,789,0.0364935219113182,3799,0,0,0,0,16076,0.01690738535345433,7689,0,0,0,0.0,0,6195,0,1982,246,0,8423,4213,0.08518667195478115,241357,122226,
1950,0.0,31,275,1675,2256,27495,11488,391078,0.06093752369331605,119131,789,0.0364935219113182,3799,0,0,0,0,16076,0.01690738535345433,7689,0,0,0,0.0,0,6195,0,1982,246,0,8423,4213,0.08518667195478115,241357,122226,
1950,0.0,31,275,1675,2256,27495,11488,391078,0.06093752369331605,119131,789,0.0364935219113182,3799,0,0,0,0,16076,0.01690738535345433,7689,0,0,0,0.0,0,6195,0,1982,246,0,8423,4213,0.08518667195478115,241357,122226,
1950,0.0,31,275,1675,2256,27495,11488,391078,0.06093752369331605,119131,789,0.0364935219113182,3799,0,0,0,0,16076,0.01690738535345433,7689,0,0,0,0.0,0,6195,0,1982,246,0,8423,4213,0.08518667195478115,241357,122226,
1950,0.0,31,275,1675,2256,27495,11488,391078,0.06093752369331605,119131,789,0.0364935219113182,3799,0,0,0,0,16076,0.01690738535345433,7689,0,0,0,0.0,0,6195,0,1982,246,0,8423,4213,0.08518667195478115,241357,122226,
1950,0.0,31,275,1675,2256,27495,11488,391078,0.06093752369331605,119131,789,0.0364935219113182,3799,0,0,0,0,16076,0.01690738535345433,7689,0,0,0,0.0,0,6195,0,1982,246,0,8423,4213,0.08518667195478115,241357,122226,
1950,0.0,31,275,1675,2256,27495,11488,391078,0.06093752369331605,119131,789,0.0364935219113182,3799,0,0,0,0,16076,0.01690738535345433,7689,0,0,0,0.0,0,6195,0,1982,246,0,8423,4213,0.08518667195478115,241357,122226,
1950,0.0,31,275,1675,2256,27495,11488,391078,0.06093752369331605,119131,789,0.0364935219113182,3799,0,0,0,0,16076,0.01690738535345433,7689,0,0,0,0.0,0,6195,0,1982,246,0,8423,4213,0.08518667195478115,241357,122226,
1950,0.0,31,275,1675,2256,27495,11488,391078,0.06093752369331605,119131,789,0.0364935219113182,3799,0,0,0,0,16076,0.01690738535345433,7689,0,0,0,0.0,0,6195,0,1982,246,0,8423,4213,0.08518667195478115,241357,122226,
1950,0.0,31,275,1675,2256,27495,11488,391078,0.06093752369331605,119131,789,0.0364935219113182,3799,0,0,0,0,16076,0.01690738535345433,7689,0,0,0,0.0,0,6195,0,1982,246,0,8423,4213,0.08518667195478115,241357,122226,
1950,0.0,31,275,1675,2256,27495,11488,391078,0.06093752369331605,119131,789,0.0364935219113182,3799,0,0,0,0,16076,0.01690738535345433,7689,0,0,0,0.0,0,6195,0,1982,246,0,8423,4213,0.08518667195478115,241357,122226,
1950,0.0,31,275,1675,2256,27495,11488,391078,0.06093752369331605,119131,789,0.0364935219113182,3799,0,0,0,0,16076,0.01690738535345433,7689,0,0,0,0.0,0,6195,0,1982,246,0,8423,4213,0.08518667195478115,241357,122226,
1950,0.0,31,275,1675,2256,27495,11488,391078,0.06093752369331605,119131,789,0.0364935219113182,3799,0,0,0,0,16076,0.01690738535345433,7689,0,0,0,0.0,0,6195,0,1982,246,0,8423,4213,0.08518667195478115,241357,122226,
1950,0.0,31,275,1675,2256,27495,11488,391078,0.06093752369331605,119131,789,0.0364935219113182,3799,0,0,0,0,16076,0.01690738535345433,7689,0,0,0,0.0,0,6195,0,1982,246,0,8423,4213,0.08518667195478115,241357,122226,
1950,0.0,31,275,1675,2256,27495,11488,391078,0.06093752369331605,119131,789,0.0364935219113182,3799,0,0,0,0,16076,0.01690738535345433,7689,0,0,0,0.0,0,6195,0,1982,246,0,8423,4213,0.08518667195478115,241357,122226,
1950,0.0,31,275,1675,2256,27495,11488,391078,0.06093752369331605,119131,789,0.0364935219113182,3799,0,0,0,0,16076,0.01690738535345433,7689,0,0,0,0.0,0,6195,0,1982,246,0,8423,4213,0.08518667195478115,241357,122226,
1950,0.0,31,275,1675,2256,27495,11488,391078,0.06093752369331605,119131,789,0.0364935219113182,3799,0,0,0,0,16076,0.01690738535345433,7689,0,0,0,0.0,0,6195,0,1982,246,0,8423,4213,0.08518667195478115,241357,122226,
1950,0.0,31,275,1675,2256,27495,11488,391078,0.06093752369331605,119131,789,0.0364935219113182,3799,0,0,0,0,16076,0.01690738535345433,7689,0,0,0,0.0,0,6195,0,1982,246,0,8423,4213,0.08518667195478115,241357,122226,
1950,0.0,31,275,1675,2256,27495,11488,391078,0.06093752369331605,119131,789,0.0364935219113182,3799,0,0,0,0,16076,0.01690738535345433,7689,0,0,0,0.0,0,6195,0,1982,246,0,8423,4213,0.08518667195478115,241357,122226,
1950,0.0,31,275,1675,2256,27495,11488,391078,0.06093752369331605,119131,789,0.0364935219113182,3799,0,0,0,0,16076,0.01690738535345433,7689,0,0,0,0.0,0,6195,0,1982,246,0,8423,4213,0.08518667195478115,241357,122226,
1950,0.0,31,275,1675,2256,27495,11488,391078,0.06093752369331605,119131,789,0.0364935219113182,3799,0,0,0,0,16076,0.01690738535345433,7689,0,0,0,0.0,0,6195,0,1982,246,0,8423,4213,0.08518667195478115,241357,122226,
1950,0.0,31,275,1675,2256,27495,11488,391078,0.06093752369331605,119131,789,0.0364935219113182,3799,0,0,0,0,16076,0.01690738535345433,7689,0,0,0,0.0,0,6195,0,1982,246,0,8423,4213,0.08518667195478115,241357,122226,
1950,0.0,31,275,1675,2256,27495,11488,391078,0.06093752369331605,119131,789,0.0364935219113182,3799,0,0,0,0,16076,0.01690738535345433,7689,0,0,0,0.0,0,6195,0,1982,246,0,8423,4213,0.08518667195478115,241357,122226,
1950,0.0,31,275,1675,2256,27495,11488,391078,0.06093752369331605,119131,789,0.0364935219113182,3799,0,0,0,0,16076,0.01690738535345433,7689,0,0,0,0.0,0,6195,0,1982,246,0,8423,4213,0.08518667195478115,241357,122226,
1950,0.0,31,275,1675,2256,27495,11488,391078,0.06093752369331605,119131,789,0.0364935219113182,3799,0,0,0,0,16076,0.01690738535345433,7689,0,0,0,0.0,0,6195,0,1982,246,0,8423,4213,0.08518667195478115,241357,122226,
1950,0.0,31,275,1675,2256,27495,11488,391078,0.06093752369331605,119131,789,0.0364935219113182,3799,0,0,0,0,16076,0.01690738535345433,7689,0,0,0,0.0,0,6195,0,1982,246,0,8423,4213,0.08518667195478115,241357,122226,
1950,0.0,31,275,1675,2256,27495,11488,391078,0.06093752369331605,119131,789,0.0364935219113182,3799,0,0,0,0,16076,0.01690738535345433,7689,0,0,0,0.0,0,6195,0,1982,246,0,8423,4213,0.08518667195478115,241357,122226,
1950,0.0,31,275,1675,2256,27495,11488,391078,0.06093752369331605,119131,789,0.0364935219113182,3799,0,0,0,0,16076,0.01690738535345433,7689,0,0,0,0.0,0,6195,0,1982,246,0,8423,4213,0.08518667195478115,241357,122226,
1950,0.0,31,275,1675,2256,27495,11488,391078,0.06093752369331605,119131,789,0.0364935219113182,3799,0,0,0,0,16076,0.01690738535345433,7689,0,0,0,0.0,0,6195,0,1982,246,0,8423,4213,0.08518667195478115,241357,122226,
1950,0.0,31,275,1675,2256,27495,11488,391078,0.06093752369331605,119131,789,0.0364935219113182,3799,0,0,0,0,16076,0.01690738535345433,7689,0,0,0,0.0,0,6195,0,1982,246,0,8423,4213,0.08518667195478115,241357,122226,
1950,0.0,31,275,1675,2256,27495,11488,391078,0.06093752369331605,119131,789,0.0364935219113182,3799,0,0,0,0,16076,0.01690738535345433,7689,0,0,0,0.0,0,6195,0,1982,246,0,8423,4213,0.08518667195478115,241357,122226,
1950,0.0,31,275,1675,2256,27495,11488,391078,0.06093752369331605,119131,789,0.0364935219113182,3799,0,0,0,0,16076,0.01690738535345433,7689,0,0,0,0.0,0,6195,0,1982,246,0,8423,4213,0.08518667195478115,241357,122226,
1950,0.0,31,275,1675,2256,27495,11488,391078,0.06093752369331605,119131,789,0.0364935219113182,3799,0,0,0,0,16076,0.01690738535345433,7689,0,0,0,0.0,0,6195,0,1982,246,0,8423,4213,0.08518667195478115,241357,122226,
1950,0.0,31,275,1675,2256,27495,11488,391078,0.06093752369331605,119131,789,0.0364935219113182,3799,0,0,0,0,16076,0.01690738535345433,7689,0,0,0,0.0,0,6195,0,1982,246,0,8423,4213,0.08518667195478115,241357,122226,
1950,0.0,31,275,1675,2256,27495,11488,391078,0.06093752369331605,119131,789,0.0364935219113182,3799,0,0,0,0,16076,0.01690738535345433,7689,0,0,0,0.0,0,6195,0,1982,246,0,8423,4213,0.08518667195478115,241357,122226,
1950,0.0,31,275,1675,2256,27495,11488,391078,0.06093752369331605,119131,789,0.0364935219113182,3799,0,0,0,0,16076,0.01690738535345433,7689,0,0,0,0.0,0,6195,0,1982,246,0,8423,4213,0.08518667195478115,241357,122226,
1950,0.0,31,275,1675,2256,27495,11488,391078,0.06093752369331605,119131,789,0.0364935219113182,3799,0,0,0,0,16076,0.01690738535345433,7689,0,0,0,0.0,0,6195,0,1982,246,0,8423,4213,0.08518667195478115,241357,122226,
1950,0.0,31,275,1675,2256,27495,11488,391078,0.06093752369331605,119131,789,0.0364935219113182,3799,0,0,0,0,16076,0.01690738535345433,7689,0,0,0,0.0,0,6195,0,1982,246,0,8423,4213,0.08518667195478115,241357,122226,
1950,0.0,31,275,1675,2256,27495,11488,391078,0.06093752369331605,119131,789,0.0364935219113182,3799,0,0,0,0,16076,0.01690738535345433,7689,0,0,0,0.0,0,6195,0,1982,246,0,8423,4213,0.08518667195478115,241357,122226,
1950,0.0,31,275,1675,2256,27495,11488,391078,0.06093752369331605,119131,789,0.0364935219113182,3799,0,0,0,0,16076,0.01690738535345433,7689,0,0,0,0.0,0,6195,0,1982,246,0,8423,4213,0.08518667195478115,241357,122226,
1950,0.0,31,275,1675,2256,27495,11488,391078,0.06093752369331605,119131,789,0.0364935219113182,3799,0,0,0,0,16076,0.01690738535345433,7689,0,0,0,0.0,0,6195,0,1982,246,0,8423,4213,0.08518667195478115,241357,122226,
1950,0.0,31,275,1675,2256,27495,11488,391078,0.06093752369331605,119131,789,0.0364935219113182,3799,0,0,0,0,16076,0.01690738535345433,7689,0,0,0,0.0,0,6195,0,1982,246,0,8423,4213,0.08518667195478115,241357,122226,
1950,0.0,31,275,1675,2256,27495,11488,391078,0.06093752369331605,119131,789,0.0364935219113182,3799,0,0,0,0,16076,0.01690738535345433,7689,0,0,0,0.0,0,6195,0,1982,246,0,8423,4213,0.08518667195478115,241357,122226,
1950,0.0,31,275,1675,2256,27495,11488,391078,0.06093752369331605,119131,789,0.0364935219113182,3799,0,0,0,0,16076,0.01690738535345433,7689,0,0,0,0.0,0,6195,0,1982,246,0,8423,4213,0.08518667195478115,241357,122226,
1950,0.0,31,275,1675,2256,27495,11488,391078,0.06093752369331605,119131,789,0.0364935219113182,3799,0,0,0,0,16076,0.01690738535345433,7689,0,0,0,0.0,0,6195,0,1982,246,0,8423,4213,0.08518667195478115,241357,122226,
1950,0.0,31,275,1675,2256,27495,11488,391078,0.06093752369331605,119131,789,0.0364935219113182,3799,0,0,0,0,16076,0.01690738535345433,7689,0,0,0,0.0,0,6195,0,1982,246,0,8423,4213,0.08518667195478115,241357,122226,
1950,0.0,31,275,1675,2256,27495,11488,391078,0.06093752369331605,119131,789,0.0364935219113182,3799,0,0,0,0,16076,0.01690738535345433,7689,0,0,0,0.0,0,6195,0,1982,246,0,8423,4213,0.08518667195478115,241357,122226,
1950,0.0,31,275,1675,2256,27495,11488,391078,0.06093752369331605,119131,789,0.0364935219113182,3799,0,0,0,0,16076,0.01690738535345433,7689,0,0,0,0.0,0,6195,0,1982,246,0,8423,4213,0.08518667195478115,241357,122226,
1950,0.0,31,275,1675,2256,27495,11488,391078,0.06093752369331605,119131,789,0.0364935219113182,3799,0,0,0,0,16076,0.01690738535345433,7689,0,0,0,0.0,0,6195,0,1982,246,0,8423,4213,0.08518667195478115,241357,122226,
1950,0.0,31,275,1675,2256,27495,11488,391078,0.06093752369331605,119131,789,0.0364935219113182,3799,0,0,0,0,16076,0.01690738535345433,7689,0,0,0,0.0,0,6195,0,1982,246,0,8423,4213,0.08518667195478115,241357,122226,
1950,0.0,31,275,1675,2256,27495,11488,391078,0.06093752369331605,119131,789,0.0364935219113182,3799,0,0,0,0,16076,0.01690738535345433,7689,0,0,0,0.0,0,6195,0,1982,246,0,8423,4213,0.08518667195478115,241357,122226,
1950,0.0,31,275,1675,2256,27495,11488,391078,0.06093752369331605,119131,789,0.0364935219113182,3799,0,0,0,0,16076,0.01690738535345433,7689,0,0,0,0.0,0,6195,0,1982,246,0,8423,4213,0.08518667195478115,241357,122226,
1950,0.0,31,275,1675,2256,27495,11488,391078,0.06093752369331605,119131,789,0.0364935219113182,3799,0,0,0,0,16076,0.01690738535345433,7689,0,0,0,0.0,0,6195,0,1982,246,0,8423,4213,0.08518667195478115,241357,122226,
1950,0.0,31,275,1675,2256,27495,11488,391078,0.06093752369331605,119131,789,0.0364935219113182,3799,0,0,0,0,16076,0.01690738535345433,7689,0,0,0,0.0,0,6195,0,1982,246,0,8423,4213,0.08518667195478115,241357,122226,
1950,0.0,31,275,1675,2256,27495,11488,391078,0.06093752369331605,119131,789,0.0364935219113182,3799,0,0,0,0,16076,0.01690738535345433,7689,0,0,0,0.0,0,6195,0,1982,246,0,8423,4213,0.08518667195478115,241357,122226,
1950,0.0,31,275,1675,2256,27495,11488,391078,0.06093752369331605,119131,789,0.0364935219113182,3799,0,0,0,0,16076,0.01690738535345433,7689,0,0,0,0.0,0,6195,0,1982,246,0,8423,4213,0.08518667195478115,241357,122226,
1950,0.0,31,275,1675,2256,27495,11488,391078,0.06093752369331605,119131,789,0.0364935219113182,3799,0,0,0,0,16076,0.01690738535345433,7689,0,0,0,0.0,0,6195,0,1982,246,0,8423,4213,0.08518667195478115,241357,122226,
1950,0.0,31,275,1675,2256,27495,11488,391078,0.06093752369331605,119131,789,0.0364935219113182,3799,0,0,0,0,16076,0.01690738535345433,7689,0,0,0,0.0,0,6195,0,1982,246,0,8423,4213,0.08518667195478115,241357,122226,
1950,0.0,31,275,1675,2256,27495,11488,391078,0.06093752369331605,119131,789,0.0364935219113182,3799,0,0,0,0,16076,0.01690738535345433,7689,0,0,0,0.0,0,6195,0,1982,246,0,8423,4213,0.08518667195478115,241357,122226,
1950,0.0,31,275,1675,2256,27495,11488,391078,0.06093752369331605,119131,789,0.0364935219113182,3799,0,0,0,0,16076,0.01690738535345433,7689,0,0,0,0.0,0,6195,0,1982,246,0,8423,4213,0.08518667195478115,241357,122226,
1950,0.0,31,275,1675,2256,27495,11488,391078,0.06093752369331605,119131,789,0.0364935219113182,3799,0,0,0,0,16076,0.01690738535345433,7689,0,0,0,0.0,0,6195,0,1982,246,0,8423,4213,0.08518667195478115,241357,122226,
1950,0.0,31,275,1675,2256,27495,11488,391078,0.06093752369331605,119131,789,0.0364935219113182,3799,0,0,0,0,16076,0.01690738535345433,7689,0,0,0,0.0,0,6195,0,1982,246,0,8423,4213,0.08518667195478115,241357,122226,
1950,0.0,31,275,1675,2256,27495,11488,391078,0.06093752369331605,119131,789,0.0364935219113182,3799,0,0,0,0,16076,0.01690738535345433,7689,0,0,0,0.0,0,6195,0,1982,246,0,8423,4213,0.08518667195478115,241357,122226,
1950,0.0,31,275,1675,2256,27495,11488,391078,0.06093752369331605,119131,789,0.0364935219113182,3799,0,0,0,0,16076,0.01690738535345433,7689,0,0,0,0.0,0,6195,0,1982,246,0,8423,4213,0.08518667195478115,241357,122226,
1950,0.0,31,275,1675,2256,27495,11488,391078,0.06093752369331605,119131,789,0.0364935219113182,3799,0,0,0,0,16076,0.01690738535345433,7689,0,0,0,0.0,0,6195,0,1982,246,0,8423,4213,0.08518667195478115,241357,122226,
1950,0.0,31,275,1675,2256,27495,11488,391078,0.06093752369331605,119131,789,0.0364935219113182,3799,0,0,0,0,16076,0.01690738535345433,7689,0,0,0,0.0,0,6195,0,1982,246,0,8423,4213,0.08518667195478115,241357,122226,
1950,0.0,31,275,1675,2256,27495,11488,391078,0.06093752369331605,119131,789,0.0364935219113182,3799,0,0,0,0,16076,0.01690738535345433,7689,0,0,0,0.0,0,6195,0,1982,246,0,8423,4213,0.08518667195478115,241357,122226,
1950,0.0,31,275,1675,2256,27495,11488,391078,0.06093752369331605,119131,789,0.0364935219113182,3799,0,0,0,0,16076,0.01690738535345433,7689,0,0,0,0.0,0,6195,0,1982,246,0,8423,4213,0.08518667195478115,241357,122226,
1950,0.0,31,275,1675,2256,27495,11488,391078,0.06093752369331605,119131,789,0.0364935219113182,3799,0,0,0,0,16076,0.01690738535345433,7689,0,0,0,0.0,0,6195,0,1982,246,0,8423,4213,0.08518667195478115,241357,122226,
1950,0.0,31,275,1675,2256,27495,11488,391078,0.06093752369331605,119131,789,0.0364935219113182,3799,0,0,0,0,16076,0.01690738535345433,7689,0,0,0,0.0,0,6195,0,1982,246,0,8423,4213,0.08518667195478115,241357,122226,
1950,0.0,31,275,1675,2256,27495,11488,391078,0.06093752369331605,119131,789,0.0364935219113182,3799,0,0,0,0,16076,0.01690738535345433,7689,0,0,0,0.0,0,6195,0,1982,246,0,8423,4213,0.08518667195478115,241357,122226,
1950,0.0,31,275,1675,2256,27495,11488,391078,0.06093752369331605,119131,789,0.0364935219113182,3799,0,0,0,0,16076,0.01690738535345433,7689,0,0,0,0.0,0,6195,0,1982,246,0,8423,4213,0.08518667195478115,241357,122226,
1950,0.0,31,275,1675,2256,27495,11488,391078,0.06093752369331605,119131,789,0.0364935219113182,3799,0,0,0,0,16076,0.01690738535345433,7689,0,0,0,0.0,0,6195,0,1982,246,0,8423,4213,0.08518667195478115,241357,122226,
1950,0.0,31,275,1675,2256,27495,11488,391078,0.06093752369331605,119131,789,0.0364935219113182,3799,0,0,0,0,16076,0.01690738535345433,7689,0,0,0,0.0,0,6195,0,1982,246,0,8423,4213,0.08518667195478115,241357,122226,
1950,0.0,31,275,1675,2256,27495,11488,391078,0.06093752369331605,119131,789,0.0364935219113182,3799,0,0,0,0,16076,0.01690738535345433,7689,0,0,0,0.0,0,6195,0,1982,246,0,8423,4213,0.08518667195478115,241357,122226,
1950,0.0,31,275,1675,2256,27495,11488,391078,0.06093752369331605,119131,789,0.0364935219113182,3799,0,0,0,0,16076,0.01690738535345433,7689,0,0,0,0.0,0,6195,0,1982,246,0,8423,4213,0.08518667195478115,241357,122226,
1950,0.0,31,275,1675,2256,27495,11488,391078,0.06093752369331605,119131,789,0.0364935219113182,3799,0,0,0,0,16076,0.01690738535345433,7689,0,0,0,0.0,0,6195,0,1982,246,0,8423,4213,0.08518667195478115,241357,122226,
1950,0.0,31,275,1675,2256,27495,11488,391078,0.06093752369331605,119131,789,0.0364935219113182,3799,0,0,0,0,16076,0.01690738535345433,7689,0,0,0,0.0,0,6195,0,1982,246,0,8423,4213,0.08518667195478115,241357,122226,
1950,0.0,31,275,1675,2256,27495,11488,391078,0.06093752369331605,119131,789,0.0364935219113182,3799,0,0,0,0,16076,0.01690738535345433,7689,0,0,0,0.0,0,6195,0,1982,246,0,8423,4213,0.08518667195478115,241357,122226,
1950,0.0,31,275,1675,2256,27495,11488,391078,0.06093752369331605,119131,789,0.0364935219113182,3799,0,0,0,0,16076,0.01690738535345433,7689,0,0,0,0.0,0,6195,0,1982,246,0,8423,4213,0.08518667195478115,241357,122226,
1950,0.0,31,275,1675,2256,27495,11488,391078,0.06093752369331605,119131,789,0.0364935219113182,3799,0,0,0,0,16076,0.01690738535345433,7689,0,0,0,0.0,0,6195,0,1982,246,0,8423,4213,0.08518667195478115,241357,122226,
1950,0.0,31,275,1675,2256,27495,11488,391078,0.06093752369331605,119131,789,0.0364935219113182,3799,0,0,0,0,16076,0.01690738535345433,7689,0,0,0,0.0,0,6195,0,1982,246,0,8423,4213,0.08518667195478115,241357,122226,
1950,0.0,31,275,1675,2256,27495,11488,391078,0.06093752369331605,119131,789,0.0364935219113182,3799,0,0,0,0,16076,0.01690738535345433,7689,0,0,0,0.0,0,6195,0,1982,246,0,8423,4213,0.08518667195478115,241357,122226,
1950,0.0,31,275,1675,2256,27495,11488,391078,0.06093752369331605,119131,789,0.0364935219113182,3799,0,0,0,0,16076,0.01690738535345433,7689,0,0,0,0.0,0,6195,0,1982,246,0,8423,4213,0.08518667195478115,241357,122226,
1950,0.0,31,275,1675,2256,27495,11488,391078,0.06093752369331605,119131,789,0.0364935219113182,3799,0,0,0,0,16076,0.01690738535345433,7689,0,0,0,0.0,0,6195,0,1982,246,0,8423,4213,0.08518667195478115,241357,122226,
1950,0.0,31,275,1675,2256,27495,11488,391078,0.06093752369331605,119131,789,0.0364935219113182,3799,0,0,0,0,16076,0.01690738535345433,7689,0,0,0,0.0,0,6195,0,1982,246,0,8423,4213,0.08518667195478115,241357,122226,
1950,0.0,31,275,1675,2256,27495,11488,391078,0.06093752369331605,119131,789,0.0364935219113182,3799,0,0,0,0,16076,0.01690738535345433,7689,0,0,0,0.0,0,6195,0,1982,246,0,8423,4213,0.08518667195478115,241357,122226,
1950,0.0,31,275,1675,2256,27495,11488,391078,0.06093752369331605,119131,789,0.0364935219113182,3799,0,0,0,0,16076,0.01690738535345433,7689,0,0,0,0.0,0,6195,0,1982,246,0,8423,4213,0.08518667195478115,241357,122226,
1950,0.0,31,275,1675,2256,27495,11488,391078,0.06093752369331605,119131,789,0.0364935219113182,3799,0,0,0,0,16076,0.01690738535345433,7689,0,0,0,0.0,0,6195,0,1982,246,0,8423,4213,0.08518667195478115,241357,122226,
1950,0.0,31,275,1675,2256,27495,11488,391078,0.06093752369331605,119131,789,0.0364935219113182,3799,0,0,0,0,16076,0.01690738535345433,7689,0,0,0,0.0,0,6195,0,1982,246,0,8423,4213,0.08518667195478115,241357,122226,
1950,0.0,31,275,1675,2256,27495,11488,391078,0.06093752369331605,119131,789,0.0364935219113182,3799,0,0,0,0,16076,0.01690738535345433,7689,0,0,0,0.0,0,6195,0,1982,246,0,8423,4213,0.08518667195478115,241357,122226,
1950,0.0,31,275,1675,2256,27495,11488,391078,0.06093752369331605,119131,789,0.0364935219113182,3799,0,0,0,0,16076,0.01690738535345433,7689,0,0,0,0.0,0,6195,0,1982,246,0,8423,4213,0.08518667195478115,241357,122226,
1950,0.0,31,275,1675,2256,27495,11488,391078,0.06093752369331605,119131,789,0.0364935219113182,3799,0,0,0,0,16076,0.01690738535345433,7689,0,0,0,0.0,0,6195,0,1982,246,0,8423,4213,0.08518667195478115,241357,122226,
1950,0.0,31,275,1675,2256,27495,11488,391078,0.06093752369331605,119131,789,0.0364935219113182,3799,0,0,0,0,16076,0.01690738535345433,7689,0,0,0,0.0,0,6195,0,1982,246,0,8423,4213,0.08518667195478115,241357,122226,
1950,0.0,31,275,1675,2256,27495,11488,391078,0.06093752369331605,119131,789,0.0364935219113182,3799,0,0,0,0,16076,0.01690738535345433,7689,0,0,0,0.0,0,6195,0,1982,246,0,8423,4213,0.08518667195478115,241357,122226,
1950,0.0,31,275,1675,2256,27495,11488,391078,0.06093752369331605,119131,789,0.0364935219113182,3799,0,0,0,0,16076,0.01690738535345433,7689,0,0,0,0.0,0,6195,0,1982,246,0,8423,4213,0.08518667195478115,241357,122226,
1950,0.0,31,275,1675,2256,27495,11488,391078,0.06093752369331605,119131,789,0.0364935219113182,3799,0,0,0,0,16076,0.01690738535345433,7689,0,0,0,0.0,0,6195,0,1982,246,0,8423,4213,0.08518667195478115,241357,122226,
1950,0.0,31,275,1675,2256,27495,11488,391078,0.06093752369331605,119131,789,0.0364935219113182,3799,0,0,0,0,16076,0.01690738535345433,7689,0,0,0,0.0,0,6195,0,1982,246,0,8423,4213,0.08518667195478115,241357,122226,
1950,0.0,31,275,1675,2256,27495,11488,391078,0.06093752369331605,119131,789,0.0364935219113182,3799,0,0,0,0,16076,0.01690738535345433,7689,0,0,0,0.0,0,6195,0,1982,246,0,8423,4213,0.08518667195478115,241357,122226,
1950,0.0,31,275,1675,2256,27495,11488,391078,0.06093752369331605,119131,789,0.0364935219113182,3799,0,0,0,0,16076,0.01690738535345433,7689,0,0,0,0.0,0,6195,0,1982,246,0,8423,4213,0.08518667195478115,241357,122226,
1950,0.0,31,275,1675,2256,27495,11488,391078,0.06093752369331605,119131,789,0.0364935219113182,3799,0,0,0,0,16076,0.01690738535345433,7689,0,0,0,0.0,0,6195,0,1982,246,0,8423,4213,0.08518667195478115,241357,122226,
1950,0.0,31,275,1675,2256,27495,11488,391078,0.06093752369331605,119131,789,0.0364935219113182,3799,0,0,0,0,16076,0.01690738535345433,7689,0,0,0,0.0,0,6195,0,1982,246,0,8423,4213,0.08518667195478115,241357,122226,
1950,0.0,31,275,1675,2256,27495,11488,391078,0.06093752369331605,119131,789,0.0364935219113182,3799,0,0,0,0,16076,0.01690738535345433,7689,0,0,0,0.0,0,6195,0,1982,246,0,8423,4213,0.08518667195478115,241357,122226,
1950,0.0,31,275,1675,2256,27495,11488,391078,0.06093752369331605,119131,789,0.0364935219113182,3799,0,0,0,0,16076,0.01690738535345433,7689,0,0,0,0.0,0,6195,0,1982,246,0,8423,4213,0.08518667195478115,241357,122226,
1950,0.0,31,275,1675,2256,27495,11488,391078,0.06093752369331605,119131,789,0.0364935219113182,3799,0,0,0,0,16076,0.01690738535345433,7689,0,0,0,0.0,0,6195,0,1982,246,0,8423,4213,0.08518667195478115,241357,122226,
1950,0.0,31,275,1675,2256,27495,11488,391078,0.06093752369331605,119131,789,0.0364935219113182,3799,0,0,0,0,16076,0.01690738535345433,7689,0,0,0,0.0,0,6195,0,1982,246,0,8423,4213,0.08518667195478115,241357,122226,
1950,0.0,31,275,1675,2256,27495,11488,391078,0.06093752369331605,119131,789,0.0364935219113182,3799,0,0,0,0,16076,0.01690738535345433,7689,0,0,0,0.0,0,6195,0,1982,246,0,8423,4213,0.08518667195478115,241357,122226,
1950,0.0,31,275,1675,2256,27495,11488,391078,0.06093752369331605,119131,789,0.0364935219113182,3799,0,0,0,0,16076,0.01690738535345433,7689,0,0,0,0.0,0,6195,0,1982,246,0,8423,4213,0.08518667195478115,241357,122226,
1950,0.0,31,275,1675,2256,27495,11488,391078,0.06093752369331605,119131,789,0.0364935219113182,3799,0,0,0,0,16076,0.01690738535345433,7689,0,0,0,0.0,0,6195,0,1982,246,0,8423,4213,0.08518667195478115,241357,122226,
1950,0.0,31,275,1675,2256,27495,11488,391078,0.06093752369331605,119131,789,0.0364935219113182,3799,0,0,0,0,16076,0.01690738535345433,7689,0,0,0,0.0,0,6195,0,1982,246,0,8423,4213,0.08518667195478115,241357,122226,
1950,0.0,31,275,1675,2256,27495,11488,391078,0.06093752369331605,119131,789,0.0364935219113182,3799,0,0,0,0,16076,0.01690738535345433,7689,0,0,0,0.0,0,6195,0,1982,246,0,8423,4213,0.08518667195478115,241357,122226,
1950,0.0,31,275,1675,2256,27495,11488,391078,0.06093752369331605,119131,789,0.0364935219113182,3799,0,0,0,0,16076,0.01690738535345433,7689,0,0,0,0.0,0,6195,0,1982,246,0,8423,4213,0.08518667195478115,241357,122226,
1950,0.0,31,275,1675,2256,27495,11488,391078,0.06093752369331605,119131,789,0.0364935219113182,3799,0,0,0,0,16076,0.01690738535345433,7689,0,0,0,0.0,0,6195,0,1982,246,0,8423,4213,0.08518667195478115,241357,122226,
1950,0.0,31,275,1675,2256,27495,11488,391078,0.06093752369331605,119131,789,0.0364935219113182,3799,0,0,0,0,16076,0.01690738535345433,7689,0,0,0,0.0,0,6195,0,1982,246,0,8423,4213,0.08518667195478115,241357,122226,
1950,0.0,31,275,1675,2256,27495,11488,391078,0.06093752369331605,119131,789,0.0364935219113182,3799,0,0,0,0,16076,0.01690738535345433,7689,0,0,0,0.0,0,6195,0,1982,246,0,8423,4213,0.08518667195478115,241357,122226,
1950,0.0,31,275,1675,2256,27495,11488,391078,0.06093752369331605,119131,789,0.0364935219113182,3799,0,0,0,0,16076,0.01690738535345433,7689,0,0,0,0.0,0,6195,0,1982,246,0,8423,4213,0.08518667195478115,241357,122226,
1950,0.0,31,275,1675,2256,27495,11488,391078,0.06093752369331605,119131,789,0.0364935219113182,3799,0,0,0,0,16076,0.01690738535345433,7689,0,0,0,0.0,0,6195,0,1982,246,0,8423,4213,0.08518667195478115,241357,122226,
1950,0.0,31,275,1675,2256,27495,11488,391078,0.06093752369331605,119131,789,0.0364935219113182,3799,0,0,0,0,16076,0.01690738535345433,7689,0,0,0,0.0,0,6195,0,1982,246,0,8423,4213,0.08518667195478115,241357,122226,
1950,0.0,31,275,1675,2256,27495,11488,391078,0.06093752369331605,119131,789,0.0364935219113182,3799,0,0,0,0,16076,0.01690738535345433,7689,0,0,0,0.0,0,6195,0,1982,246,0,8423,4213,0.08518667195478115,241357,122226,
1950,0.0,31,275,1675,2256,27495,11488,391078,0.06093752369331605,119131,789,0.0364935219113182,3799,0,0,0,0,16076,0.01690738535345433,7689,0,0,0,0.0,0,6195,0,1982,246,0,8423,4213,0.08518667195478115,241357,122226,
1950,0.0,31,275,1675,2256,27495,11488,391078,0.06093752369331605,119131,789,0.0364935219113182,3799,0,0,0,0,16076,0.01690738535345433,7689,0,0,0,0.0,0,6195,0,1982,246,0,8423,4213,0.08518667195478115,241357,122226,
1950,0.0,31,275,1675,2256,27495,11488,391078,0.06093752369331605,119131,789,0.0364935219113182,3799,0,0,0,0,16076,0.01690738535345433,7689,0,0,0,0.0,0,6195,0,1982,246,0,8423,4213,0.08518667195478115,241357,122226,
1950,0.0,31,275,1675,2256,27495,11488,391078,0.06093752369331605,119131,789,0.0364935219113182,3799,0,0,0,0,16076,0.01690738535345433,7689,0,0,0,0.0,0,6195,0,1982,246,0,8423,4213,0.08518667195478115,241357,122226,
1950,0.0,31,275,1675,2256,27495,11488,391078,0.06093752369331605,119131,789,0.0364935219113182,3799,0,0,0,0,16076,0.01690738535345433,7689,0,0,0,0.0,0,6195,0,1982,246,0,8423,4213,0.08518667195478115,241357,122226,
1950,0.0,31,275,1675,2256,27495,11488,391078,0.06093752369331605,119131,789,0.0364935219113182,3799,0,0,0,0,16076,0.01690738535345433,7689,0,0,0,0.0,0,6195,0,1982,246,0,8423,4213,0.08518667195478115,241357,122226,
1950,0.0,31,275,1675,2256,27495,11488,391078,0.06093752369331605,119131,789,0.0364935219113182,3799,0,0,0,0,16076,0.01690738535345433,7689,0,0,0,0.0,0,6195,0,1982,246,0,8423,4213,0.08518667195478115,241357,122226,
1950,0.0,31,275,1675,2256,27495,11488,391078,0.06093752369331605,119131,789,0.0364935219113182,3799,0,0,0,0,16076,0.01690738535345433,7689,0,0,0,0.0,0,6195,0,1982,246,0,8423,4213,0.08518667195478115,241357,122226,
1950,0.0,31,275,1675,2256,27495,11488,391078,0.06093752369331605,119131,789,0.0364935219113182,3799,0,0,0,0,16076,0.01690738535345433,7689,0,0,0,0.0,0,6195,0,1982,246,0,8423,4213,0.08518667195478115,241357,122226,
1950,0.0,31,275,1675,2256,27495,11488,391078,0.06093752369331605,119131,789,0.0364935219113182,3799,0,0,0,0,16076,0.01690738535345433,7689,0,0,0,0.0,0,6195,0,1982,246,0,8423,4213,0.08518667195478115,241357,122226,
1950,0.0,31,275,1675,2256,27495,11488,391078,0.06093752369331605,119131,789,0.0364935219113182,3799,0,0,0,0,16076,0.01690738535345433,7689,0,0,0,0.0,0,6195,0,1982,246,0,8423,4213,0.08518667195478115,241357,122226,
1950,0.0,31,275,1675,2256,27495,11488,391078,0.06093752369331605,119131,789,0.0364935219113182,3799,0,0,0,0,16076,0.01690738535345433,7689,0,0,0,0.0,0,6195,0,1982,246,0,8423,4213,0.08518667195478115,241357,122226,
1950,0.0,31,275,1675,2256,27495,11488,391078,0.06093752369331605,119131,789,0.0364935219113182,3799,0,0,0,0,16076,0.01690738535345433,7689,0,0,0,0.0,0,6195,0,1982,246,0,8423,4213,0.08518667195478115,241357,122226,
1950,0.0,31,275,1675,2256,27495,11488,391078,0.06093752369331605,119131,789,0.0364935219113182,3799,0,0,0,0,16076,0.01690738535345433,7689,0,0,0,0.0,0,6195,0,1982,246,0,8423,4213,0.08518667195478115,241357,122226,
1950,0.0,31,275,1675,2256,27495,11488,391078,0.06093752369331605,119131,789,0.0364935219113182,3799,0,0,0,0,16076,0.01690738535345433,7689,0,0,0,0.0,0,6195,0,1982,246,0,8423,4213,0.08518667195478115,241357,122226,
1950,0.0,31,275,1675,2256,27495,11488,391078,0.06093752369331605,119131,789,0.0364935219113182,3799,0,0,0,0,16076,0.01690738535345433,7689,0,0,0,0.0,0,6195,0,1982,246,0,8423,4213,0.08518667195478115,241357,122226,
1950,0.0,31,275,1675,2256,27495,11488,391078,0.06093752369331605,119131,789,0.0364935219113182,3799,0,0,0,0,16076,0.01690738535345433,7689,0,0,0,0.0,0,6195,0,1982,246,0,8423,4213,0.08518667195478115,241357,122226,
1950,0.0,31,275,1675,2256,27495,11488,391078,0.06093752369331605,119131,789,0.0364935219113182,3799,0,0,0,0,16076,0.01690738535345433,7689,0,0,0,0.0,0,6195,0,1982,246,0,8423,4213,0.08518667195478115,241357,122226,
1950,0.0,31,275,1675,2256,27495,11488,391078,0.06093752369331605,119131,789,0.0364935219113182,3799,0,0,0,0,16076,0.01690738535345433,7689,0,0,0,0.0,0,6195,0,1982,246,0,8423,4213,0.08518667195478115,241357,122226,
1950,0.0,31,275,1675,2256,27495,11488,391078,0.06093752369331605,119131,789,0.0364935219113182,3799,0,0,0,0,16076,0.01690738535345433,7689,0,0,0,0.0,0,6195,0,1982,246,0,8423,4213,0.08518667195478115,241357,122226,
1950,0.0,31,275,1675,2256,27495,11488,391078,0.06093752369331605,119131,789,0.0364935219113182,3799,0,0,0,0,16076,0.01690738535345433,7689,0,0,0,0.0,0,6195,0,1982,246,0,8423,4213,0.08518667195478115,241357,122226,
1950,0.0,31,275,1675,2256,27495,11488,391078,0.06093752369331605,119131,789,0.0364935219113182,3799,0,0,0,0,16076,0.01690738535345433,7689,0,0,0,0.0,0,6195,0,1982,246,0,8423,4213,0.08518667195478115,241357,122226,
1950,0.0,31,275,1675,2256,27495,11488,391078,0.06093752369331605,119131,789,0.0364935219113182,3799,0,0,0,0,16076,0.01690738535345433,7689,0,0,0,0.0,0,6195,0,1982,246,0,8423,4213,0.08518667195478115,241357,122226,
1950,0.0,31,275,1675,2256,27495,11488,391078,0.06093752369331605,119131,789,0.0364935219113182,3799,0,0,0,0,16076,0.01690738535345433,7689,0,0,0,0.0,0,6195,0,1982,246,0,8423,4213,0.08518667195478115,241357,122226,
1950,0.0,31,275,1675,2256,27495,11488,391078,0.06093752369331605,119131,789,0.0364935219113182,3799,0,0,0,0,16076,0.01690738535345433,7689,0,0,0,0.0,0,6195,0,1982,246,0,8423,4213,0.08518667195478115,241357,122226,
1950,0.0,31,275,1675,2256,27495,11488,391078,0.06093752369331605,119131,789,0.0364935219113182,3799,0,0,0,0,16076,0.01690738535345433,7689,0,0,0,0.0,0,6195,0,1982,246,0,8423,4213,0.08518667195478115,241357,122226,
1950,0.0,31,275,1675,2256,27495,11488,391078,0.06093752369331605,119131,789,0.0364935219113182,3799,0,0,0,0,16076,0.01690738535345433,7689,0,0,0,0.0,0,6195,0,1982,246,0,8423,4213,0.08518667195478115,241357,122226,
1950,0.0,31,275,1675,2256,27495,11488,391078,0.06093752369331605,119131,789,0.0364935219113182,3799,0,0,0,0,16076,0.01690738535345433,7689,0,0,0,0.0,0,6195,0,1982,246,0,8423,4213,0.08518667195478115,241357,122226,
1950,0.0,31,275,1675,2256,27495,11488,391078,0.06093752369331605,119131,789,0.0364935219113182,3799,0,0,0,0,16076,0.01690738535345433,7689,0,0,0,0.0,0,6195,0,1982,246,0,8423,4213,0.08518667195478115,241357,122226,
1950,0.0,31,275,1675,2256,27495,11488,391078,0.06093752369331605,119131,789,0.0364935219113182,3799,0,0,0,0,16076,0.01690738535345433,7689,0,0,0,0.0,0,6195,0,1982,246,0,8423,4213,0.08518667195478115,241357,122226,
1950,0.0,31,275,1675,2256,27495,11488,391078,0.06093752369331605,119131,789,0.0364935219113182,3799,0,0,0,0,16076,0.01690738535345433,7689,0,0,0,0.0,0,6195,0,1982,246,0,8423,4213,0.08518667195478115,241357,122226,
1950,0.0,31,275,1675,2256,27495,11488,391078,0.06093752369331605,119131,789,0.0364935219113182,3799,0,0,0,0,16076,0.01690738535345433,7689,0,0,0,0.0,0,6195,0,1982,246,0,8423,4213,0.08518667195478115,241357,122226,
1950,0.0,31,275,1675,2256,27495,11488,391078,0.06093752369331605,119131,789,0.0364935219113182,3799,0,0,0,0,16076,0.01690738535345433,7689,0,0,0,0.0,0,6195,0,1982,246,0,8423,4213,0.08518667195478115,241357,122226,
1950,0.0,31,275,1675,2256,27495,11488,391078,0.06093752369331605,119131,789,0.0364935219113182,3799,0,0,0,0,16076,0.01690738535345433,7689,0,0,0,0.0,0,6195,0,1982,246,0,8423,4213,0.08518667195478115,241357,122226,
1950,0.0,31,275,1675,2256,27495,11488,391078,0.06093752369331605,119131,789,0.0364935219113182,3799,0,0,0,0,16076,0.01690738535345433,7689,0,0,0,0.0,0,6195,0,1982,246,0,8423,4213,0.08518667195478115,241357,122226,
1950,0.0,31,275,1675,2256,27495,11488,391078,0.06093752369331605,119131,789,0.0364935219113182,3799,0,0,0,0,16076,0.01690738535345433,7689,0,0,0,0.0,0,6195,0,1982,246,0,8423,4213,0.08518667195478115,241357,122226,
1950,0.0,31,275,1675,2256,27495,11488,391078,0.06093752369331605,119131,789,0.0364935219113182,3799,0,0,0,0,16076,0.01690738535345433,7689,0,0,0,0.0,0,6195,0,1982,246,0,8423,4213,0.08518667195478115,241357,122226,
1950,0.0,31,275,1675,2256,27495,11488,391078,0.06093752369331605,119131,789,0.0364935219113182,3799,0,0,0,0,16076,0.01690738535345433,7689,0,0,0,0.0,0,6195,0,1982,246,0,8423,4213,0.08518667195478115,241357,122226,
1950,0.0,31,275,1675,2256,27495,11488,391078,0.06093752369331605,119131,789,0.0364935219113182,3799,0,0,0,0,16076,0.01690738535345433,7689,0,0,0,0.0,0,6195,0,1982,246,0,8423,4213,0.08518667195478115,241357,122226,
1950,0.0,31,275,1675,2256,27495,11488,391078,0.06093752369331605,119131,789,0.0364935219113182,3799,0,0,0,0,16076,0.01690738535345433,7689,0,0,0,0.0,0,6195,0,1982,246,0,8423,4213,0.08518667195478115,241357,122226,
1950,0.0,31,275,1675,2256,27495,11488,391078,0.06093752369331605,119131,789,0.0364935219113182,3799,0,0,0,0,16076,0.01690738535345433,7689,0,0,0,0.0,0,6195,0,1982,246,0,8423,4213,0.08518667195478115,241357,122226,
1950,0.0,31,275,1675,2256,27495,11488,391078,0.06093752369331605,119131,789,0.0364935219113182,3799,0,0,0,0,16076,0.01690738535345433,7689,0,0,0,0.0,0,6195,0,1982,246,0,8423,4213,0.08518667195478115,241357,122226,
1950,0.0,31,275,1675,2256,27495,11488,391078,0.06093752369331605,119131,789,0.0364935219113182,3799,0,0,0,0,16076,0.01690738535345433,7689,0,0,0,0.0,0,6195,0,1982,246,0,8423,4213,0.08518667195478115,241357,122226,
1950,0.0,31,275,1675,2256,27495,11488,391078,0.06093752369331605,119131,789,0.0364935219113182,3799,0,0,0,0,16076,0.01690738535345433,7689,0,0,0,0.0,0,6195,0,1982,246,0,8423,4213,0.08518667195478115,241357,122226,
1950,0.0,31,275,1675,2256,27495,11488,391078,0.06093752369331605,119131,789,0.0364935219113182,3799,0,0,0,0,16076,0.01690738535345433,7689,0,0,0,0.0,0,6195,0,1982,246,0,8423,4213,0.08518667195478115,241357,122226,
1950,0.0,31,275,1675,2256,27495,11488,391078,0.06093752369331605,119131,789,0.0364935219113182,3799,0,0,0,0,16076,0.01690738535345433,7689,0,0,0,0.0,0,6195,0,1982,246,0,8423,4213,0.08518667195478115,241357,122226,
1950,0.0,31,275,1675,2256,27495,11488,391078,0.06093752369331605,119131,789,0.0364935219113182,3799,0,0,0,0,16076,0.01690738535345433,7689,0,0,0,0.0,0,6195,0,1982,246,0,8423,4213,0.08518667195478115,241357,122226,
1950,0.0,31,275,1675,2256,27495,11488,391078,0.06093752369331605,119131,789,0.0364935219113182,3799,0,0,0,0,16076,0.01690738535345433,7689,0,0,0,0.0,0,6195,0,1982,246,0,8423,4213,0.08518667195478115,241357,122226,
1950,0.0,31,275,1675,2256,27495,11488,391078,0.06093752369331605,119131,789,0.0364935219113182,3799,0,0,0,0,16076,0.01690738535345433,7689,0,0,0,0.0,0,6195,0,1982,246,0,8423,4213,0.08518667195478115,241357,122226,
1950,0.0,31,275,1675,2256,27495,11488,391078,0.06093752369331605,119131,789,0.0364935219113182,3799,0,0,0,0,16076,0.01690738535345433,7689,0,0,0,0.0,0,6195,0,1982,246,0,8423,4213,0.08518667195478115,241357,122226,
1950,0.0,31,275,1675,2256,27495,11488,391078,0.06093752369331605,119131,789,0.0364935219113182,3799,0,0,0,0,16076,0.01690738535345433,7689,0,0,0,0.0,0,6195,0,1982,246,0,8423,4213,0.08518667195478115,241357,122226,
1950,0.0,31,275,1675,2256,27495,11488,391078,0.06093752369331605,119131,789,0.0364935219113182,3799,0,0,0,0,16076,0.01690738535345433,7689,0,0,0,0.0,0,6195,0,1982,246,0,8423,4213,0.08518667195478115,241357,122226,
1950,0.0,31,275,1675,2256,27495,11488,391078,0.06093752369331605,119131,789,0.0364935219113182,3799,0,0,0,0,16076,0.01690738535345433,7689,0,0,0,0.0,0,6195,0,1982,246,0,8423,4213,0.08518667195478115,241357,122226,
1950,0.0,31,275,1675,2256,27495,11488,391078,0.06093752369331605,119131,789,0.0364935219113182,3799,0,0,0,0,16076,0.01690738535345433,7689,0,0,0,0.0,0,6195,0,1982,246,0,8423,4213,0.08518667195478115,241357,122226,
1950,0.0,31,275,1675,2256,27495,11488,391078,0.06093752369331605,119131,789,0.0364935219113182,3799,0,0,0,0,16076,0.01690738535345433,7689,0,0,0,0.0,0,6195,0,1982,246,0,8423,4213,0.08518667195478115,241357,122226,
1950,0.0,31,275,1675,2256,27495,11488,391078,0.06093752369331605,119131,789,0.0364935219113182,3799,0,0,0,0,16076,0.01690738535345433,7689,0,0,0,0.0,0,6195,0,1982,246,0,8423,4213,0.08518667195478115,241357,122226,
1950,0.0,31,275,1675,2256,27495,11488,391078,0.06093752369331605,119131,789,0.0364935219113182,3799,0,0,0,0,16076,0.01690738535345433,7689,0,0,0,0.0,0,6195,0,1982,246,0,8423,4213,0.08518667195478115,241357,122226,
1950,0.14606771577297462,31,275,1675,2256,27495,11488,391078,0.06093752369331605,119131,789,0.0364935219113182,3799,607,326,53,986,16076,0.01690738535345433,7689,52,281,49,0.10247466747263148,121,6195,20,1982,246,-3,8423,4213,0.08518667195478115,241357,122226,
1950,0.09092387768379961,31,275,1675,2256,27495,11488,391078,0.06093752369331605,119131,789,0.0364935219113182,3799,18,12,0,30,16076,0.01690738535345433,7689,10,6,18,0.10228258512253308,28,6195,0,1982,246,8,8423,4213,0.08518667195478115,241357,122226,
1950,0.12215009803161475,31,275,1675,2256,27495,11488,391078,0.06093752369331605,119131,789,0.0364935219113182,3799,279,96,6,381,16076,0.01690738535345433,7689,96,183,279,0.12215009803161475,381,6195,6,1982,246,183,8423,4213,0.08518667195478115,241357,122226,
1950,0.0,31,275,1675,2256,27495,11488,391078,0.06093752369331605,119131,789,0.0364935219113182,3799,43,0,0,43,16076,0.01690738535345433,7689,0,43,0,0.034345047923322686,0,6195,0,1982,246,0,8423,4213,0.08518667195478115,241357,122226,
679,0.03869969040247678,9,153,526,841,27495,11488,391078,0.028589849169396338,119131,789,0.0364935219113182,3799,50,0,0,50,16076,0.01690738535345433,7689,0,50,50,0.03869969040247678,50,806,0,175,9,50,990,631,0.02979972249239855,241357,122226,
679,0.07009901205041599,9,153,526,841,27495,11488,391078,0.028589849169396338,119131,789,0.0364935219113182,3799,138,82,2,222,16076,0.01690738535345433,7689,81,56,136,0.05983447661503819,219,806,2,175,9,55,990,631,0.02979972249239855,241357,122226,
679,0.07009901205041599,9,153,526,841,27495,11488,391078,0.028589849169396338,119131,789,0.0364935219113182,3799,138,82,2,222,16076,0.01690738535345433,7689,81,56,136,0.05983447661503819,219,806,2,175,9,55,990,631,0.02979972249239855,241357,122226,
580,0.16493055555555555,16,235,345,831,27495,11488,391078,0.028546698061849694,119131,789,0.0364935219113182,3799,254,199,6,459,16076,0.01690738535345433,7689,0,55,10,0.08347919632581359,10,8125,0,3609,613,10,12347,4516,0.047029209250948355,241357,122226,
580,0.16418194808287687,16,235,345,831,27495,11488,391078,0.028546698061849694,119131,789,0.0364935219113182,3799,287,164,38,489,16076,0.01690738535345433,7689,25,123,24,0.10026969154254226,49,8125,0,3609,613,-1,12347,4516,0.047029209250948355,241357,122226,
580,0.01935483870967742,16,235,345,831,27495,11488,391078,0.028546698061849694,119131,789,0.0364935219113182,3799,174,9,0,183,16076,0.01690738535345433,7689,2,165,1,0.06475251775613154,3,8125,0,3609,613,-1,12347,4516,0.047029209250948355,241357,122226,
580,0.01935483870967742,16,235,345,831,27495,11488,391078,0.028546698061849694,119131,789,0.0364935219113182,3799,174,9,0,183,16076,0.01690738535345433,7689,2,165,1,0.06475251775613154,3,8125,0,3609,613,-1,12347,4516,0.047029209250948355,241357,122226,
580,0.029899420908259675,16,235,345,831,27495,11488,391078,0.028546698061849694,119131,789,0.0364935219113182,3799,394,48,0,442,16076,0.01690738535345433,7689,2,346,7,0.09759452668760621,9,8125,0,3609,613,5,12347,4516,0.047029209250948355,241357,122226,
580,0.0,16,235,345,831,27495,11488,391078,0.028546698061849694,119131,789,0.0364935219113182,3799,26,20,5,51,16076,0.01690738535345433,7689,0,6,0,0.01413586992857141,0,8125,0,3609,613,0,12347,4516,0.047029209250948355,241357,122226,
580,0.0,16,235,345,831,27495,11488,391078,0.028546698061849694,119131,789,0.0364935219113182,3799,49,0,0,49,16076,0.01690738535345433,7689,0,49,0,0.1821561338289963,0,8125,0,3609,613,0,12347,4516,0.047029209250948355,241357,122226,
580,0.0,16,235,345,831,27495,11488,391078,0.028546698061849694,119131,789,0.0364935219113182,3799,49,0,0,49,16076,0.01690738535345433,7689,0,49,0,0.1821561338289963,0,8125,0,3609,613,0,12347,4516,0.047029209250948355,241357,122226,
580,0.0,16,235,345,831,27495,11488,391078,0.028546698061849694,119131,789,0.0364935219113182,3799,67,0,0,67,16076,0.01690738535345433,7689,0,67,0,0.08874172185430464,0,8125,0,3609,613,0,12347,4516,0.047029209250948355,241357,122226,
580,0.0,16,235,345,831,27495,11488,391078,0.028546698061849694,119131,789,0.0364935219113182,3799,67,0,0,67,16076,0.01690738535345433,7689,0,67,0,0.08874172185430464,0,8125,0,3609,613,0,12347,4516,0.047029209250948355,241357,122226,
580,0.0,16,235,345,831,27495,11488,391078,0.028546698061849694,119131,789,0.0364935219113182,3799,83,4,1,88,16076,0.01690738535345433,7689,0,79,0,0.016787441324929153,0,8125,0,3609,613,0,12347,4516,0.047029209250948355,241357,122226,
580,0.05874124757143624,16,235,345,831,27495,11488,391078,0.028546698061849694,119131,789,0.0364935219113182,3799,1055,595,84,1734,16076,0.01690738535345433,7689,40,460,17,0.09085801332776514,59,8125,2,3609,613,-23,12347,4516,0.047029209250948355,241357,122226,
580,0.0,16,235,345,831,27495,11488,391078,0.028546698061849694,119131,789,0.0364935219113182,3799,117,0,0,117,16076,0.01690738535345433,7689,0,117,0,0.12942477876106195,0,8125,0,3609,613,0,12347,4516,0.047029209250948355,241357,122226,
580,0.21514828618451418,16,235,345,831,27495,11488,391078,0.028546698061849694,119131,789,0.0364935219113182,3799,2275,1104,323,3702,16076,0.01690738535345433,7689,10,1171,54,0.14701661232562047,64,8125,0,3609,613,44,12347,4516,0.047029209250948355,241357,122226,
580,0.21514828618451418,16,235,345,831,27495,11488,391078,0.028546698061849694,119131,789,0.0364935219113182,3799,2275,1104,323,3702,16076,0.01690738535345433,7689,10,1171,54,0.14701661232562047,64,8125,0,3609,613,44,12347,4516,0.047029209250948355,241357,122226,
580,0.21514828618451418,16,235,345,831,27495,11488,391078,0.028546698061849694,119131,789,0.0364935219113182,3799,2275,1104,323,3702,16076,0.01690738535345433,7689,10,1171,54,0.14701661232562047,64,8125,0,3609,613,44,12347,4516,0.047029209250948355,241357,122226,
580,0.21514828618451418,16,235,345,831,27495,11488,391078,0.028546698061849694,119131,789,0.0364935219113182,3799,2275,1104,323,3702,16076,0.01690738535345433,7689,10,1171,54,0.14701661232562047,64,8125,0,3609,613,44,12347,4516,0.047029209250948355,241357,122226,
580,0.21514828618451418,16,235,345,831,27495,11488,391078,0.028546698061849694,119131,789,0.0364935219113182,3799,2275,1104,323,3702,16076,0.01690738535345433,7689,10,1171,54,0.14701661232562047,64,8125,0,3609,613,44,12347,4516,0.047029209250948355,241357,122226,
580,0.0,16,235,345,831,27495,11488,391078,0.028546698061849694,119131,789,0.0364935219113182,3799,243,0,0,243,16076,0.01690738535345433,7689,0,243,0,0.07925636007827788,0,8125,0,3609,613,0,12347,4516,0.047029209250948355,241357,122226,
0,0.0,0,0,0,0,27495,11488,391078,0.0,119131,789,0.0364935219113182,3799,0,0,0,0,16076,0.01690738535345433,7689,0,0,0,0.0,0,0,0,0,0,0,0,0,0.0,241357,122226,
512,0.045454545454545456,17,392,120,921,27495,11488,391078,0.024682590151370254,119131,789,0.0364935219113182,3799,2,2,1,5,16076,0.01690738535345433,7689,0,0,0,0.08522727272727273,1,31384,1,15492,4269,0,51145,15892,0.049780316119266775,241357,122226,
512,0.029411764705882353,17,392,120,921,27495,11488,391078,0.024682590151370254,119131,789,0.0364935219113182,3799,639,265,18,922,16076,0.01690738535345433,7689,1,374,0,0.1402891072940549,1,31384,0,15492,4269,-1,51145,15892,0.049780316119266775,241357,122226,
512,0.029411764705882353,17,392,120,921,27495,11488,391078,0.024682590151370254,119131,789,0.0364935219113182,3799,639,265,18,922,16076,0.01690738535345433,7689,1,374,0,0.1402891072940549,1,31384,0,15492,4269,-1,51145,15892,0.049780316119266775,241357,122226,
512,0.029411764705882353,17,392,120,921,27495,11488,391078,0.024682590151370254,119131,789,0.0364935219113182,3799,639,265,18,922,16076,0.01690738535345433,7689,1,374,0,0.1402891072940549,1,31384,0,15492,4269,-1,51145,15892,0.049780316119266775,241357,122226,
512,0.029411764705882353,17,392,120,921,27495,11488,391078,0.024682590151370254,119131,789,0.0364935219113182,3799,639,265,18,922,16076,0.01690738535345433,7689,1,374,0,0.1402891072940549,1,31384,0,15492,4269,-1,51145,15892,0.049780316119266775,241357,122226,
512,0.0,17,392,120,921,27495,11488,391078,0.024682590151370254,119131,789,0.0364935219113182,3799,88,109,26,223,16076,0.01690738535345433,7689,0,-21,0,0.11558522185234943,0,31384,0,15492,4269,0,51145,15892,0.049780316119266775,241357,122226,
512,0.043478260869565216,17,392,120,921,27495,11488,391078,0.024682590151370254,119131,789,0.0364935219113182,3799,474,115,75,664,16076,0.01690738535345433,7689,1,359,1,0.18384399543921542,2,31384,0,15492,4269,0,51145,15892,0.049780316119266775,241357,122226,
512,0.043478260869565216,17,392,120,921,27495,11488,391078,0.024682590151370254,119131,789,0.0364935219113182,3799,474,115,75,664,16076,0.01690738535345433,7689,1,359,1,0.18384399543921542,2,31384,0,15492,4269,0,51145,15892,0.049780316119266775,241357,122226,
512,0.0,17,392,120,921,27495,11488,391078,0.024682590151370254,119131,789,0.0364935219113182,3799,3,3,0,6,16076,0.01690738535345433,7689,0,0,0,0.00452147701582517,0,31384,0,15492,4269,0,51145,15892,0.049780316119266775,241357,122226,
512,0.021739130434782608,17,392,120,921,27495,11488,391078,0.024682590151370254,119131,789,0.0364935219113182,3799,413,169,78,660,16076,0.01690738535345433,7689,1,244,0,0.11560944618702762,1,31384,0,15492,4269,-1,51145,15892,0.049780316119266775,241357,122226,
512,0.0,17,392,120,921,27495,11488,391078,0.024682590151370254,119131,789,0.0364935219113182,3799,22,2,0,24,16076,0.01690738535345433,7689,0,20,0,0.0029511154855643047,0,31384,0,15492,4269,0,51145,15892,0.049780316119266775,241357,122226,
512,0.23064036592338477,17,392,120,921,27495,11488,391078,0.024682590151370254,119131,789,0.0364935219113182,3799,6983,4079,2510,13572,16076,0.01690738535345433,7689,5,2904,22,0.18736778590061728,33,31384,6,15492,4269,17,51145,15892,0.049780316119266775,241357,122226,
512,0.23064036592338477,17,392,120,921,27495,11488,391078,0.024682590151370254,119131,789,0.0364935219113182,3799,6983,4079,2510,13572,16076,0.01690738535345433,7689,5,2904,22,0.18736778590061728,33,31384,6,15492,4269,17,51145,15892,0.049780316119266775,241357,122226,
512,0.23064036592338477,17,392,120,921,27495,11488,391078,0.024682590151370254,119131,789,0.0364935219113182,3799,6983,4079,2510,13572,16076,0.01690738535345433,7689,5,2904,22,0.18736778590061728,33,31384,6,15492,4269,17,51145,15892,0.049780316119266775,241357,122226,
512,0.23064036592338477,17,392,120,921,27495,11488,391078,0.024682590151370254,119131,789,0.0364935219113182,3799,6983,4079,2510,13572,16076,0.01690738535345433,7689,5,2904,22,0.18736778590061728,33,31384,6,15492,4269,17,51145,15892,0.049780316119266775,241357,122226,
512,0.23064036592338477,17,392,120,921,27495,11488,391078,0.024682590151370254,119131,789,0.0364935219113182,3799,6983,4079,2510,13572,16076,0.01690738535345433,7689,5,2904,22,0.18736778590061728,33,31384,6,15492,4269,17,51145,15892,0.049780316119266775,241357,122226,
512,0.23064036592338477,17,392,120,921,27495,11488,391078,0.024682590151370254,119131,789,0.0364935219113182,3799,6983,4079,2510,13572,16076,0.01690738535345433,7689,5,2904,22,0.18736778590061728,33,31384,6,15492,4269,17,51145,15892,0.049780316119266775,241357,122226,
512,0.23064036592338477,17,392,120,921,27495,11488,391078,0.024682590151370254,119131,789,0.0364935219113182,3799,6983,4079,2510,13572,16076,0.01690738535345433,7689,5,2904,22,0.18736778590061728,33,31384,6,15492,4269,17,51145,15892,0.049780316119266775,241357,122226,
512,0.23064036592338477,17,392,120,921,27495,11488,391078,0.024682590151370254,119131,789,0.0364935219113182,3799,6983,4079,2510,13572,16076,0.01690738535345433,7689,5,2904,22,0.18736778590061728,33,31384,6,15492,4269,17,51145,15892,0.049780316119266775,241357,122226,
512,0.23064036592338477,17,392,120,921,27495,11488,391078,0.024682590151370254,119131,789,0.0364935219113182,3799,6983,4079,2510,13572,16076,0.01690738535345433,7689,5,2904,22,0.18736778590061728,33,31384,6,15492,4269,17,51145,15892,0.049780316119266775,241357,122226,
512,0.23064036592338477,17,392,120,921,27495,11488,391078,0.024682590151370254,119131,789,0.0364935219113182,3799,6983,4079,2510,13572,16076,0.01690738535345433,7689,5,2904,22,0.18736778590061728,33,31384,6,15492,4269,17,51145,15892,0.049780316119266775,241357,122226,
512,0.14744801512287334,17,392,120,921,27495,11488,391078,0.024682590151370254,119131,789,0.0364935219113182,3799,1864,1172,32,3068,16076,0.01690738535345433,7689,39,692,39,0.10359598475862325,78,31384,0,15492,4269,0,51145,15892,0.049780316119266775,241357,122226,
512,0.14744801512287334,17,392,120,921,27495,11488,391078,0.024682590151370254,119131,789,0.0364935219113182,3799,1864,1172,32,3068,16076,0.01690738535345433,7689,39,692,39,0.10359598475862325,78,31384,0,15492,4269,0,51145,15892,0.049780316119266775,241357,122226,
512,0.14744801512287334,17,392,120,921,27495,11488,391078,0.024682590151370254,119131,789,0.0364935219113182,3799,1864,1172,32,3068,16076,0.01690738535345433,7689,39,692,39,0.10359598475862325,78,31384,0,15492,4269,0,51145,15892,0.049780316119266775,241357,122226,
512,0.14744801512287334,17,392,120,921,27495,11488,391078,0.024682590151370254,119131,789,0.0364935219113182,3799,1864,1172,32,3068,16076,0.01690738535345433,7689,39,692,39,0.10359598475862325,78,31384,0,15492,4269,0,51145,15892,0.049780316119266775,241357,122226,
512,0.14744801512287334,17,392,120,921,27495,11488,391078,0.024682590151370254,119131,789,0.0364935219113182,3799,1864,1172,32,3068,16076,0.01690738535345433,7689,39,692,39,0.10359598475862325,78,31384,0,15492,4269,0,51145,15892,0.049780316119266775,241357,122226,
512,0.14744801512287334,17,392,120,921,27495,11488,391078,0.024682590151370254,119131,789,0.0364935219113182,3799,1864,1172,32,3068,16076,0.01690738535345433,7689,39,692,39,0.10359598475862325,78,31384,0,15492,4269,0,51145,15892,0.049780316119266775,241357,122226,
512,0.14744801512287334,17,392,120,921,27495,11488,391078,0.024682590151370254,119131,789,0.0364935219113182,3799,1864,1172,32,3068,16076,0.01690738535345433,7689,39,692,39,0.10359598475862325,78,31384,0,15492,4269,0,51145,15892,0.049780316119266775,241357,122226,
512,0.14744801512287334,17,392,120,921,27495,11488,391078,0.024682590151370254,119131,789,0.0364935219113182,3799,1864,1172,32,3068,16076,0.01690738535345433,7689,39,692,39,0.10359598475862325,78,31384,0,15492,4269,0,51145,15892,0.049780316119266775,241357,122226,
512,0.14744801512287334,17,392,120,921,27495,11488,391078,0.024682590151370254,119131,789,0.0364935219113182,3799,1864,1172,32,3068,16076,0.01690738535345433,7689,39,692,39,0.10359598475862325,78,31384,0,15492,4269,0,51145,15892,0.049780316119266775,241357,122226,
512,0.14744801512287334,17,392,120,921,27495,11488,391078,0.024682590151370254,119131,789,0.0364935219113182,3799,1864,1172,32,3068,16076,0.01690738535345433,7689,39,692,39,0.10359598475862325,78,31384,0,15492,4269,0,51145,15892,0.049780316119266775,241357,122226,
512,0.14744801512287334,17,392,120,921,27495,11488,391078,0.024682590151370254,119131,789,0.0364935219113182,3799,1864,1172,32,3068,16076,0.01690738535345433,7689,39,692,39,0.10359598475862325,78,31384,0,15492,4269,0,51145,15892,0.049780316119266775,241357,122226,
512,0.14744801512287334,17,392,120,921,27495,11488,391078,0.024682590151370254,119131,789,0.0364935219113182,3799,1864,1172,32,3068,16076,0.01690738535345433,7689,39,692,39,0.10359598475862325,78,31384,0,15492,4269,0,51145,15892,0.049780316119266775,241357,122226,
512,0.14744801512287334,17,392,120,921,27495,11488,391078,0.024682590151370254,119131,789,0.0364935219113182,3799,1864,1172,32,3068,16076,0.01690738535345433,7689,39,692,39,0.10359598475862325,78,31384,0,15492,4269,0,51145,15892,0.049780316119266775,241357,122226,
512,0.14744801512287334,17,392,120,921,27495,11488,391078,0.024682590151370254,119131,789,0.0364935219113182,3799,1864,1172,32,3068,16076,0.01690738535345433,7689,39,692,39,0.10359598475862325,78,31384,0,15492,4269,0,51145,15892,0.049780316119266775,241357,122226,
512,0.14744801512287334,17,392,120,921,27495,11488,391078,0.024682590151370254,119131,789,0.0364935219113182,3799,1864,1172,32,3068,16076,0.01690738535345433,7689,39,692,39,0.10359598475862325,78,31384,0,15492,4269,0,51145,15892,0.049780316119266775,241357,122226,
512,0.14744801512287334,17,392,120,921,27495,11488,391078,0.024682590151370254,119131,789,0.0364935219113182,3799,1864,1172,32,3068,16076,0.01690738535345433,7689,39,692,39,0.10359598475862325,78,31384,0,15492,4269,0,51145,15892,0.049780316119266775,241357,122226,
512,0.14744801512287334,17,392,120,921,27495,11488,391078,0.024682590151370254,119131,789,0.0364935219113182,3799,1864,1172,32,3068,16076,0.01690738535345433,7689,39,692,39,0.10359598475862325,78,31384,0,15492,4269,0,51145,15892,0.049780316119266775,241357,122226,
512,0.0,17,392,120,921,27495,11488,391078,0.024682590151370254,119131,789,0.0364935219113182,3799,190,259,0,449,16076,0.01690738535345433,7689,0,-69,0,0.04521255811907155,0,31384,0,15492,4269,0,51145,15892,0.049780316119266775,241357,122226,
512,0.2041847215535227,17,392,120,921,27495,11488,391078,0.024682590151370254,119131,789,0.0364935219113182,3799,377,265,4,646,16076,0.01690738535345433,7689,97,112,63,0.06804923767153305,164,31384,4,15492,4269,-34,51145,15892,0.049780316119266775,241357,122226,
512,0.2041847215535227,17,392,120,921,27495,11488,391078,0.024682590151370254,119131,789,0.0364935219113182,3799,377,265,4,646,16076,0.01690738535345433,7689,97,112,63,0.06804923767153305,164,31384,4,15492,4269,-34,51145,15892,0.049780316119266775,241357,122226,
512,0.06756756756756757,17,392,120,921,27495,11488,391078,0.024682590151370254,119131,789,0.0364935219113182,3799,371,296,38,705,16076,0.01690738535345433,7689,10,75,0,0.07708806522176377,10,31384,0,15492,4269,-10,51145,15892,0.049780316119266775,241357,122226,
512,0.0,17,392,120,921,27495,11488,391078,0.024682590151370254,119131,789,0.0364935219113182,3799,84,17,4,105,16076,0.01690738535345433,7689,0,67,0,0.07610811678312394,0,31384,0,15492,4269,0,51145,15892,0.049780316119266775,241357,122226,
512,0.0,17,392,120,921,27495,11488,391078,0.024682590151370254,119131,789,0.0364935219113182,3799,14,3,1,18,16076,0.01690738535345433,7689,0,11,0,0.13081809188302287,0,31384,0,15492,4269,0,51145,15892,0.049780316119266775,241357,122226,
512,0.0,17,392,120,921,27495,11488,391078,0.024682590151370254,119131,789,0.0364935219113182,3799,14,3,1,18,16076,0.01690738535345433,7689,0,11,0,0.13081809188302287,0,31384,0,15492,4269,0,51145,15892,0.049780316119266775,241357,122226,
512,0.14747243725076237,17,392,120,921,27495,11488,391078,0.024682590151370254,119131,789,0.0364935219113182,3799,672,449,39,1160,16076,0.01690738535345433,7689,18,223,11,0.13057773300939682,29,31384,0,15492,4269,-7,51145,15892,0.049780316119266775,241357,122226,
512,0.14747243725076237,17,392,120,921,27495,11488,391078,0.024682590151370254,119131,789,0.0364935219113182,3799,672,449,39,1160,16076,0.01690738535345433,7689,18,223,11,0.13057773300939682,29,31384,0,15492,4269,-7,51145,15892,0.049780316119266775,241357,122226,
512,0.0,17,392,120,921,27495,11488,391078,0.024682590151370254,119131,789,0.0364935219113182,3799,89,66,0,155,16076,0.01690738535345433,7689,0,23,0,0.15173807203628886,0,31384,0,15492,4269,0,51145,15892,0.049780316119266775,241357,122226,
512,0.0,17,392,120,921,27495,11488,391078,0.024682590151370254,119131,789,0.0364935219113182,3799,89,66,0,155,16076,0.01690738535345433,7689,0,23,0,0.15173807203628886,0,31384,0,15492,4269,0,51145,15892,0.049780316119266775,241357,122226,
512,0.0,17,392,120,921,27495,11488,391078,0.024682590151370254,119131,789,0.0364935219113182,3799,83,17,0,100,16076,0.01690738535345433,7689,0,66,0,0.05797937639146909,0,31384,0,15492,4269,0,51145,15892,0.049780316119266775,241357,122226,
512,0.06981361025523983,17,392,120,921,27495,11488,391078,0.024682590151370254,119131,789,0.0364935219113182,3799,441,107,3,551,16076,0.01690738535345433,7689,69,334,9,0.07421386836301354,78,31384,0,15492,4269,-60,51145,15892,0.049780316119266775,241357,122226,
512,0.3236994219653179,17,392,120,921,27495,11488,391078,0.024682590151370254,119131,789,0.0364935219113182,3799,392,294,32,718,16076,0.01690738535345433,7689,12,98,40,0.20112882082368194,56,31384,4,15492,4269,28,51145,15892,0.049780316119266775,241357,122226,
512,0.3236994219653179,17,392,120,921,27495,11488,391078,0.024682590151370254,119131,789,0.0364935219113182,3799,392,294,32,718,16076,0.01690738535345433,7689,12,98,40,0.20112882082368194,56,31384,4,15492,4269,28,51145,15892,0.049780316119266775,241357,122226,
512,0.3236994219653179,17,392,120,921,27495,11488,391078,0.024682590151370254,119131,789,0.0364935219113182,3799,392,294,32,718,16076,0.01690738535345433,7689,12,98,40,0.20112882082368194,56,31384,4,15492,4269,28,51145,15892,0.049780316119266775,241357,122226,
512,0.3236994219653179,17,392,120,921,27495,11488,391078,0.024682590151370254,119131,789,0.0364935219113182,3799,392,294,32,718,16076,0.01690738535345433,7689,12,98,40,0.20112882082368194,56,31384,4,15492,4269,28,51145,15892,0.049780316119266775,241357,122226,
512,0.3236994219653179,17,392,120,921,27495,11488,391078,0.024682590151370254,119131,789,0.0364935219113182,3799,392,294,32,718,16076,0.01690738535345433,7689,12,98,40,0.20112882082368194,56,31384,4,15492,4269,28,51145,15892,0.049780316119266775,241357,122226,
512,0.3236994219653179,17,392,120,921,27495,11488,391078,0.024682590151370254,119131,789,0.0364935219113182,3799,392,294,32,718,16076,0.01690738535345433,7689,12,98,40,0.20112882082368194,56,31384,4,15492,4269,28,51145,15892,0.049780316119266775,241357,122226,
512,0.3236994219653179,17,392,120,921,27495,11488,391078,0.024682590151370254,119131,789,0.0364935219113182,3799,392,294,32,718,16076,0.01690738535345433,7689,12,98,40,0.20112882082368194,56,31384,4,15492,4269,28,51145,15892,0.049780316119266775,241357,122226,
512,0.004761904761904762,17,392,120,921,27495,11488,391078,0.024682590151370254,119131,789,0.0364935219113182,3799,42,40,1,83,16076,0.01690738535345433,7689,1,2,1,0.07230513693004642,2,31384,0,15492,4269,0,51145,15892,0.049780316119266775,241357,122226,
512,0.004761904761904762,17,392,120,921,27495,11488,391078,0.024682590151370254,119131,789,0.0364935219113182,3799,42,40,1,83,16076,0.01690738535345433,7689,1,2,1,0.07230513693004642,2,31384,0,15492,4269,0,51145,15892,0.049780316119266775,241357,122226,
512,0.004761904761904762,17,392,120,921,27495,11488,391078,0.024682590151370254,119131,789,0.0364935219113182,3799,42,40,1,83,16076,0.01690738535345433,7689,1,2,1,0.07230513693004642,2,31384,0,15492,4269,0,51145,15892,0.049780316119266775,241357,122226,
512,0.004761904761904762,17,392,120,921,27495,11488,391078,0.024682590151370254,119131,789,0.0364935219113182,3799,42,40,1,83,16076,0.01690738535345433,7689,1,2,1,0.07230513693004642,2,31384,0,15492,4269,0,51145,15892,0.049780316119266775,241357,122226,
512,0.004761904761904762,17,392,120,921,27495,11488,391078,0.024682590151370254,119131,789,0.0364935219113182,3799,42,40,1,83,16076,0.01690738535345433,7689,1,2,1,0.07230513693004642,2,31384,0,15492,4269,0,51145,15892,0.049780316119266775,241357,122226,
512,0.004761904761904762,17,392,120,921,27495,11488,391078,0.024682590151370254,119131,789,0.0364935219113182,3799,42,40,1,83,16076,0.01690738535345433,7689,1,2,1,0.07230513693004642,2,31384,0,15492,4269,0,51145,15892,0.049780316119266775,241357,122226,
512,0.0,17,392,120,921,27495,11488,391078,0.024682590151370254,119131,789,0.0364935219113182,3799,1171,581,388,2140,16076,0.01690738535345433,7689,0,590,0,0.13282379073856163,0,31384,0,15492,4269,0,51145,15892,0.049780316119266775,241357,122226,
512,0.0,17,392,120,921,27495,11488,391078,0.024682590151370254,119131,789,0.0364935219113182,3799,1171,581,388,2140,16076,0.01690738535345433,7689,0,590,0,0.13282379073856163,0,31384,0,15492,4269,0,51145,15892,0.049780316119266775,241357,122226,
512,0.0,17,392,120,921,27495,11488,391078,0.024682590151370254,119131,789,0.0364935219113182,3799,1171,581,388,2140,16076,0.01690738535345433,7689,0,590,0,0.13282379073856163,0,31384,0,15492,4269,0,51145,15892,0.049780316119266775,241357,122226,
512,0.0,17,392,120,921,27495,11488,391078,0.024682590151370254,119131,789,0.0364935219113182,3799,1171,581,388,2140,16076,0.01690738535345433,7689,0,590,0,0.13282379073856163,0,31384,0,15492,4269,0,51145,15892,0.049780316119266775,241357,122226,
512,0.0034423407917383822,17,392,120,921,27495,11488,391078,0.024682590151370254,119131,789,0.0364935219113182,3799,16,20,0,36,16076,0.01690738535345433,7689,1,-4,1,0.001627389829498058,2,31384,0,15492,4269,0,51145,15892,0.049780316119266775,241357,122226,
512,0.0034423407917383822,17,392,120,921,27495,11488,391078,0.024682590151370254,119131,789,0.0364935219113182,3799,16,20,0,36,16076,0.01690738535345433,7689,1,-4,1,0.001627389829498058,2,31384,0,15492,4269,0,51145,15892,0.049780316119266775,241357,122226,
512,0.0034423407917383822,17,392,120,921,27495,11488,391078,0.024682590151370254,119131,789,0.0364935219113182,3799,16,20,0,36,16076,0.01690738535345433,7689,1,-4,1,0.001627389829498058,2,31384,0,15492,4269,0,51145,15892,0.049780316119266775,241357,122226,
512,0.0034423407917383822,17,392,120,921,27495,11488,391078,0.024682590151370254,119131,789,0.0364935219113182,3799,16,20,0,36,16076,0.01690738535345433,7689,1,-4,1,0.001627389829498058,2,31384,0,15492,4269,0,51145,15892,0.049780316119266775,241357,122226,
512,0.0913154533844189,17,392,120,921,27495,11488,391078,0.024682590151370254,119131,789,0.0364935219113182,3799,408,16,2,426,16076,0.01690738535345433,7689,1,392,6,0.05618772644768263,7,31384,0,15492,4269,5,51145,15892,0.049780316119266775,241357,122226,
512,0.04189944134078212,17,392,120,921,27495,11488,391078,0.024682590151370254,119131,789,0.0364935219113182,3799,645,102,1,748,16076,0.01690738535345433,7689,15,543,15,0.026270940806109505,30,31384,0,15492,4269,0,51145,15892,0.049780316119266775,241357,122226,
512,0.04189944134078212,17,392,120,921,27495,11488,391078,0.024682590151370254,119131,789,0.0364935219113182,3799,645,102,1,748,16076,0.01690738535345433,7689,15,543,15,0.026270940806109505,30,31384,0,15492,4269,0,51145,15892,0.049780316119266775,241357,122226,
512,0.04189944134078212,17,392,120,921,27495,11488,391078,0.024682590151370254,119131,789,0.0364935219113182,3799,645,102,1,748,16076,0.01690738535345433,7689,15,543,15,0.026270940806109505,30,31384,0,15492,4269,0,51145,15892,0.049780316119266775,241357,122226,
512,0.04189944134078212,17,392,120,921,27495,11488,391078,0.024682590151370254,119131,789,0.0364935219113182,3799,645,102,1,748,16076,0.01690738535345433,7689,15,543,15,0.026270940806109505,30,31384,0,15492,4269,0,51145,15892,0.049780316119266775,241357,122226,
512,0.04189944134078212,17,392,120,921,27495,11488,391078,0.024682590151370254,119131,789,0.0364935219113182,3799,645,102,1,748,16076,0.01690738535345433,7689,15,543,15,0.026270940806109505,30,31384,0,15492,4269,0,51145,15892,0.049780316119266775,241357,122226,
512,0.04189944134078212,17,392,120,921,27495,11488,391078,0.024682590151370254,119131,789,0.0364935219113182,3799,645,102,1,748,16076,0.01690738535345433,7689,15,543,15,0.026270940806109505,30,31384,0,15492,4269,0,51145,15892,0.049780316119266775,241357,122226,
512,0.04189944134078212,17,392,120,921,27495,11488,391078,0.024682590151370254,119131,789,0.0364935219113182,3799,645,102,1,748,16076,0.01690738535345433,7689,15,543,15,0.026270940806109505,30,31384,0,15492,4269,0,51145,15892,0.049780316119266775,241357,122226,
512,0.0,17,392,120,921,27495,11488,391078,0.024682590151370254,119131,789,0.0364935219113182,3799,66,5,0,71,16076,0.01690738535345433,7689,0,61,0,0.043678088479511774,0,31384,0,15492,4269,0,51145,15892,0.049780316119266775,241357,122226,
512,0.0,17,392,120,921,27495,11488,391078,0.024682590151370254,119131,789,0.0364935219113182,3799,76,60,2,138,16076,0.01690738535345433,7689,0,16,0,0.008741614448034,0,31384,0,15492,4269,0,51145,15892,0.049780316119266775,241357,122226,
512,0.0,17,392,120,921,27495,11488,391078,0.024682590151370254,119131,789,0.0364935219113182,3799,76,60,2,138,16076,0.01690738535345433,7689,0,16,0,0.008741614448034,0,31384,0,15492,4269,0,51145,15892,0.049780316119266775,241357,122226,
512,0.0,17,392,120,921,27495,11488,391078,0.024682590151370254,119131,789,0.0364935219113182,3799,76,60,2,138,16076,0.01690738535345433,7689,0,16,0,0.008741614448034,0,31384,0,15492,4269,0,51145,15892,0.049780316119266775,241357,122226,
512,0.0,17,392,120,921,27495,11488,391078,0.024682590151370254,119131,789,0.0364935219113182,3799,322,50,76,448,16076,0.01690738535345433,7689,0,272,0,0.045330050800884376,0,31384,0,15492,4269,0,51145,15892,0.049780316119266775,241357,122226,
512,0.0,17,392,120,921,27495,11488,391078,0.024682590151370254,119131,789,0.0364935219113182,3799,206,138,4,348,16076,0.01690738535345433,7689,0,68,0,0.03995478215207311,0,31384,0,15492,4269,0,51145,15892,0.049780316119266775,241357,122226,
512,0.0,17,392,120,921,27495,11488,391078,0.024682590151370254,119131,789,0.0364935219113182,3799,206,138,4,348,16076,0.01690738535345433,7689,0,68,0,0.03995478215207311,0,31384,0,15492,4269,0,51145,15892,0.049780316119266775,241357,122226,
512,0.0,17,392,120,921,27495,11488,391078,0.024682590151370254,119131,789,0.0364935219113182,3799,54,16,4,74,16076,0.01690738535345433,7689,0,38,0,0.00874051478542687,0,31384,0,15492,4269,0,51145,15892,0.049780316119266775,241357,122226,
512,0.19259259259259257,17,392,120,921,27495,11488,391078,0.024682590151370254,119131,789,0.0364935219113182,3799,147,65,0,212,16076,0.01690738535345433,7689,7,82,7,0.04392108767180143,14,31384,0,15492,4269,0,51145,15892,0.049780316119266775,241357,122226,
512,0.19259259259259257,17,392,120,921,27495,11488,391078,0.024682590151370254,119131,789,0.0364935219113182,3799,147,65,0,212,16076,0.01690738535345433,7689,7,82,7,0.04392108767180143,14,31384,0,15492,4269,0,51145,15892,0.049780316119266775,241357,122226,
512,0.19259259259259257,17,392,120,921,27495,11488,391078,0.024682590151370254,119131,789,0.0364935219113182,3799,147,65,0,212,16076,0.01690738535345433,7689,7,82,7,0.04392108767180143,14,31384,0,15492,4269,0,51145,15892,0.049780316119266775,241357,122226,
512,0.19259259259259257,17,392,120,921,27495,11488,391078,0.024682590151370254,119131,789,0.0364935219113182,3799,147,65,0,212,16076,0.01690738535345433,7689,7,82,7,0.04392108767180143,14,31384,0,15492,4269,0,51145,15892,0.049780316119266775,241357,122226,
512,0.0,17,392,120,921,27495,11488,391078,0.024682590151370254,119131,789,0.0364935219113182,3799,6,5,1,12,16076,0.01690738535345433,7689,0,1,0,0.003757169502187496,0,31384,0,15492,4269,0,51145,15892,0.049780316119266775,241357,122226,
512,0.0,17,392,120,921,27495,11488,391078,0.024682590151370254,119131,789,0.0364935219113182,3799,194,125,3,322,16076,0.01690738535345433,7689,0,69,0,0.026170601607337418,0,31384,0,15492,4269,0,51145,15892,0.049780316119266775,241357,122226,
512,0.0,17,392,120,921,27495,11488,391078,0.024682590151370254,119131,789,0.0364935219113182,3799,194,125,3,322,16076,0.01690738535345433,7689,0,69,0,0.026170601607337418,0,31384,0,15492,4269,0,51145,15892,0.049780316119266775,241357,122226,
512,0.0,17,392,120,921,27495,11488,391078,0.024682590151370254,119131,789,0.0364935219113182,3799,95,129,19,243,16076,0.01690738535345433,7689,0,-34,0,0.08676344852219696,0,31384,0,15492,4269,0,51145,15892,0.049780316119266775,241357,122226,
512,0.0,17,392,120,921,27495,11488,391078,0.024682590151370254,119131,789,0.0364935219113182,3799,95,129,19,243,16076,0.01690738535345433,7689,0,-34,0,0.08676344852219696,0,31384,0,15492,4269,0,51145,15892,0.049780316119266775,241357,122226,
512,0.0,17,392,120,921,27495,11488,391078,0.024682590151370254,119131,789,0.0364935219113182,3799,106,25,4,135,16076,0.01690738535345433,7689,0,81,0,0.061911124757586145,0,31384,0,15492,4269,0,51145,15892,0.049780316119266775,241357,122226,
512,0.0,17,392,120,921,27495,11488,391078,0.024682590151370254,119131,789,0.0364935219113182,3799,106,25,4,135,16076,0.01690738535345433,7689,0,81,0,0.061911124757586145,0,31384,0,15492,4269,0,51145,15892,0.049780316119266775,241357,122226,
512,0.0,17,392,120,921,27495,11488,391078,0.024682590151370254,119131,789,0.0364935219113182,3799,125,101,0,226,16076,0.01690738535345433,7689,0,24,0,0.02486451464392103,0,31384,0,15492,4269,0,51145,15892,0.049780316119266775,241357,122226,
512,0.0,17,392,120,921,27495,11488,391078,0.024682590151370254,119131,789,0.0364935219113182,3799,10,11,0,21,16076,0.01690738535345433,7689,0,-1,0,0.06909244029057458,0,31384,0,15492,4269,0,51145,15892,0.049780316119266775,241357,122226,
512,0.0,17,392,120,921,27495,11488,391078,0.024682590151370254,119131,789,0.0364935219113182,3799,10,11,0,21,16076,0.01690738535345433,7689,0,-1,0,0.06909244029057458,0,31384,0,15492,4269,0,51145,15892,0.049780316119266775,241357,122226,
512,0.0,17,392,120,921,27495,11488,391078,0.024682590151370254,119131,789,0.0364935219113182,3799,503,250,9,762,16076,0.01690738535345433,7689,0,253,0,0.054992461294790296,0,31384,0,15492,4269,0,51145,15892,0.049780316119266775,241357,122226,
512,0.0,17,392,120,921,27495,11488,391078,0.024682590151370254,119131,789,0.0364935219113182,3799,503,250,9,762,16076,0.01690738535345433,7689,0,253,0,0.054992461294790296,0,31384,0,15492,4269,0,51145,15892,0.049780316119266775,241357,122226,
512,0.0,17,392,120,921,27495,11488,391078,0.024682590151370254,119131,789,0.0364935219113182,3799,503,250,9,762,16076,0.01690738535345433,7689,0,253,0,0.054992461294790296,0,31384,0,15492,4269,0,51145,15892,0.049780316119266775,241357,122226,
512,0.0,17,392,120,921,27495,11488,391078,0.024682590151370254,119131,789,0.0364935219113182,3799,503,250,9,762,16076,0.01690738535345433,7689,0,253,0,0.054992461294790296,0,31384,0,15492,4269,0,51145,15892,0.049780316119266775,241357,122226,
512,0.0,17,392,120,921,27495,11488,391078,0.024682590151370254,119131,789,0.0364935219113182,3799,503,250,9,762,16076,0.01690738535345433,7689,0,253,0,0.054992461294790296,0,31384,0,15492,4269,0,51145,15892,0.049780316119266775,241357,122226,
512,0.0,17,392,120,921,27495,11488,391078,0.024682590151370254,119131,789,0.0364935219113182,3799,285,166,101,552,16076,0.01690738535345433,7689,0,119,0,0.029181164650423853,0,31384,0,15492,4269,0,51145,15892,0.049780316119266775,241357,122226,
512,0.0,17,392,120,921,27495,11488,391078,0.024682590151370254,119131,789,0.0364935219113182,3799,285,166,101,552,16076,0.01690738535345433,7689,0,119,0,0.029181164650423853,0,31384,0,15492,4269,0,51145,15892,0.049780316119266775,241357,122226,
512,0.0,17,392,120,921,27495,11488,391078,0.024682590151370254,119131,789,0.0364935219113182,3799,253,163,94,510,16076,0.01690738535345433,7689,0,90,0,0.040848291562800475,0,31384,0,15492,4269,0,51145,15892,0.049780316119266775,241357,122226,
512,0.0,17,392,120,921,27495,11488,391078,0.024682590151370254,119131,789,0.0364935219113182,3799,253,163,94,510,16076,0.01690738535345433,7689,0,90,0,0.040848291562800475,0,31384,0,15492,4269,0,51145,15892,0.049780316119266775,241357,122226,
512,0.0,17,392,120,921,27495,11488,391078,0.024682590151370254,119131,789,0.0364935219113182,3799,498,320,2,820,16076,0.01690738535345433,7689,0,178,0,0.14820862450177627,0,31384,0,15492,4269,0,51145,15892,0.049780316119266775,241357,122226,
402,0.09779801409682565,134,384,18,920,27495,11488,391078,0.03290811160867375,119131,789,0.0364935219113182,3799,606,192,25,823,16076,0.01690738535345433,7689,10,414,7,0.10068024630789581,17,15900,0,10526,3546,-3,29972,5374,0.05741873839722478,241357,122226,
512,0.0,17,392,120,921,27495,11488,391078,0.024682590151370254,119131,789,0.0364935219113182,3799,53,0,0,53,16076,0.01690738535345433,7689,0,53,0,0.004119704624951419,0,31384,0,15492,4269,0,51145,15892,0.049780316119266775,241357,122226,
512,0.0,17,392,120,921,27495,11488,391078,0.024682590151370254,119131,789,0.0364935219113182,3799,53,0,0,53,16076,0.01690738535345433,7689,0,53,0,0.004119704624951419,0,31384,0,15492,4269,0,51145,15892,0.049780316119266775,241357,122226,
72,0.0,6,92,-20,170,27495,11488,391078,0.022299621422124834,119131,789,0.0364935219113182,3799,125,2,0,127,16076,0.01690738535345433,7689,0,123,0,0.18939024070136756,0,2252,0,1144,236,0,3632,1108,0.02623003068899154,241357,122226,
72,0.15226424422197504,6,92,-20,170,27495,11488,391078,0.022299621422124834,119131,789,0.0364935219113182,3799,403,603,135,1141,16076,0.01690738535345433,7689,13,-200,17,0.09859638273319338,34,2252,4,1144,236,4,3632,1108,0.02623003068899154,241357,122226,
72,0.15226424422197504,6,92,-20,170,27495,11488,391078,0.022299621422124834,119131,789,0.0364935219113182,3799,403,603,135,1141,16076,0.01690738535345433,7689,13,-200,17,0.09859638273319338,34,2252,4,1144,236,4,3632,1108,0.02623003068899154,241357,122226,
72,0.15226424422197504,6,92,-20,170,27495,11488,391078,0.022299621422124834,119131,789,0.0364935219113182,3799,403,603,135,1141,16076,0.01690738535345433,7689,13,-200,17,0.09859638273319338,34,2252,4,1144,236,4,3632,1108,0.02623003068899154,241357,122226,
72,0.15226424422197504,6,92,-20,170,27495,11488,391078,0.022299621422124834,119131,789,0.0364935219113182,3799,403,603,135,1141,16076,0.01690738535345433,7689,13,-200,17,0.09859638273319338,34,2252,4,1144,236,4,3632,1108,0.02623003068899154,241357,122226,
72,0.0,6,92,-20,170,27495,11488,391078,0.022299621422124834,119131,789,0.0364935219113182,3799,127,11,0,138,16076,0.01690738535345433,7689,0,116,0,0.11578348711001772,0,2252,0,1144,236,0,3632,1108,0.02623003068899154,241357,122226,
72,0.07692307692307693,6,92,-20,170,27495,11488,391078,0.022299621422124834,119131,789,0.0364935219113182,3799,142,19,9,170,16076,0.01690738535345433,7689,4,123,2,0.14313897765920267,6,2252,0,1144,236,-2,3632,1108,0.02623003068899154,241357,122226,
72,0.23469387755102042,6,92,-20,170,27495,11488,391078,0.022299621422124834,119131,789,0.0364935219113182,3799,119,132,5,256,16076,0.01690738535345433,7689,53,-13,14,0.07396070404864394,69,2252,2,1144,236,-39,3632,1108,0.02623003068899154,241357,122226,
72,0.23469387755102042,6,92,-20,170,27495,11488,391078,0.022299621422124834,119131,789,0.0364935219113182,3799,119,132,5,256,16076,0.01690738535345433,7689,53,-13,14,0.07396070404864394,69,2252,2,1144,236,-39,3632,1108,0.02623003068899154,241357,122226,
72,0.23469387755102042,6,92,-20,170,27495,11488,391078,0.022299621422124834,119131,789,0.0364935219113182,3799,119,132,5,256,16076,0.01690738535345433,7689,53,-13,14,0.07396070404864394,69,2252,2,1144,236,-39,3632,1108,0.02623003068899154,241357,122226,
72,0.23121387283236994,6,92,-20,170,27495,11488,391078,0.022299621422124834,119131,789,0.0364935219113182,3799,614,327,74,1015,16076,0.01690738535345433,7689,20,287,20,0.0766560258040407,40,2252,0,1144,236,0,3632,1108,0.02623003068899154,241357,122226,
72,0.23121387283236994,6,92,-20,170,27495,11488,391078,0.022299621422124834,119131,789,0.0364935219113182,3799,614,327,74,1015,16076,0.01690738535345433,7689,20,287,20,0.0766560258040407,40,2252,0,1144,236,0,3632,1108,0.02623003068899154,241357,122226,
72,0.17459016393442622,6,92,-20,170,27495,11488,391078,0.022299621422124834,119131,789,0.0364935219113182,3799,486,41,9,536,16076,0.01690738535345433,7689,2,445,19,0.17072564285781144,21,2252,0,1144,236,17,3632,1108,0.02623003068899154,241357,122226,
72,0.17459016393442622,6,92,-20,170,27495,11488,391078,0.022299621422124834,119131,789,0.0364935219113182,3799,486,41,9,536,16076,0.01690738535345433,7689,2,445,19,0.17072564285781144,21,2252,0,1144,236,17,3632,1108,0.02623003068899154,241357,122226,
72,0.17459016393442622,6,92,-20,170,27495,11488,391078,0.022299621422124834,119131,789,0.0364935219113182,3799,486,41,9,536,16076,0.01690738535345433,7689,2,445,19,0.17072564285781144,21,2252,0,1144,236,17,3632,1108,0.02623003068899154,241357,122226,
72,0.17459016393442622,6,92,-20,170,27495,11488,391078,0.022299621422124834,119131,789,0.0364935219113182,3799,486,41,9,536,16076,0.01690738535345433,7689,2,445,19,0.17072564285781144,21,2252,0,1144,236,17,3632,1108,0.02623003068899154,241357,122226,
72,0.17459016393442622,6,92,-20,170,27495,11488,391078,0.022299621422124834,119131,789,0.0364935219113182,3799,486,41,9,536,16076,0.01690738535345433,7689,2,445,19,0.17072564285781144,21,2252,0,1144,236,17,3632,1108,0.02623003068899154,241357,122226,
72,0.0,6,92,-20,170,27495,11488,391078,0.022299621422124834,119131,789,0.0364935219113182,3799,112,7,4,123,16076,0.01690738535345433,7689,0,105,0,0.06880840012455806,0,2252,0,1144,236,0,3632,1108,0.02623003068899154,241357,122226,
72,0.0,6,92,-20,170,27495,11488,391078,0.022299621422124834,119131,789,0.0364935219113182,3799,112,7,4,123,16076,0.01690738535345433,7689,0,105,0,0.06880840012455806,0,2252,0,1144,236,0,3632,1108,0.02623003068899154,241357,122226,
72,0.0,6,92,-20,170,27495,11488,391078,0.022299621422124834,119131,789,0.0364935219113182,3799,112,7,4,123,16076,0.01690738535345433,7689,0,105,0,0.06880840012455806,0,2252,0,1144,236,0,3632,1108,0.02623003068899154,241357,122226,
262,0.1527391632981695,223,110,152,595,27495,11488,391078,0.024635041078511832,119131,789,0.0364935219113182,3799,96,4,16,116,16076,0.01690738535345433,7689,1,92,26,0.11324621310662134,43,8666,16,3639,1038,25,13343,5027,0.05255372446043591,241357,122226,
262,0.1527391632981695,223,110,152,595,27495,11488,391078,0.024635041078511832,119131,789,0.0364935219113182,3799,96,4,16,116,16076,0.01690738535345433,7689,1,92,26,0.11324621310662134,43,8666,16,3639,1038,25,13343,5027,0.05255372446043591,241357,122226,
262,0.1527391632981695,223,110,152,595,27495,11488,391078,0.024635041078511832,119131,789,0.0364935219113182,3799,96,4,16,116,16076,0.01690738535345433,7689,1,92,26,0.11324621310662134,43,8666,16,3639,1038,25,13343,5027,0.05255372446043591,241357,122226,
262,0.0017543859649122807,223,110,152,595,27495,11488,391078,0.024635041078511832,119131,789,0.0364935219113182,3799,22,3,0,25,16076,0.01690738535345433,7689,1,19,1,0.006781873482632268,2,8666,0,3639,1038,0,13343,5027,0.05255372446043591,241357,122226,
140,0.15773161457065987,2,49,91,191,27495,11488,391078,0.03378158774219646,119131,789,0.0364935219113182,3799,3194,2228,392,5814,16076,0.01690738535345433,7689,10,966,30,0.1794964093049724,42,8831,2,5350,1996,20,16177,3481,0.0948130234151262,241357,122226,
262,0.24660816527475524,223,110,152,595,27495,11488,391078,0.024635041078511832,119131,789,0.0364935219113182,3799,3256,780,484,4520,16076,0.01690738535345433,7689,39,2476,102,0.12097149313752185,250,8666,109,3639,1038,63,13343,5027,0.05255372446043591,241357,122226,
262,0.24660816527475524,223,110,152,595,27495,11488,391078,0.024635041078511832,119131,789,0.0364935219113182,3799,3256,780,484,4520,16076,0.01690738535345433,7689,39,2476,102,0.12097149313752185,250,8666,109,3639,1038,63,13343,5027,0.05255372446043591,241357,122226,
262,0.24660816527475524,223,110,152,595,27495,11488,391078,0.024635041078511832,119131,789,0.0364935219113182,3799,3256,780,484,4520,16076,0.01690738535345433,7689,39,2476,102,0.12097149313752185,250,8666,109,3639,1038,63,13343,5027,0.05255372446043591,241357,122226,
262,0.24660816527475524,223,110,152,595,27495,11488,391078,0.024635041078511832,119131,789,0.0364935219113182,3799,3256,780,484,4520,16076,0.01690738535345433,7689,39,2476,102,0.12097149313752185,250,8666,109,3639,1038,63,13343,5027,0.05255372446043591,241357,122226,
262,0.24660816527475524,223,110,152,595,27495,11488,391078,0.024635041078511832,119131,789,0.0364935219113182,3799,3256,780,484,4520,16076,0.01690738535345433,7689,39,2476,102,0.12097149313752185,250,8666,109,3639,1038,63,13343,5027,0.05255372446043591,241357,122226,
262,0.2110658452570217,223,110,152,595,27495,11488,391078,0.024635041078511832,119131,789,0.0364935219113182,3799,409,281,134,824,16076,0.01690738535345433,7689,14,128,14,0.07563688693520944,112,8666,84,3639,1038,0,13343,5027,0.05255372446043591,241357,122226,
262,0.01312910284463895,223,110,152,595,27495,11488,391078,0.024635041078511832,119131,789,0.0364935219113182,3799,479,267,60,806,16076,0.01690738535345433,7689,9,212,9,0.10245981564529606,18,8666,0,3639,1038,0,13343,5027,0.05255372446043591,241357,122226,
262,0.01312910284463895,223,110,152,595,27495,11488,391078,0.024635041078511832,119131,789,0.0364935219113182,3799,479,267,60,806,16076,0.01690738535345433,7689,9,212,9,0.10245981564529606,18,8666,0,3639,1038,0,13343,5027,0.05255372446043591,241357,122226,
262,0.06474867724867725,223,110,152,595,27495,11488,391078,0.024635041078511832,119131,789,0.0364935219113182,3799,352,165,12,529,16076,0.01690738535345433,7689,4,187,5,0.05385279508703071,9,8666,0,3639,1038,1,13343,5027,0.05255372446043591,241357,122226,
262,0.04696969696969697,223,110,152,595,27495,11488,391078,0.024635041078511832,119131,789,0.0364935219113182,3799,346,205,44,595,16076,0.01690738535345433,7689,2,141,17,0.11928583236067042,31,8666,12,3639,1038,15,13343,5027,0.05255372446043591,241357,122226,
262,0.04696969696969697,223,110,152,595,27495,11488,391078,0.024635041078511832,119131,789,0.0364935219113182,3799,346,205,44,595,16076,0.01690738535345433,7689,2,141,17,0.11928583236067042,31,8666,12,3639,1038,15,13343,5027,0.05255372446043591,241357,122226,
262,0.056457388398185725,223,110,152,595,27495,11488,391078,0.024635041078511832,119131,789,0.0364935219113182,3799,579,770,150,1499,16076,0.01690738535345433,7689,2,-191,5,0.13098855131722725,7,8666,0,3639,1038,3,13343,5027,0.05255372446043591,241357,122226,
262,0.0,223,110,152,595,27495,11488,391078,0.024635041078511832,119131,789,0.0364935219113182,3799,123,5,0,128,16076,0.01690738535345433,7689,0,118,0,0.11070836903432858,0,8666,0,3639,1038,0,13343,5027,0.05255372446043591,241357,122226,
262,0.0,223,110,152,595,27495,11488,391078,0.024635041078511832,119131,789,0.0364935219113182,3799,0,0,0,0,16076,0.01690738535345433,7689,0,0,0,0.0,0,8666,0,3639,1038,0,13343,5027,0.05255372446043591,241357,122226,
262,0.0,223,110,152,595,27495,11488,391078,0.024635041078511832,119131,789,0.0364935219113182,3799,83,4,0,87,16076,0.01690738535345433,7689,0,79,0,0.14247279933741683,0,8666,0,3639,1038,0,13343,5027,0.05255372446043591,241357,122226,
262,0.0,223,110,152,595,27495,11488,391078,0.024635041078511832,119131,789,0.0364935219113182,3799,396,71,12,479,16076,0.01690738535345433,7689,0,325,0,0.06321891055373316,0,8666,0,3639,1038,0,13343,5027,0.05255372446043591,241357,122226,
262,0.0,223,110,152,595,27495,11488,391078,0.024635041078511832,119131,789,0.0364935219113182,3799,396,71,12,479,16076,0.01690738535345433,7689,0,325,0,0.06321891055373316,0,8666,0,3639,1038,0,13343,5027,0.05255372446043591,241357,122226,
262,0.0,223,110,152,595,27495,11488,391078,0.024635041078511832,119131,789,0.0364935219113182,3799,396,71,12,479,16076,0.01690738535345433,7689,0,325,0,0.06321891055373316,0,8666,0,3639,1038,0,13343,5027,0.05255372446043591,241357,122226,
262,0.0,223,110,152,595,27495,11488,391078,0.024635041078511832,119131,789,0.0364935219113182,3799,168,126,27,321,16076,0.01690738535345433,7689,0,42,0,0.09533217788734853,0,8666,0,3639,1038,0,13343,5027,0.05255372446043591,241357,122226,
262,0.0027662517289073307,223,110,152,595,27495,11488,391078,0.024635041078511832,119131,789,0.0364935219113182,3799,294,20,0,314,16076,0.01690738535345433,7689,2,274,2,0.09599443807546022,4,8666,0,3639,1038,0,13343,5027,0.05255372446043591,241357,122226,
194,0.29411764705882354,0,1,193,195,27495,11488,391078,0.03781589955569857,119131,789,0.0364935219113182,3799,282,1,0,283,16076,0.01690738535345433,7689,0,281,10,0.10013938191041914,10,1838,0,160,7,10,2005,1678,0.042868385930848366,241357,122226,
194,0.29411764705882354,0,1,193,195,27495,11488,391078,0.03781589955569857,119131,789,0.0364935219113182,3799,282,1,0,283,16076,0.01690738535345433,7689,0,281,10,0.10013938191041914,10,1838,0,160,7,10,2005,1678,0.042868385930848366,241357,122226,
194,0.29411764705882354,0,1,193,195,27495,11488,391078,0.03781589955569857,119131,789,0.0364935219113182,3799,282,1,0,283,16076,0.01690738535345433,7689,0,281,10,0.10013938191041914,10,1838,0,160,7,10,2005,1678,0.042868385930848366,241357,122226,
194,0.29411764705882354,0,1,193,195,27495,11488,391078,0.03781589955569857,119131,789,0.0364935219113182,3799,282,1,0,283,16076,0.01690738535345433,7689,0,281,10,0.10013938191041914,10,1838,0,160,7,10,2005,1678,0.042868385930848366,241357,122226,
194,0.0,0,1,193,195,27495,11488,391078,0.03781589955569857,119131,789,0.0364935219113182,3799,43,26,1,70,16076,0.01690738535345433,7689,0,17,0,0.01644095757525162,0,1838,0,160,7,0,2005,1678,0.042868385930848366,241357,122226,
194,0.07142857142857142,0,1,193,195,27495,11488,391078,0.03781589955569857,119131,789,0.0364935219113182,3799,108,2,0,110,16076,0.01690738535345433,7689,1,106,0,0.0719042258188712,1,1838,0,160,7,-1,2005,1678,0.042868385930848366,241357,122226,
194,0.07142857142857142,0,1,193,195,27495,11488,391078,0.03781589955569857,119131,789,0.0364935219113182,3799,108,2,0,110,16076,0.01690738535345433,7689,1,106,0,0.0719042258188712,1,1838,0,160,7,-1,2005,1678,0.042868385930848366,241357,122226,
194,0.0,0,1,193,195,27495,11488,391078,0.03781589955569857,119131,789,0.0364935219113182,3799,1,0,0,1,16076,0.01690738535345433,7689,0,1,0,0.0037735849056603774,0,1838,0,160,7,0,2005,1678,0.042868385930848366,241357,122226,
194,0.0,0,1,193,195,27495,11488,391078,0.03781589955569857,119131,789,0.0364935219113182,3799,5,5,0,10,16076,0.01690738535345433,7689,0,0,0,0.13065076999503228,0,1838,0,160,7,0,2005,1678,0.042868385930848366,241357,122226,
194,0.17857142857142858,0,1,193,195,27495,11488,391078,0.03781589955569857,119131,789,0.0364935219113182,3799,229,11,0,240,16076,0.01690738535345433,7689,0,218,10,0.10577786565796847,10,1838,0,160,7,10,2005,1678,0.042868385930848366,241357,122226,
194,0.17857142857142858,0,1,193,195,27495,11488,391078,0.03781589955569857,119131,789,0.0364935219113182,3799,229,11,0,240,16076,0.01690738535345433,7689,0,218,10,0.10577786565796847,10,1838,0,160,7,10,2005,1678,0.042868385930848366,241357,122226,
194,0.0,0,1,193,195,27495,11488,391078,0.03781589955569857,119131,789,0.0364935219113182,3799,104,1,0,105,16076,0.01690738535345433,7689,0,103,0,0.030707801907388255,0,1838,0,160,7,0,2005,1678,0.042868385930848366,241357,122226,
194,0.0,0,1,193,195,27495,11488,391078,0.03781589955569857,119131,789,0.0364935219113182,3799,104,1,0,105,16076,0.01690738535345433,7689,0,103,0,0.030707801907388255,0,1838,0,160,7,0,2005,1678,0.042868385930848366,241357,122226,
194,0.0,0,1,193,195,27495,11488,391078,0.03781589955569857,119131,789,0.0364935219113182,3799,1,1,0,2,16076,0.01690738535345433,7689,0,0,0,3.757985719654265E-4,0,1838,0,160,7,0,2005,1678,0.042868385930848366,241357,122226,
194,0.0,0,1,193,195,27495,11488,391078,0.03781589955569857,119131,789,0.0364935219113182,3799,74,2,0,76,16076,0.01690738535345433,7689,0,72,0,0.0033569717889378064,0,1838,0,160,7,0,2005,1678,0.042868385930848366,241357,122226,
66,0.28125,0,4,62,70,27495,11488,391078,0.04536356209150327,119131,789,0.0364935219113182,3799,274,50,0,324,16076,0.01690738535345433,7689,2,224,16,0.14506839278828615,18,1778,0,668,51,14,2497,1110,0.04357317282731773,241357,122226,
66,0.0,0,4,62,70,27495,11488,391078,0.04536356209150327,119131,789,0.0364935219113182,3799,36,25,2,63,16076,0.01690738535345433,7689,0,11,0,0.006026777139945944,0,1778,0,668,51,0,2497,1110,0.04357317282731773,241357,122226,
66,0.0,0,4,62,70,27495,11488,391078,0.04536356209150327,119131,789,0.0364935219113182,3799,36,25,2,63,16076,0.01690738535345433,7689,0,11,0,0.006026777139945944,0,1778,0,668,51,0,2497,1110,0.04357317282731773,241357,122226,
66,0.23529411764705882,0,4,62,70,27495,11488,391078,0.04536356209150327,119131,789,0.0364935219113182,3799,382,253,22,657,16076,0.01690738535345433,7689,2,129,2,0.0392320716322011,4,1778,0,668,51,0,2497,1110,0.04357317282731773,241357,122226,
66,0.23529411764705882,0,4,62,70,27495,11488,391078,0.04536356209150327,119131,789,0.0364935219113182,3799,382,253,22,657,16076,0.01690738535345433,7689,2,129,2,0.0392320716322011,4,1778,0,668,51,0,2497,1110,0.04357317282731773,241357,122226,
107,0.1791125541125541,14,14,93,135,27495,11488,391078,0.09794241836330243,119131,789,0.0364935219113182,3799,82,37,0,119,16076,0.01690738535345433,7689,5,45,39,0.056190311160135495,44,1526,0,616,124,34,2266,910,0.05212148889927745,241357,122226,
107,0.1791125541125541,14,14,93,135,27495,11488,391078,0.09794241836330243,119131,789,0.0364935219113182,3799,82,37,0,119,16076,0.01690738535345433,7689,5,45,39,0.056190311160135495,44,1526,0,616,124,34,2266,910,0.05212148889927745,241357,122226,
107,0.1791125541125541,14,14,93,135,27495,11488,391078,0.09794241836330243,119131,789,0.0364935219113182,3799,82,37,0,119,16076,0.01690738535345433,7689,5,45,39,0.056190311160135495,44,1526,0,616,124,34,2266,910,0.05212148889927745,241357,122226,
107,0.1791125541125541,14,14,93,135,27495,11488,391078,0.09794241836330243,119131,789,0.0364935219113182,3799,82,37,0,119,16076,0.01690738535345433,7689,5,45,39,0.056190311160135495,44,1526,0,616,124,34,2266,910,0.05212148889927745,241357,122226,
107,0.1791125541125541,14,14,93,135,27495,11488,391078,0.09794241836330243,119131,789,0.0364935219113182,3799,82,37,0,119,16076,0.01690738535345433,7689,5,45,39,0.056190311160135495,44,1526,0,616,124,34,2266,910,0.05212148889927745,241357,122226,
107,0.1791125541125541,14,14,93,135,27495,11488,391078,0.09794241836330243,119131,789,0.0364935219113182,3799,82,37,0,119,16076,0.01690738535345433,7689,5,45,39,0.056190311160135495,44,1526,0,616,124,34,2266,910,0.05212148889927745,241357,122226,
107,0.1791125541125541,14,14,93,135,27495,11488,391078,0.09794241836330243,119131,789,0.0364935219113182,3799,82,37,0,119,16076,0.01690738535345433,7689,5,45,39,0.056190311160135495,44,1526,0,616,124,34,2266,910,0.05212148889927745,241357,122226,
6,0.0,1,0,6,7,27495,11488,391078,0.005405405405405406,119131,789,0.0364935219113182,3799,390,164,32,586,16076,0.01690738535345433,7689,0,226,0,0.0739738878434714,0,767,0,263,44,0,1074,504,0.026907340539179436,241357,122226,
0,0.0,0,0,0,0,27495,11488,391078,0.0,119131,789,0.0364935219113182,3799,0,0,0,0,16076,0.01690738535345433,7689,0,0,0,0.0,0,0,0,0,0,0,0,0,0.0,241357,122226,
28,0.0,0,4,24,32,27495,11488,391078,0.01010722844241804,119131,789,0.0364935219113182,3799,126,162,25,313,16076,0.01690738535345433,7689,0,-36,0,0.10881845069087695,0,4796,0,2012,201,0,7009,2784,0.047145777265474254,241357,122226,
28,0.0,0,4,24,32,27495,11488,391078,0.01010722844241804,119131,789,0.0364935219113182,3799,143,90,5,238,16076,0.01690738535345433,7689,0,53,0,0.06905366254781332,0,4796,0,2012,201,0,7009,2784,0.047145777265474254,241357,122226,
28,0.0,0,4,24,32,27495,11488,391078,0.01010722844241804,119131,789,0.0364935219113182,3799,143,90,5,238,16076,0.01690738535345433,7689,0,53,0,0.06905366254781332,0,4796,0,2012,201,0,7009,2784,0.047145777265474254,241357,122226,
28,0.0,0,4,24,32,27495,11488,391078,0.01010722844241804,119131,789,0.0364935219113182,3799,19,45,0,64,16076,0.01690738535345433,7689,0,-26,0,0.044719836561682616,0,4796,0,2012,201,0,7009,2784,0.047145777265474254,241357,122226,
28,0.0,0,4,24,32,27495,11488,391078,0.01010722844241804,119131,789,0.0364935219113182,3799,141,26,0,167,16076,0.01690738535345433,7689,0,115,0,0.04158342376772499,0,4796,0,2012,201,0,7009,2784,0.047145777265474254,241357,122226,
28,0.07352941176470588,0,4,24,32,27495,11488,391078,0.01010722844241804,119131,789,0.0364935219113182,3799,41,65,7,113,16076,0.01690738535345433,7689,0,-24,5,0.05613866679430491,5,4796,0,2012,201,5,7009,2784,0.047145777265474254,241357,122226,
28,0.07352941176470588,0,4,24,32,27495,11488,391078,0.01010722844241804,119131,789,0.0364935219113182,3799,41,65,7,113,16076,0.01690738535345433,7689,0,-24,5,0.05613866679430491,5,4796,0,2012,201,5,7009,2784,0.047145777265474254,241357,122226,
28,0.0,0,4,24,32,27495,11488,391078,0.01010722844241804,119131,789,0.0364935219113182,3799,162,6,0,168,16076,0.01690738535345433,7689,0,156,0,0.22507787047969777,0,4796,0,2012,201,0,7009,2784,0.047145777265474254,241357,122226,
28,0.0,0,4,24,32,27495,11488,391078,0.01010722844241804,119131,789,0.0364935219113182,3799,162,6,0,168,16076,0.01690738535345433,7689,0,156,0,0.22507787047969777,0,4796,0,2012,201,0,7009,2784,0.047145777265474254,241357,122226,
28,0.0,0,4,24,32,27495,11488,391078,0.01010722844241804,119131,789,0.0364935219113182,3799,162,6,0,168,16076,0.01690738535345433,7689,0,156,0,0.22507787047969777,0,4796,0,2012,201,0,7009,2784,0.047145777265474254,241357,122226,
28,0.0,0,4,24,32,27495,11488,391078,0.01010722844241804,119131,789,0.0364935219113182,3799,162,6,0,168,16076,0.01690738535345433,7689,0,156,0,0.22507787047969777,0,4796,0,2012,201,0,7009,2784,0.047145777265474254,241357,122226,
28,0.0,0,4,24,32,27495,11488,391078,0.01010722844241804,119131,789,0.0364935219113182,3799,4,3,0,7,16076,0.01690738535345433,7689,0,1,0,0.008466987875875699,0,4796,0,2012,201,0,7009,2784,0.047145777265474254,241357,122226,
28,0.0,0,4,24,32,27495,11488,391078,0.01010722844241804,119131,789,0.0364935219113182,3799,456,78,21,555,16076,0.01690738535345433,7689,0,378,0,0.10384110503894303,0,4796,0,2012,201,0,7009,2784,0.047145777265474254,241357,122226,
28,0.001273074474856779,0,4,24,32,27495,11488,391078,0.01010722844241804,119131,789,0.0364935219113182,3799,426,13,1,440,16076,0.01690738535345433,7689,1,413,1,0.06262619263471224,2,4796,0,2012,201,0,7009,2784,0.047145777265474254,241357,122226,
28,0.001273074474856779,0,4,24,32,27495,11488,391078,0.01010722844241804,119131,789,0.0364935219113182,3799,426,13,1,440,16076,0.01690738535345433,7689,1,413,1,0.06262619263471224,2,4796,0,2012,201,0,7009,2784,0.047145777265474254,241357,122226,
28,0.0,0,4,24,32,27495,11488,391078,0.01010722844241804,119131,789,0.0364935219113182,3799,18,35,4,57,16076,0.01690738535345433,7689,0,-17,0,0.014069204847320825,0,4796,0,2012,201,0,7009,2784,0.047145777265474254,241357,122226,
28,0.0,0,4,24,32,27495,11488,391078,0.01010722844241804,119131,789,0.0364935219113182,3799,190,84,7,281,16076,0.01690738535345433,7689,0,106,0,0.09573478433371689,0,4796,0,2012,201,0,7009,2784,0.047145777265474254,241357,122226,
28,0.0,0,4,24,32,27495,11488,391078,0.01010722844241804,119131,789,0.0364935219113182,3799,19,25,7,51,16076,0.01690738535345433,7689,0,-6,0,0.028558604041565395,0,4796,0,2012,201,0,7009,2784,0.047145777265474254,241357,122226,
28,0.0,0,4,24,32,27495,11488,391078,0.01010722844241804,119131,789,0.0364935219113182,3799,5,52,4,61,16076,0.01690738535345433,7689,0,-47,0,0.017267516796337284,0,4796,0,2012,201,0,7009,2784,0.047145777265474254,241357,122226,
28,0.0,0,4,24,32,27495,11488,391078,0.01010722844241804,119131,789,0.0364935219113182,3799,68,51,1,120,16076,0.01690738535345433,7689,0,17,0,0.0769074932323146,0,4796,0,2012,201,0,7009,2784,0.047145777265474254,241357,122226,
28,0.0,0,4,24,32,27495,11488,391078,0.01010722844241804,119131,789,0.0364935219113182,3799,68,51,1,120,16076,0.01690738535345433,7689,0,17,0,0.0769074932323146,0,4796,0,2012,201,0,7009,2784,0.047145777265474254,241357,122226,
28,0.0,0,4,24,32,27495,11488,391078,0.01010722844241804,119131,789,0.0364935219113182,3799,68,51,1,120,16076,0.01690738535345433,7689,0,17,0,0.0769074932323146,0,4796,0,2012,201,0,7009,2784,0.047145777265474254,241357,122226,
28,0.0012626262626262627,0,4,24,32,27495,11488,391078,0.01010722844241804,119131,789,0.0364935219113182,3799,16,16,0,32,16076,0.01690738535345433,7689,1,0,1,0.004722822602771344,2,4796,0,2012,201,0,7009,2784,0.047145777265474254,241357,122226,
28,0.0012626262626262627,0,4,24,32,27495,11488,391078,0.01010722844241804,119131,789,0.0364935219113182,3799,16,16,0,32,16076,0.01690738535345433,7689,1,0,1,0.004722822602771344,2,4796,0,2012,201,0,7009,2784,0.047145777265474254,241357,122226,
28,0.0,0,4,24,32,27495,11488,391078,0.01010722844241804,119131,789,0.0364935219113182,3799,5,14,0,19,16076,0.01690738535345433,7689,0,-9,0,0.011449348523441674,0,4796,0,2012,201,0,7009,2784,0.047145777265474254,241357,122226,
28,0.0,0,4,24,32,27495,11488,391078,0.01010722844241804,119131,789,0.0364935219113182,3799,19,35,11,65,16076,0.01690738535345433,7689,0,-16,0,0.012636397870430999,0,4796,0,2012,201,0,7009,2784,0.047145777265474254,241357,122226,
28,0.0,0,4,24,32,27495,11488,391078,0.01010722844241804,119131,789,0.0364935219113182,3799,66,6,0,72,16076,0.01690738535345433,7689,0,60,0,0.011843279763558574,0,4796,0,2012,201,0,7009,2784,0.047145777265474254,241357,122226,
28,0.0,0,4,24,32,27495,11488,391078,0.01010722844241804,119131,789,0.0364935219113182,3799,85,23,6,114,16076,0.01690738535345433,7689,0,62,0,0.007518019495188759,0,4796,0,2012,201,0,7009,2784,0.047145777265474254,241357,122226,
28,0.0,0,4,24,32,27495,11488,391078,0.01010722844241804,119131,789,0.0364935219113182,3799,170,33,0,203,16076,0.01690738535345433,7689,0,137,0,0.07298103827661497,0,4796,0,2012,201,0,7009,2784,0.047145777265474254,241357,122226,
28,0.0,0,4,24,32,27495,11488,391078,0.01010722844241804,119131,789,0.0364935219113182,3799,80,40,4,124,16076,0.01690738535345433,7689,0,40,0,0.0393065302197927,0,4796,0,2012,201,0,7009,2784,0.047145777265474254,241357,122226,
28,0.0,0,4,24,32,27495,11488,391078,0.01010722844241804,119131,789,0.0364935219113182,3799,255,29,0,284,16076,0.01690738535345433,7689,0,226,0,0.07635271892497103,0,4796,0,2012,201,0,7009,2784,0.047145777265474254,241357,122226,
28,0.0,0,4,24,32,27495,11488,391078,0.01010722844241804,119131,789,0.0364935219113182,3799,79,15,2,96,16076,0.01690738535345433,7689,0,64,0,0.005646554610647531,0,4796,0,2012,201,0,7009,2784,0.047145777265474254,241357,122226,
28,0.0,0,4,24,32,27495,11488,391078,0.01010722844241804,119131,789,0.0364935219113182,3799,130,45,2,177,16076,0.01690738535345433,7689,0,85,0,0.02278429734283776,0,4796,0,2012,201,0,7009,2784,0.047145777265474254,241357,122226,
28,0.0,0,4,24,32,27495,11488,391078,0.01010722844241804,119131,789,0.0364935219113182,3799,47,107,11,165,16076,0.01690738535345433,7689,0,-60,0,0.030389588184805125,0,4796,0,2012,201,0,7009,2784,0.047145777265474254,241357,122226,
28,0.21212121212121213,0,4,24,32,27495,11488,391078,0.01010722844241804,119131,789,0.0364935219113182,3799,37,56,0,93,16076,0.01690738535345433,7689,0,-19,7,0.08030169225951787,7,4796,0,2012,201,7,7009,2784,0.047145777265474254,241357,122226,
28,0.0,0,4,24,32,27495,11488,391078,0.01010722844241804,119131,789,0.0364935219113182,3799,49,22,5,76,16076,0.01690738535345433,7689,0,27,0,0.030520319908360263,0,4796,0,2012,201,0,7009,2784,0.047145777265474254,241357,122226,
28,0.0,0,4,24,32,27495,11488,391078,0.01010722844241804,119131,789,0.0364935219113182,3799,130,64,10,204,16076,0.01690738535345433,7689,0,66,0,0.01199135740676378,0,4796,0,2012,201,0,7009,2784,0.047145777265474254,241357,122226,
28,0.0,0,4,24,32,27495,11488,391078,0.01010722844241804,119131,789,0.0364935219113182,3799,194,146,11,351,16076,0.01690738535345433,7689,0,48,0,0.04757951038953569,0,4796,0,2012,201,0,7009,2784,0.047145777265474254,241357,122226,
28,0.0,0,4,24,32,27495,11488,391078,0.01010722844241804,119131,789,0.0364935219113182,3799,114,17,0,131,16076,0.01690738535345433,7689,0,97,0,0.09688162394047514,0,4796,0,2012,201,0,7009,2784,0.047145777265474254,241357,122226,
28,0.0,0,4,24,32,27495,11488,391078,0.01010722844241804,119131,789,0.0364935219113182,3799,36,17,2,55,16076,0.01690738535345433,7689,0,19,0,0.03357329072407703,0,4796,0,2012,201,0,7009,2784,0.047145777265474254,241357,122226,
28,0.0,0,4,24,32,27495,11488,391078,0.01010722844241804,119131,789,0.0364935219113182,3799,233,189,11,433,16076,0.01690738535345433,7689,0,44,0,0.03541352851653646,0,4796,0,2012,201,0,7009,2784,0.047145777265474254,241357,122226,
28,0.0,0,4,24,32,27495,11488,391078,0.01010722844241804,119131,789,0.0364935219113182,3799,222,60,3,285,16076,0.01690738535345433,7689,0,162,0,0.07692252511977017,0,4796,0,2012,201,0,7009,2784,0.047145777265474254,241357,122226,
28,0.0,0,4,24,32,27495,11488,391078,0.01010722844241804,119131,789,0.0364935219113182,3799,92,10,2,104,16076,0.01690738535345433,7689,0,82,0,0.06916155256111904,0,4796,0,2012,201,0,7009,2784,0.047145777265474254,241357,122226,
28,0.0,0,4,24,32,27495,11488,391078,0.01010722844241804,119131,789,0.0364935219113182,3799,92,10,2,104,16076,0.01690738535345433,7689,0,82,0,0.06916155256111904,0,4796,0,2012,201,0,7009,2784,0.047145777265474254,241357,122226,
4,0.0,0,4,0,8,27495,11488,391078,0.0031478706851841183,119131,789,0.0364935219113182,3799,232,84,10,326,16076,0.01690738535345433,7689,0,148,0,0.1548846816243827,0,4084,0,1757,402,0,6243,2327,0.04752618952964013,241357,122226,
4,0.0,0,4,0,8,27495,11488,391078,0.0031478706851841183,119131,789,0.0364935219113182,3799,14,27,1,42,16076,0.01690738535345433,7689,0,-13,0,0.026234125967266566,0,4084,0,1757,402,0,6243,2327,0.04752618952964013,241357,122226,
4,0.0,0,4,0,8,27495,11488,391078,0.0031478706851841183,119131,789,0.0364935219113182,3799,14,27,1,42,16076,0.01690738535345433,7689,0,-13,0,0.026234125967266566,0,4084,0,1757,402,0,6243,2327,0.04752618952964013,241357,122226,
4,0.0,0,4,0,8,27495,11488,391078,0.0031478706851841183,119131,789,0.0364935219113182,3799,920,544,121,1585,16076,0.01690738535345433,7689,0,376,0,0.15917430335459942,0,4084,0,1757,402,0,6243,2327,0.04752618952964013,241357,122226,
4,0.0,0,4,0,8,27495,11488,391078,0.0031478706851841183,119131,789,0.0364935219113182,3799,920,544,121,1585,16076,0.01690738535345433,7689,0,376,0,0.15917430335459942,0,4084,0,1757,402,0,6243,2327,0.04752618952964013,241357,122226,
4,0.0,0,4,0,8,27495,11488,391078,0.0031478706851841183,119131,789,0.0364935219113182,3799,920,544,121,1585,16076,0.01690738535345433,7689,0,376,0,0.15917430335459942,0,4084,0,1757,402,0,6243,2327,0.04752618952964013,241357,122226,
4,0.0,0,4,0,8,27495,11488,391078,0.0031478706851841183,119131,789,0.0364935219113182,3799,173,107,14,294,16076,0.01690738535345433,7689,0,66,0,0.031833423430189106,0,4084,0,1757,402,0,6243,2327,0.04752618952964013,241357,122226,
4,0.0,0,4,0,8,27495,11488,391078,0.0031478706851841183,119131,789,0.0364935219113182,3799,97,25,58,180,16076,0.01690738535345433,7689,0,72,0,0.07220887759342356,0,4084,0,1757,402,0,6243,2327,0.04752618952964013,241357,122226,
4,0.0,0,4,0,8,27495,11488,391078,0.0031478706851841183,119131,789,0.0364935219113182,3799,97,25,58,180,16076,0.01690738535345433,7689,0,72,0,0.07220887759342356,0,4084,0,1757,402,0,6243,2327,0.04752618952964013,241357,122226,
4,0.0,0,4,0,8,27495,11488,391078,0.0031478706851841183,119131,789,0.0364935219113182,3799,80,1,0,81,16076,0.01690738535345433,7689,0,79,0,0.08579399845044401,0,4084,0,1757,402,0,6243,2327,0.04752618952964013,241357,122226,
4,0.0,0,4,0,8,27495,11488,391078,0.0031478706851841183,119131,789,0.0364935219113182,3799,80,1,0,81,16076,0.01690738535345433,7689,0,79,0,0.08579399845044401,0,4084,0,1757,402,0,6243,2327,0.04752618952964013,241357,122226,
4,0.0,0,4,0,8,27495,11488,391078,0.0031478706851841183,119131,789,0.0364935219113182,3799,79,1,0,80,16076,0.01690738535345433,7689,0,78,0,0.06640983126502163,0,4084,0,1757,402,0,6243,2327,0.04752618952964013,241357,122226,
4,0.0,0,4,0,8,27495,11488,391078,0.0031478706851841183,119131,789,0.0364935219113182,3799,79,1,0,80,16076,0.01690738535345433,7689,0,78,0,0.06640983126502163,0,4084,0,1757,402,0,6243,2327,0.04752618952964013,241357,122226,
4,0.0,0,4,0,8,27495,11488,391078,0.0031478706851841183,119131,789,0.0364935219113182,3799,72,15,2,89,16076,0.01690738535345433,7689,0,57,0,0.02991105581948013,0,4084,0,1757,402,0,6243,2327,0.04752618952964013,241357,122226,
28,0.23529411764705882,0,4,24,32,27495,11488,391078,0.01010722844241804,119131,789,0.0364935219113182,3799,254,149,19,422,16076,0.01690738535345433,7689,0,105,12,0.056755625012901004,12,4796,0,2012,201,12,7009,2784,0.047145777265474254,241357,122226,
4,0.029850746268656716,0,4,0,8,27495,11488,391078,0.0031478706851841183,119131,789,0.0364935219113182,3799,58,8,0,66,16076,0.01690738535345433,7689,1,50,1,0.09052897417069686,2,4084,0,1757,402,0,6243,2327,0.04752618952964013,241357,122226,
4,0.029850746268656716,0,4,0,8,27495,11488,391078,0.0031478706851841183,119131,789,0.0364935219113182,3799,58,8,0,66,16076,0.01690738535345433,7689,1,50,1,0.09052897417069686,2,4084,0,1757,402,0,6243,2327,0.04752618952964013,241357,122226,
4,0.029850746268656716,0,4,0,8,27495,11488,391078,0.0031478706851841183,119131,789,0.0364935219113182,3799,58,8,0,66,16076,0.01690738535345433,7689,1,50,1,0.09052897417069686,2,4084,0,1757,402,0,6243,2327,0.04752618952964013,241357,122226,
4,0.029850746268656716,0,4,0,8,27495,11488,391078,0.0031478706851841183,119131,789,0.0364935219113182,3799,58,8,0,66,16076,0.01690738535345433,7689,1,50,1,0.09052897417069686,2,4084,0,1757,402,0,6243,2327,0.04752618952964013,241357,122226,
4,0.0,0,4,0,8,27495,11488,391078,0.0031478706851841183,119131,789,0.0364935219113182,3799,328,160,101,589,16076,0.01690738535345433,7689,0,168,0,0.055149315868296266,0,4084,0,1757,402,0,6243,2327,0.04752618952964013,241357,122226,
4,0.0,0,4,0,8,27495,11488,391078,0.0031478706851841183,119131,789,0.0364935219113182,3799,328,160,101,589,16076,0.01690738535345433,7689,0,168,0,0.055149315868296266,0,4084,0,1757,402,0,6243,2327,0.04752618952964013,241357,122226,
4,0.0,0,4,0,8,27495,11488,391078,0.0031478706851841183,119131,789,0.0364935219113182,3799,79,35,1,115,16076,0.01690738535345433,7689,0,44,0,0.048272350869139946,0,4084,0,1757,402,0,6243,2327,0.04752618952964013,241357,122226,
4,0.0,0,4,0,8,27495,11488,391078,0.0031478706851841183,119131,789,0.0364935219113182,3799,395,121,2,518,16076,0.01690738535345433,7689,0,274,0,0.08314729616685151,0,4084,0,1757,402,0,6243,2327,0.04752618952964013,241357,122226,
4,0.0,0,4,0,8,27495,11488,391078,0.0031478706851841183,119131,789,0.0364935219113182,3799,395,121,2,518,16076,0.01690738535345433,7689,0,274,0,0.08314729616685151,0,4084,0,1757,402,0,6243,2327,0.04752618952964013,241357,122226,
4,0.0,0,4,0,8,27495,11488,391078,0.0031478706851841183,119131,789,0.0364935219113182,3799,395,121,2,518,16076,0.01690738535345433,7689,0,274,0,0.08314729616685151,0,4084,0,1757,402,0,6243,2327,0.04752618952964013,241357,122226,
4,0.0,0,4,0,8,27495,11488,391078,0.0031478706851841183,119131,789,0.0364935219113182,3799,395,121,2,518,16076,0.01690738535345433,7689,0,274,0,0.08314729616685151,0,4084,0,1757,402,0,6243,2327,0.04752618952964013,241357,122226,
4,0.0,0,4,0,8,27495,11488,391078,0.0031478706851841183,119131,789,0.0364935219113182,3799,628,269,39,936,16076,0.01690738535345433,7689,0,359,0,0.13295065572201564,0,4084,0,1757,402,0,6243,2327,0.04752618952964013,241357,122226,
4,0.0,0,4,0,8,27495,11488,391078,0.0031478706851841183,119131,789,0.0364935219113182,3799,628,269,39,936,16076,0.01690738535345433,7689,0,359,0,0.13295065572201564,0,4084,0,1757,402,0,6243,2327,0.04752618952964013,241357,122226,
4,0.0,0,4,0,8,27495,11488,391078,0.0031478706851841183,119131,789,0.0364935219113182,3799,96,92,0,188,16076,0.01690738535345433,7689,0,4,0,0.035347380879457636,0,4084,0,1757,402,0,6243,2327,0.04752618952964013,241357,122226,
679,0.03869969040247678,9,153,526,841,27495,11488,391078,0.028589849169396338,119131,789,0.0364935219113182,3799,50,0,0,50,16076,0.01690738535345433,7689,0,50,50,0.03869969040247678,50,806,0,175,9,50,990,631,0.02979972249239855,241357,122226,
10,0.0,0,33,-23,43,27495,11488,391078,0.005510181824195358,119131,789,0.0364935219113182,3799,59,0,0,59,16076,0.01690738535345433,7689,0,59,0,0.10068259385665529,0,9142,0,3346,564,0,13052,5796,0.03989226963543097,241357,122226,
48,0.0,5,6,42,59,27495,11488,391078,0.02642166338502758,119131,789,0.0364935219113182,3799,90,1,0,91,16076,0.01690738535345433,7689,0,89,0,0.053174809836557944,0,1202,0,113,22,0,1337,1089,0.053508829203120355,241357,122226,
25,0.019801980198019802,0,13,12,38,27495,11488,391078,0.00907894448695455,119131,789,0.0364935219113182,3799,734,90,26,850,16076,0.01690738535345433,7689,1,644,1,0.1226548039098564,2,4416,0,1080,366,0,5862,3336,0.052676017837552665,241357,122226,
25,0.0,0,13,12,38,27495,11488,391078,0.00907894448695455,119131,789,0.0364935219113182,3799,31,1,0,32,16076,0.01690738535345433,7689,0,30,0,0.27084597550918793,0,4416,0,1080,366,0,5862,3336,0.052676017837552665,241357,122226,
25,0.0,0,13,12,38,27495,11488,391078,0.00907894448695455,119131,789,0.0364935219113182,3799,31,1,0,32,16076,0.01690738535345433,7689,0,30,0,0.27084597550918793,0,4416,0,1080,366,0,5862,3336,0.052676017837552665,241357,122226,
25,0.019801980198019802,0,13,12,38,27495,11488,391078,0.00907894448695455,119131,789,0.0364935219113182,3799,734,90,26,850,16076,0.01690738535345433,7689,1,644,1,0.1226548039098564,2,4416,0,1080,366,0,5862,3336,0.052676017837552665,241357,122226,
25,0.019801980198019802,0,13,12,38,27495,11488,391078,0.00907894448695455,119131,789,0.0364935219113182,3799,734,90,26,850,16076,0.01690738535345433,7689,1,644,1,0.1226548039098564,2,4416,0,1080,366,0,5862,3336,0.052676017837552665,241357,122226,
25,0.0,0,13,12,38,27495,11488,391078,0.00907894448695455,119131,789,0.0364935219113182,3799,123,48,81,252,16076,0.01690738535345433,7689,0,75,0,0.02096040534416652,0,4416,0,1080,366,0,5862,3336,0.052676017837552665,241357,122226,
25,0.19166666666666665,0,13,12,38,27495,11488,391078,0.00907894448695455,119131,789,0.0364935219113182,3799,1798,553,114,2465,16076,0.01690738535345433,7689,0,1245,23,0.1343122368650718,23,4416,0,1080,366,23,5862,3336,0.052676017837552665,241357,122226,
25,0.19166666666666665,0,13,12,38,27495,11488,391078,0.00907894448695455,119131,789,0.0364935219113182,3799,1798,553,114,2465,16076,0.01690738535345433,7689,0,1245,23,0.1343122368650718,23,4416,0,1080,366,23,5862,3336,0.052676017837552665,241357,122226,
25,0.19166666666666665,0,13,12,38,27495,11488,391078,0.00907894448695455,119131,789,0.0364935219113182,3799,1798,553,114,2465,16076,0.01690738535345433,7689,0,1245,23,0.1343122368650718,23,4416,0,1080,366,23,5862,3336,0.052676017837552665,241357,122226,
25,0.04839968774395004,0,13,12,38,27495,11488,391078,0.00907894448695455,119131,789,0.0364935219113182,3799,222,53,4,279,16076,0.01690738535345433,7689,12,169,0,0.07891575584666724,12,4416,0,1080,366,-12,5862,3336,0.052676017837552665,241357,122226,
270,0.5431034482758621,0,227,43,497,27495,11488,391078,0.0976569038250232,119131,789,0.0364935219113182,3799,189,0,0,189,16076,0.01690738535345433,7689,0,189,189,0.5431034482758621,189,3095,0,1911,376,189,5382,1184,0.19118514580677626,241357,122226,
270,0.0,0,227,43,497,27495,11488,391078,0.0976569038250232,119131,789,0.0364935219113182,3799,409,282,71,762,16076,0.01690738535345433,7689,0,127,0,0.0835307548199296,0,3095,0,1911,376,0,5382,1184,0.19118514580677626,241357,122226,
444,0.014388489208633094,9,44,400,497,27495,11488,391078,0.1292693382871944,119131,789,0.0364935219113182,3799,337,14,1,352,16076,0.01690738535345433,7689,1,323,1,0.06112032843061104,2,1653,0,485,10,0,2148,1168,0.13069780336465492,241357,122226,
270,0.2707253886010363,0,227,43,497,27495,11488,391078,0.0976569038250232,119131,789,0.0364935219113182,3799,92,220,8,320,16076,0.01690738535345433,7689,190,-128,19,0.10616070034792875,209,3095,0,1911,376,-171,5382,1184,0.19118514580677626,241357,122226,
270,0.0,0,227,43,497,27495,11488,391078,0.0976569038250232,119131,789,0.0364935219113182,3799,633,484,219,1336,16076,0.01690738535345433,7689,0,149,0,0.1038698119863904,0,3095,0,1911,376,0,5382,1184,0.19118514580677626,241357,122226,
270,0.0,0,227,43,497,27495,11488,391078,0.0976569038250232,119131,789,0.0364935219113182,3799,633,484,219,1336,16076,0.01690738535345433,7689,0,149,0,0.1038698119863904,0,3095,0,1911,376,0,5382,1184,0.19118514580677626,241357,122226,
270,0.0,0,227,43,497,27495,11488,391078,0.0976569038250232,119131,789,0.0364935219113182,3799,106,45,6,157,16076,0.01690738535345433,7689,0,61,0,0.03984437491597289,0,3095,0,1911,376,0,5382,1184,0.19118514580677626,241357,122226,
270,0.0,0,227,43,497,27495,11488,391078,0.0976569038250232,119131,789,0.0364935219113182,3799,106,45,6,157,16076,0.01690738535345433,7689,0,61,0,0.03984437491597289,0,3095,0,1911,376,0,5382,1184,0.19118514580677626,241357,122226,
270,0.0,0,227,43,497,27495,11488,391078,0.0976569038250232,119131,789,0.0364935219113182,3799,260,0,0,260,16076,0.01690738535345433,7689,0,260,0,0.4585537918871252,0,3095,0,1911,376,0,5382,1184,0.19118514580677626,241357,122226,
270,0.0,0,227,43,497,27495,11488,391078,0.0976569038250232,119131,789,0.0364935219113182,3799,260,0,0,260,16076,0.01690738535345433,7689,0,260,0,0.4585537918871252,0,3095,0,1911,376,0,5382,1184,0.19118514580677626,241357,122226,
444,0.1324842876421824,9,44,400,497,27495,11488,391078,0.1292693382871944,119131,789,0.0364935219113182,3799,123,432,6,561,16076,0.01690738535345433,7689,12,-309,26,0.15045294817695892,44,1653,6,485,10,14,2148,1168,0.13069780336465492,241357,122226,
444,0.16,9,44,400,497,27495,11488,391078,0.1292693382871944,119131,789,0.0364935219113182,3799,120,8,0,128,16076,0.01690738535345433,7689,8,112,8,0.10825532434868057,16,1653,0,485,10,0,2148,1168,0.13069780336465492,241357,122226,
444,0.21165900637171722,9,44,400,497,27495,11488,391078,0.1292693382871944,119131,789,0.0364935219113182,3799,713,24,3,740,16076,0.01690738535345433,7689,20,689,111,0.1641265806338373,134,1653,3,485,10,91,2148,1168,0.13069780336465492,241357,122226,
444,0.014388489208633094,9,44,400,497,27495,11488,391078,0.1292693382871944,119131,789,0.0364935219113182,3799,337,14,1,352,16076,0.01690738535345433,7689,1,323,1,0.06112032843061104,2,1653,0,485,10,0,2148,1168,0.13069780336465492,241357,122226,
444,0.014388489208633094,9,44,400,497,27495,11488,391078,0.1292693382871944,119131,789,0.0364935219113182,3799,337,14,1,352,16076,0.01690738535345433,7689,1,323,1,0.06112032843061104,2,1653,0,485,10,0,2148,1168,0.13069780336465492,241357,122226,
444,0.014388489208633094,9,44,400,497,27495,11488,391078,0.1292693382871944,119131,789,0.0364935219113182,3799,337,14,1,352,16076,0.01690738535345433,7689,1,323,1,0.06112032843061104,2,1653,0,485,10,0,2148,1168,0.13069780336465492,241357,122226,
444,0.014388489208633094,9,44,400,497,27495,11488,391078,0.1292693382871944,119131,789,0.0364935219113182,3799,337,14,1,352,16076,0.01690738535345433,7689,1,323,1,0.06112032843061104,2,1653,0,485,10,0,2148,1168,0.13069780336465492,241357,122226,
444,0.014388489208633094,9,44,400,497,27495,11488,391078,0.1292693382871944,119131,789,0.0364935219113182,3799,337,14,1,352,16076,0.01690738535345433,7689,1,323,1,0.06112032843061104,2,1653,0,485,10,0,2148,1168,0.13069780336465492,241357,122226,
280,0.0,1,10,270,291,27495,11488,391078,0.0733296940358264,119131,789,0.0364935219113182,3799,874,251,51,1176,16076,0.01690738535345433,7689,0,623,0,0.24584118923307313,0,2979,0,1649,305,0,4933,1330,0.19666337945015888,241357,122226,
280,0.0,1,10,270,291,27495,11488,391078,0.0733296940358264,119131,789,0.0364935219113182,3799,874,251,51,1176,16076,0.01690738535345433,7689,0,623,0,0.24584118923307313,0,2979,0,1649,305,0,4933,1330,0.19666337945015888,241357,122226,
280,0.0,1,10,270,291,27495,11488,391078,0.0733296940358264,119131,789,0.0364935219113182,3799,874,251,51,1176,16076,0.01690738535345433,7689,0,623,0,0.24584118923307313,0,2979,0,1649,305,0,4933,1330,0.19666337945015888,241357,122226,
280,0.0,1,10,270,291,27495,11488,391078,0.0733296940358264,119131,789,0.0364935219113182,3799,874,251,51,1176,16076,0.01690738535345433,7689,0,623,0,0.24584118923307313,0,2979,0,1649,305,0,4933,1330,0.19666337945015888,241357,122226,
280,0.0,1,10,270,291,27495,11488,391078,0.0733296940358264,119131,789,0.0364935219113182,3799,1287,1359,248,2894,16076,0.01690738535345433,7689,0,-72,0,0.2073529451807659,0,2979,0,1649,305,0,4933,1330,0.19666337945015888,241357,122226,
280,0.0,1,10,270,291,27495,11488,391078,0.0733296940358264,119131,789,0.0364935219113182,3799,1287,1359,248,2894,16076,0.01690738535345433,7689,0,-72,0,0.2073529451807659,0,2979,0,1649,305,0,4933,1330,0.19666337945015888,241357,122226,
280,0.0,1,10,270,291,27495,11488,391078,0.0733296940358264,119131,789,0.0364935219113182,3799,1287,1359,248,2894,16076,0.01690738535345433,7689,0,-72,0,0.2073529451807659,0,2979,0,1649,305,0,4933,1330,0.19666337945015888,241357,122226,
280,0.02046533940993044,1,10,270,291,27495,11488,391078,0.0733296940358264,119131,789,0.0364935219113182,3799,545,36,5,586,16076,0.01690738535345433,7689,7,509,7,0.06060594665342137,14,2979,0,1649,305,0,4933,1330,0.19666337945015888,241357,122226,
280,0.02046533940993044,1,10,270,291,27495,11488,391078,0.0733296940358264,119131,789,0.0364935219113182,3799,545,36,5,586,16076,0.01690738535345433,7689,7,509,7,0.06060594665342137,14,2979,0,1649,305,0,4933,1330,0.19666337945015888,241357,122226,
280,0.02046533940993044,1,10,270,291,27495,11488,391078,0.0733296940358264,119131,789,0.0364935219113182,3799,545,36,5,586,16076,0.01690738535345433,7689,7,509,7,0.06060594665342137,14,2979,0,1649,305,0,4933,1330,0.19666337945015888,241357,122226,
280,0.02046533940993044,1,10,270,291,27495,11488,391078,0.0733296940358264,119131,789,0.0364935219113182,3799,545,36,5,586,16076,0.01690738535345433,7689,7,509,7,0.06060594665342137,14,2979,0,1649,305,0,4933,1330,0.19666337945015888,241357,122226,
280,0.02046533940993044,1,10,270,291,27495,11488,391078,0.0733296940358264,119131,789,0.0364935219113182,3799,545,36,5,586,16076,0.01690738535345433,7689,7,509,7,0.06060594665342137,14,2979,0,1649,305,0,4933,1330,0.19666337945015888,241357,122226,
280,0.02046533940993044,1,10,270,291,27495,11488,391078,0.0733296940358264,119131,789,0.0364935219113182,3799,545,36,5,586,16076,0.01690738535345433,7689,7,509,7,0.06060594665342137,14,2979,0,1649,305,0,4933,1330,0.19666337945015888,241357,122226,
0,0.0,0,0,0,0,27495,11488,391078,0.0,119131,789,0.0364935219113182,3799,0,0,0,0,16076,0.01690738535345433,7689,0,0,0,0.0,0,0,0,0,0,0,0,0,0.0,241357,122226,
0,0.0,0,0,0,0,27495,11488,391078,0.0,119131,789,0.0364935219113182,3799,0,0,0,0,16076,0.01690738535345433,7689,0,0,0,0.0,0,0,0,0,0,0,0,0,0.0,241357,122226,
0,0.0,0,0,0,0,27495,11488,391078,0.0,119131,789,0.0364935219113182,3799,0,0,0,0,16076,0.01690738535345433,7689,0,0,0,0.0,0,0,0,0,0,0,0,0,0.0,241357,122226,
0,0.0,0,0,0,0,27495,11488,391078,0.0,119131,789,0.0364935219113182,3799,0,0,0,0,16076,0.01690738535345433,7689,0,0,0,0.0,0,0,0,0,0,0,0,0,0.0,241357,122226,
0,0.0,0,0,0,0,27495,11488,391078,0.0,119131,789,0.0364935219113182,3799,0,0,0,0,16076,0.01690738535345433,7689,0,0,0,0.0,0,0,0,0,0,0,0,0,0.0,241357,122226,
0,0.0,0,0,0,0,27495,11488,391078,0.0,119131,789,0.0364935219113182,3799,0,0,0,0,16076,0.01690738535345433,7689,0,0,0,0.0,0,0,0,0,0,0,0,0,0.0,241357,122226,
0,0.0,0,0,0,0,27495,11488,391078,0.0,119131,789,0.0364935219113182,3799,0,0,0,0,16076,0.01690738535345433,7689,0,0,0,0.0,0,0,0,0,0,0,0,0,0.0,241357,122226,
0,0.0,0,0,0,0,27495,11488,391078,0.0,119131,789,0.0364935219113182,3799,0,0,0,0,16076,0.01690738535345433,7689,0,0,0,0.0,0,0,0,0,0,0,0,0,0.0,241357,122226,
0,0.0,0,0,0,0,27495,11488,391078,0.0,119131,789,0.0364935219113182,3799,0,0,0,0,16076,0.01690738535345433,7689,0,0,0,0.0,0,0,0,0,0,0,0,0,0.0,241357,122226,
20,0.0,0,4,16,24,27495,11488,391078,0.027722856799580118,119131,789,0.0364935219113182,3799,90,20,0,110,16076,0.01690738535345433,7689,0,70,0,0.04502410389360452,0,1372,0,265,75,0,1712,1107,0.08196704822405808,241357,122226,
20,0.0,0,4,16,24,27495,11488,391078,0.027722856799580118,119131,789,0.0364935219113182,3799,90,20,0,110,16076,0.01690738535345433,7689,0,70,0,0.04502410389360452,0,1372,0,265,75,0,1712,1107,0.08196704822405808,241357,122226,
20,0.0,0,4,16,24,27495,11488,391078,0.027722856799580118,119131,789,0.0364935219113182,3799,90,20,0,110,16076,0.01690738535345433,7689,0,70,0,0.04502410389360452,0,1372,0,265,75,0,1712,1107,0.08196704822405808,241357,122226,
20,0.0,0,4,16,24,27495,11488,391078,0.027722856799580118,119131,789,0.0364935219113182,3799,90,20,0,110,16076,0.01690738535345433,7689,0,70,0,0.04502410389360452,0,1372,0,265,75,0,1712,1107,0.08196704822405808,241357,122226,
20,0.0,0,4,16,24,27495,11488,391078,0.027722856799580118,119131,789,0.0364935219113182,3799,90,20,0,110,16076,0.01690738535345433,7689,0,70,0,0.04502410389360452,0,1372,0,265,75,0,1712,1107,0.08196704822405808,241357,122226,
20,0.0,0,4,16,24,27495,11488,391078,0.027722856799580118,119131,789,0.0364935219113182,3799,90,20,0,110,16076,0.01690738535345433,7689,0,70,0,0.04502410389360452,0,1372,0,265,75,0,1712,1107,0.08196704822405808,241357,122226,
20,0.0,0,4,16,24,27495,11488,391078,0.027722856799580118,119131,789,0.0364935219113182,3799,90,20,0,110,16076,0.01690738535345433,7689,0,70,0,0.04502410389360452,0,1372,0,265,75,0,1712,1107,0.08196704822405808,241357,122226,
20,0.0,0,4,16,24,27495,11488,391078,0.027722856799580118,119131,789,0.0364935219113182,3799,90,20,0,110,16076,0.01690738535345433,7689,0,70,0,0.04502410389360452,0,1372,0,265,75,0,1712,1107,0.08196704822405808,241357,122226,
20,0.0,0,4,16,24,27495,11488,391078,0.027722856799580118,119131,789,0.0364935219113182,3799,90,20,0,110,16076,0.01690738535345433,7689,0,70,0,0.04502410389360452,0,1372,0,265,75,0,1712,1107,0.08196704822405808,241357,122226,
20,0.0,0,4,16,24,27495,11488,391078,0.027722856799580118,119131,789,0.0364935219113182,3799,90,20,0,110,16076,0.01690738535345433,7689,0,70,0,0.04502410389360452,0,1372,0,265,75,0,1712,1107,0.08196704822405808,241357,122226,
20,0.0,0,4,16,24,27495,11488,391078,0.027722856799580118,119131,789,0.0364935219113182,3799,342,107,9,458,16076,0.01690738535345433,7689,0,235,0,0.12129992825546392,0,1372,0,265,75,0,1712,1107,0.08196704822405808,241357,122226,
20,0.0,0,4,16,24,27495,11488,391078,0.027722856799580118,119131,789,0.0364935219113182,3799,342,107,9,458,16076,0.01690738535345433,7689,0,235,0,0.12129992825546392,0,1372,0,265,75,0,1712,1107,0.08196704822405808,241357,122226,
20,0.0,0,4,16,24,27495,11488,391078,0.027722856799580118,119131,789,0.0364935219113182,3799,342,107,9,458,16076,0.01690738535345433,7689,0,235,0,0.12129992825546392,0,1372,0,265,75,0,1712,1107,0.08196704822405808,241357,122226,
20,0.0,0,4,16,24,27495,11488,391078,0.027722856799580118,119131,789,0.0364935219113182,3799,342,107,9,458,16076,0.01690738535345433,7689,0,235,0,0.12129992825546392,0,1372,0,265,75,0,1712,1107,0.08196704822405808,241357,122226,
20,0.0,0,4,16,24,27495,11488,391078,0.027722856799580118,119131,789,0.0364935219113182,3799,342,107,9,458,16076,0.01690738535345433,7689,0,235,0,0.12129992825546392,0,1372,0,265,75,0,1712,1107,0.08196704822405808,241357,122226,
20,0.0,0,4,16,24,27495,11488,391078,0.027722856799580118,119131,789,0.0364935219113182,3799,342,107,9,458,16076,0.01690738535345433,7689,0,235,0,0.12129992825546392,0,1372,0,265,75,0,1712,1107,0.08196704822405808,241357,122226,
20,0.0,0,4,16,24,27495,11488,391078,0.027722856799580118,119131,789,0.0364935219113182,3799,97,8,0,105,16076,0.01690738535345433,7689,0,89,0,0.007651742465676747,0,1372,0,265,75,0,1712,1107,0.08196704822405808,241357,122226,
20,0.0,0,4,16,24,27495,11488,391078,0.027722856799580118,119131,789,0.0364935219113182,3799,97,8,0,105,16076,0.01690738535345433,7689,0,89,0,0.007651742465676747,0,1372,0,265,75,0,1712,1107,0.08196704822405808,241357,122226,
20,0.0,0,4,16,24,27495,11488,391078,0.027722856799580118,119131,789,0.0364935219113182,3799,37,0,0,37,16076,0.01690738535345433,7689,0,37,0,0.005092239962826169,0,1372,0,265,75,0,1712,1107,0.08196704822405808,241357,122226,
20,0.0,0,4,16,24,27495,11488,391078,0.027722856799580118,119131,789,0.0364935219113182,3799,58,0,0,58,16076,0.01690738535345433,7689,0,58,0,0.11788617886178862,0,1372,0,265,75,0,1712,1107,0.08196704822405808,241357,122226,
20,0.0,0,4,16,24,27495,11488,391078,0.027722856799580118,119131,789,0.0364935219113182,3799,58,0,0,58,16076,0.01690738535345433,7689,0,58,0,0.11788617886178862,0,1372,0,265,75,0,1712,1107,0.08196704822405808,241357,122226,
20,0.0,0,4,16,24,27495,11488,391078,0.027722856799580118,119131,789,0.0364935219113182,3799,58,0,0,58,16076,0.01690738535345433,7689,0,58,0,0.11788617886178862,0,1372,0,265,75,0,1712,1107,0.08196704822405808,241357,122226,
269,0.18041237113402062,11,76,193,356,27495,11488,391078,0.02879883965760438,119131,789,0.0364935219113182,3799,63,13,13,89,16076,0.01690738535345433,7689,10,50,53,0.09057249156408817,70,8343,7,3972,852,43,13167,4371,0.054128191009951906,241357,122226,
269,0.09876543209876543,11,76,193,356,27495,11488,391078,0.02879883965760438,119131,789,0.0364935219113182,3799,108,0,0,108,16076,0.01690738535345433,7689,0,108,32,0.04768162940205951,32,8343,0,3972,852,32,13167,4371,0.054128191009951906,241357,122226,
269,0.09876543209876543,11,76,193,356,27495,11488,391078,0.02879883965760438,119131,789,0.0364935219113182,3799,108,0,0,108,16076,0.01690738535345433,7689,0,108,32,0.04768162940205951,32,8343,0,3972,852,32,13167,4371,0.054128191009951906,241357,122226,
269,0.16666666666666666,11,76,193,356,27495,11488,391078,0.02879883965760438,119131,789,0.0364935219113182,3799,249,110,69,428,16076,0.01690738535345433,7689,3,139,3,0.08443956885483854,6,8343,0,3972,852,0,13167,4371,0.054128191009951906,241357,122226,
269,0.16100178890876565,11,76,193,356,27495,11488,391078,0.02879883965760438,119131,789,0.0364935219113182,3799,133,87,5,225,16076,0.01690738535345433,7689,0,46,90,0.05018142206206703,90,8343,0,3972,852,90,13167,4371,0.054128191009951906,241357,122226,
269,0.16100178890876565,11,76,193,356,27495,11488,391078,0.02879883965760438,119131,789,0.0364935219113182,3799,133,87,5,225,16076,0.01690738535345433,7689,0,46,90,0.05018142206206703,90,8343,0,3972,852,90,13167,4371,0.054128191009951906,241357,122226,
269,0.0,11,76,193,356,27495,11488,391078,0.02879883965760438,119131,789,0.0364935219113182,3799,217,82,7,306,16076,0.01690738535345433,7689,0,135,0,0.10934176679532619,0,8343,0,3972,852,0,13167,4371,0.054128191009951906,241357,122226,
269,0.0,11,76,193,356,27495,11488,391078,0.02879883965760438,119131,789,0.0364935219113182,3799,94,30,2,126,16076,0.01690738535345433,7689,0,64,0,0.06936323867225455,0,8343,0,3972,852,0,13167,4371,0.054128191009951906,241357,122226,
269,0.0,11,76,193,356,27495,11488,391078,0.02879883965760438,119131,789,0.0364935219113182,3799,94,30,2,126,16076,0.01690738535345433,7689,0,64,0,0.06936323867225455,0,8343,0,3972,852,0,13167,4371,0.054128191009951906,241357,122226,
269,0.0024906600249066002,11,76,193,356,27495,11488,391078,0.02879883965760438,119131,789,0.0364935219113182,3799,16,13,0,29,16076,0.01690738535345433,7689,2,3,2,0.05387220432326708,4,8343,0,3972,852,0,13167,4371,0.054128191009951906,241357,122226,
269,0.0,11,76,193,356,27495,11488,391078,0.02879883965760438,119131,789,0.0364935219113182,3799,173,12,0,185,16076,0.01690738535345433,7689,0,161,0,0.027577619930469654,0,8343,0,3972,852,0,13167,4371,0.054128191009951906,241357,122226,
269,0.13333333333333333,11,76,193,356,27495,11488,391078,0.02879883965760438,119131,789,0.0364935219113182,3799,102,31,1,134,16076,0.01690738535345433,7689,1,71,1,0.0790526955548798,2,8343,0,3972,852,0,13167,4371,0.054128191009951906,241357,122226,
269,0.13333333333333333,11,76,193,356,27495,11488,391078,0.02879883965760438,119131,789,0.0364935219113182,3799,102,31,1,134,16076,0.01690738535345433,7689,1,71,1,0.0790526955548798,2,8343,0,3972,852,0,13167,4371,0.054128191009951906,241357,122226,
269,0.022113022113022112,11,76,193,356,27495,11488,391078,0.02879883965760438,119131,789,0.0364935219113182,3799,228,412,41,681,16076,0.01690738535345433,7689,5,-184,4,0.07079218359257969,9,8343,0,3972,852,-1,13167,4371,0.054128191009951906,241357,122226,
269,0.2857142857142857,11,76,193,356,27495,11488,391078,0.02879883965760438,119131,789,0.0364935219113182,3799,90,21,2,113,16076,0.01690738535345433,7689,0,69,8,0.08909905890886748,10,8343,2,3972,852,8,13167,4371,0.054128191009951906,241357,122226,
269,0.0,11,76,193,356,27495,11488,391078,0.02879883965760438,119131,789,0.0364935219113182,3799,292,309,47,648,16076,0.01690738535345433,7689,0,-17,0,0.04786571572147,0,8343,0,3972,852,0,13167,4371,0.054128191009951906,241357,122226,
269,0.0,11,76,193,356,27495,11488,391078,0.02879883965760438,119131,789,0.0364935219113182,3799,292,309,47,648,16076,0.01690738535345433,7689,0,-17,0,0.04786571572147,0,8343,0,3972,852,0,13167,4371,0.054128191009951906,241357,122226,
269,0.1926605504587156,11,76,193,356,27495,11488,391078,0.02879883965760438,119131,789,0.0364935219113182,3799,312,74,2,388,16076,0.01690738535345433,7689,5,238,16,0.1388532328593199,21,8343,0,3972,852,11,13167,4371,0.054128191009951906,241357,122226,
269,0.03289473684210526,11,76,193,356,27495,11488,391078,0.02879883965760438,119131,789,0.0364935219113182,3799,2083,863,275,3221,16076,0.01690738535345433,7689,2,1220,4,0.1015445166034933,6,8343,0,3972,852,2,13167,4371,0.054128191009951906,241357,122226,
269,0.03289473684210526,11,76,193,356,27495,11488,391078,0.02879883965760438,119131,789,0.0364935219113182,3799,2083,863,275,3221,16076,0.01690738535345433,7689,2,1220,4,0.1015445166034933,6,8343,0,3972,852,2,13167,4371,0.054128191009951906,241357,122226,
269,0.03289473684210526,11,76,193,356,27495,11488,391078,0.02879883965760438,119131,789,0.0364935219113182,3799,2083,863,275,3221,16076,0.01690738535345433,7689,2,1220,4,0.1015445166034933,6,8343,0,3972,852,2,13167,4371,0.054128191009951906,241357,122226,
269,0.03289473684210526,11,76,193,356,27495,11488,391078,0.02879883965760438,119131,789,0.0364935219113182,3799,2083,863,275,3221,16076,0.01690738535345433,7689,2,1220,4,0.1015445166034933,6,8343,0,3972,852,2,13167,4371,0.054128191009951906,241357,122226,
269,0.03289473684210526,11,76,193,356,27495,11488,391078,0.02879883965760438,119131,789,0.0364935219113182,3799,2083,863,275,3221,16076,0.01690738535345433,7689,2,1220,4,0.1015445166034933,6,8343,0,3972,852,2,13167,4371,0.054128191009951906,241357,122226,
269,0.03289473684210526,11,76,193,356,27495,11488,391078,0.02879883965760438,119131,789,0.0364935219113182,3799,2083,863,275,3221,16076,0.01690738535345433,7689,2,1220,4,0.1015445166034933,6,8343,0,3972,852,2,13167,4371,0.054128191009951906,241357,122226,
269,0.03289473684210526,11,76,193,356,27495,11488,391078,0.02879883965760438,119131,789,0.0364935219113182,3799,2083,863,275,3221,16076,0.01690738535345433,7689,2,1220,4,0.1015445166034933,6,8343,0,3972,852,2,13167,4371,0.054128191009951906,241357,122226,
269,0.03289473684210526,11,76,193,356,27495,11488,391078,0.02879883965760438,119131,789,0.0364935219113182,3799,2083,863,275,3221,16076,0.01690738535345433,7689,2,1220,4,0.1015445166034933,6,8343,0,3972,852,2,13167,4371,0.054128191009951906,241357,122226,
269,0.03289473684210526,11,76,193,356,27495,11488,391078,0.02879883965760438,119131,789,0.0364935219113182,3799,2083,863,275,3221,16076,0.01690738535345433,7689,2,1220,4,0.1015445166034933,6,8343,0,3972,852,2,13167,4371,0.054128191009951906,241357,122226,
269,0.03289473684210526,11,76,193,356,27495,11488,391078,0.02879883965760438,119131,789,0.0364935219113182,3799,2083,863,275,3221,16076,0.01690738535345433,7689,2,1220,4,0.1015445166034933,6,8343,0,3972,852,2,13167,4371,0.054128191009951906,241357,122226,
269,0.01098901098901099,11,76,193,356,27495,11488,391078,0.02879883965760438,119131,789,0.0364935219113182,3799,359,101,5,465,16076,0.01690738535345433,7689,10,258,10,0.05799463064565128,20,8343,0,3972,852,0,13167,4371,0.054128191009951906,241357,122226,
269,0.01098901098901099,11,76,193,356,27495,11488,391078,0.02879883965760438,119131,789,0.0364935219113182,3799,359,101,5,465,16076,0.01690738535345433,7689,10,258,10,0.05799463064565128,20,8343,0,3972,852,0,13167,4371,0.054128191009951906,241357,122226,
269,0.01098901098901099,11,76,193,356,27495,11488,391078,0.02879883965760438,119131,789,0.0364935219113182,3799,359,101,5,465,16076,0.01690738535345433,7689,10,258,10,0.05799463064565128,20,8343,0,3972,852,0,13167,4371,0.054128191009951906,241357,122226,
269,0.01098901098901099,11,76,193,356,27495,11488,391078,0.02879883965760438,119131,789,0.0364935219113182,3799,359,101,5,465,16076,0.01690738535345433,7689,10,258,10,0.05799463064565128,20,8343,0,3972,852,0,13167,4371,0.054128191009951906,241357,122226,
269,0.01098901098901099,11,76,193,356,27495,11488,391078,0.02879883965760438,119131,789,0.0364935219113182,3799,359,101,5,465,16076,0.01690738535345433,7689,10,258,10,0.05799463064565128,20,8343,0,3972,852,0,13167,4371,0.054128191009951906,241357,122226,
269,0.01098901098901099,11,76,193,356,27495,11488,391078,0.02879883965760438,119131,789,0.0364935219113182,3799,359,101,5,465,16076,0.01690738535345433,7689,10,258,10,0.05799463064565128,20,8343,0,3972,852,0,13167,4371,0.054128191009951906,241357,122226,
269,0.0,11,76,193,356,27495,11488,391078,0.02879883965760438,119131,789,0.0364935219113182,3799,15,1,0,16,16076,0.01690738535345433,7689,0,14,0,0.1396780303030303,0,8343,0,3972,852,0,13167,4371,0.054128191009951906,241357,122226,
269,0.0010911074740861974,11,76,193,356,27495,11488,391078,0.02879883965760438,119131,789,0.0364935219113182,3799,235,6,0,241,16076,0.01690738535345433,7689,1,229,1,0.10947015198755397,2,8343,0,3972,852,0,13167,4371,0.054128191009951906,241357,122226,
269,0.0010911074740861974,11,76,193,356,27495,11488,391078,0.02879883965760438,119131,789,0.0364935219113182,3799,235,6,0,241,16076,0.01690738535345433,7689,1,229,1,0.10947015198755397,2,8343,0,3972,852,0,13167,4371,0.054128191009951906,241357,122226,
269,0.0010911074740861974,11,76,193,356,27495,11488,391078,0.02879883965760438,119131,789,0.0364935219113182,3799,235,6,0,241,16076,0.01690738535345433,7689,1,229,1,0.10947015198755397,2,8343,0,3972,852,0,13167,4371,0.054128191009951906,241357,122226,
269,0.0010911074740861974,11,76,193,356,27495,11488,391078,0.02879883965760438,119131,789,0.0364935219113182,3799,235,6,0,241,16076,0.01690738535345433,7689,1,229,1,0.10947015198755397,2,8343,0,3972,852,0,13167,4371,0.054128191009951906,241357,122226,
269,0.0010911074740861974,11,76,193,356,27495,11488,391078,0.02879883965760438,119131,789,0.0364935219113182,3799,235,6,0,241,16076,0.01690738535345433,7689,1,229,1,0.10947015198755397,2,8343,0,3972,852,0,13167,4371,0.054128191009951906,241357,122226,
269,0.11152416356877323,11,76,193,356,27495,11488,391078,0.02879883965760438,119131,789,0.0364935219113182,3799,156,28,8,192,16076,0.01690738535345433,7689,7,128,21,0.08623000731309652,30,8343,2,3972,852,14,13167,4371,0.054128191009951906,241357,122226,
269,0.11152416356877323,11,76,193,356,27495,11488,391078,0.02879883965760438,119131,789,0.0364935219113182,3799,156,28,8,192,16076,0.01690738535345433,7689,7,128,21,0.08623000731309652,30,8343,2,3972,852,14,13167,4371,0.054128191009951906,241357,122226,
269,0.01384083044982699,11,76,193,356,27495,11488,391078,0.02879883965760438,119131,789,0.0364935219113182,3799,216,92,48,356,16076,0.01690738535345433,7689,4,124,4,0.04673402596747194,8,8343,0,3972,852,0,13167,4371,0.054128191009951906,241357,122226,
269,0.01384083044982699,11,76,193,356,27495,11488,391078,0.02879883965760438,119131,789,0.0364935219113182,3799,216,92,48,356,16076,0.01690738535345433,7689,4,124,4,0.04673402596747194,8,8343,0,3972,852,0,13167,4371,0.054128191009951906,241357,122226,
269,0.01384083044982699,11,76,193,356,27495,11488,391078,0.02879883965760438,119131,789,0.0364935219113182,3799,216,92,48,356,16076,0.01690738535345433,7689,4,124,4,0.04673402596747194,8,8343,0,3972,852,0,13167,4371,0.054128191009951906,241357,122226,
269,0.01384083044982699,11,76,193,356,27495,11488,391078,0.02879883965760438,119131,789,0.0364935219113182,3799,216,92,48,356,16076,0.01690738535345433,7689,4,124,4,0.04673402596747194,8,8343,0,3972,852,0,13167,4371,0.054128191009951906,241357,122226,
269,0.01384083044982699,11,76,193,356,27495,11488,391078,0.02879883965760438,119131,789,0.0364935219113182,3799,216,92,48,356,16076,0.01690738535345433,7689,4,124,4,0.04673402596747194,8,8343,0,3972,852,0,13167,4371,0.054128191009951906,241357,122226,
269,0.0851063829787234,11,76,193,356,27495,11488,391078,0.02879883965760438,119131,789,0.0364935219113182,3799,1160,894,235,2289,16076,0.01690738535345433,7689,2,266,2,0.0678800237774167,4,8343,0,3972,852,0,13167,4371,0.054128191009951906,241357,122226,
0,0.0,2,0,0,2,27495,11488,391078,0.004784688995215311,119131,789,0.0364935219113182,3799,26,0,0,26,16076,0.01690738535345433,7689,0,26,0,0.012109920819748486,0,247,0,38,8,0,293,209,0.009691550541914212,241357,122226,
9,0.19230769230769232,0,4,5,13,27495,11488,391078,0.006364531501330407,119131,789,0.0364935219113182,3799,853,311,135,1299,16076,0.01690738535345433,7689,2,542,3,0.22887109394281582,5,3505,0,971,600,1,5076,2534,0.04465136137772993,241357,122226,
9,0.19230769230769232,0,4,5,13,27495,11488,391078,0.006364531501330407,119131,789,0.0364935219113182,3799,853,311,135,1299,16076,0.01690738535345433,7689,2,542,3,0.22887109394281582,5,3505,0,971,600,1,5076,2534,0.04465136137772993,241357,122226,
9,0.19230769230769232,0,4,5,13,27495,11488,391078,0.006364531501330407,119131,789,0.0364935219113182,3799,853,311,135,1299,16076,0.01690738535345433,7689,2,542,3,0.22887109394281582,5,3505,0,971,600,1,5076,2534,0.04465136137772993,241357,122226,
9,0.19230769230769232,0,4,5,13,27495,11488,391078,0.006364531501330407,119131,789,0.0364935219113182,3799,853,311,135,1299,16076,0.01690738535345433,7689,2,542,3,0.22887109394281582,5,3505,0,971,600,1,5076,2534,0.04465136137772993,241357,122226,
9,0.19230769230769232,0,4,5,13,27495,11488,391078,0.006364531501330407,119131,789,0.0364935219113182,3799,853,311,135,1299,16076,0.01690738535345433,7689,2,542,3,0.22887109394281582,5,3505,0,971,600,1,5076,2534,0.04465136137772993,241357,122226,
9,0.19230769230769232,0,4,5,13,27495,11488,391078,0.006364531501330407,119131,789,0.0364935219113182,3799,853,311,135,1299,16076,0.01690738535345433,7689,2,542,3,0.22887109394281582,5,3505,0,971,600,1,5076,2534,0.04465136137772993,241357,122226,
9,0.19230769230769232,0,4,5,13,27495,11488,391078,0.006364531501330407,119131,789,0.0364935219113182,3799,853,311,135,1299,16076,0.01690738535345433,7689,2,542,3,0.22887109394281582,5,3505,0,971,600,1,5076,2534,0.04465136137772993,241357,122226,
9,0.19230769230769232,0,4,5,13,27495,11488,391078,0.006364531501330407,119131,789,0.0364935219113182,3799,853,311,135,1299,16076,0.01690738535345433,7689,2,542,3,0.22887109394281582,5,3505,0,971,600,1,5076,2534,0.04465136137772993,241357,122226,
9,0.19230769230769232,0,4,5,13,27495,11488,391078,0.006364531501330407,119131,789,0.0364935219113182,3799,853,311,135,1299,16076,0.01690738535345433,7689,2,542,3,0.22887109394281582,5,3505,0,971,600,1,5076,2534,0.04465136137772993,241357,122226,
9,0.19230769230769232,0,4,5,13,27495,11488,391078,0.006364531501330407,119131,789,0.0364935219113182,3799,853,311,135,1299,16076,0.01690738535345433,7689,2,542,3,0.22887109394281582,5,3505,0,971,600,1,5076,2534,0.04465136137772993,241357,122226,
9,0.19230769230769232,0,4,5,13,27495,11488,391078,0.006364531501330407,119131,789,0.0364935219113182,3799,853,311,135,1299,16076,0.01690738535345433,7689,2,542,3,0.22887109394281582,5,3505,0,971,600,1,5076,2534,0.04465136137772993,241357,122226,
9,0.19230769230769232,0,4,5,13,27495,11488,391078,0.006364531501330407,119131,789,0.0364935219113182,3799,853,311,135,1299,16076,0.01690738535345433,7689,2,542,3,0.22887109394281582,5,3505,0,971,600,1,5076,2534,0.04465136137772993,241357,122226,
9,0.19230769230769232,0,4,5,13,27495,11488,391078,0.006364531501330407,119131,789,0.0364935219113182,3799,853,311,135,1299,16076,0.01690738535345433,7689,2,542,3,0.22887109394281582,5,3505,0,971,600,1,5076,2534,0.04465136137772993,241357,122226,
9,0.19230769230769232,0,4,5,13,27495,11488,391078,0.006364531501330407,119131,789,0.0364935219113182,3799,853,311,135,1299,16076,0.01690738535345433,7689,2,542,3,0.22887109394281582,5,3505,0,971,600,1,5076,2534,0.04465136137772993,241357,122226,
9,0.19230769230769232,0,4,5,13,27495,11488,391078,0.006364531501330407,119131,789,0.0364935219113182,3799,853,311,135,1299,16076,0.01690738535345433,7689,2,542,3,0.22887109394281582,5,3505,0,971,600,1,5076,2534,0.04465136137772993,241357,122226,
9,0.19230769230769232,0,4,5,13,27495,11488,391078,0.006364531501330407,119131,789,0.0364935219113182,3799,853,311,135,1299,16076,0.01690738535345433,7689,2,542,3,0.22887109394281582,5,3505,0,971,600,1,5076,2534,0.04465136137772993,241357,122226,
9,0.19230769230769232,0,4,5,13,27495,11488,391078,0.006364531501330407,119131,789,0.0364935219113182,3799,853,311,135,1299,16076,0.01690738535345433,7689,2,542,3,0.22887109394281582,5,3505,0,971,600,1,5076,2534,0.04465136137772993,241357,122226,
9,0.19230769230769232,0,4,5,13,27495,11488,391078,0.006364531501330407,119131,789,0.0364935219113182,3799,853,311,135,1299,16076,0.01690738535345433,7689,2,542,3,0.22887109394281582,5,3505,0,971,600,1,5076,2534,0.04465136137772993,241357,122226,
9,0.19230769230769232,0,4,5,13,27495,11488,391078,0.006364531501330407,119131,789,0.0364935219113182,3799,853,311,135,1299,16076,0.01690738535345433,7689,2,542,3,0.22887109394281582,5,3505,0,971,600,1,5076,2534,0.04465136137772993,241357,122226,
9,0.19230769230769232,0,4,5,13,27495,11488,391078,0.006364531501330407,119131,789,0.0364935219113182,3799,853,311,135,1299,16076,0.01690738535345433,7689,2,542,3,0.22887109394281582,5,3505,0,971,600,1,5076,2534,0.04465136137772993,241357,122226,
9,0.0,0,4,5,13,27495,11488,391078,0.006364531501330407,119131,789,0.0364935219113182,3799,0,0,0,0,16076,0.01690738535345433,7689,0,0,0,0.0,0,3505,0,971,600,0,5076,2534,0.04465136137772993,241357,122226,
9,0.17647058823529413,0,4,5,13,27495,11488,391078,0.006364531501330407,119131,789,0.0364935219113182,3799,205,2,0,207,16076,0.01690738535345433,7689,1,203,2,0.07208389907540412,3,3505,0,971,600,1,5076,2534,0.04465136137772993,241357,122226,
9,0.17647058823529413,0,4,5,13,27495,11488,391078,0.006364531501330407,119131,789,0.0364935219113182,3799,205,2,0,207,16076,0.01690738535345433,7689,1,203,2,0.07208389907540412,3,3505,0,971,600,1,5076,2534,0.04465136137772993,241357,122226,
9,0.17647058823529413,0,4,5,13,27495,11488,391078,0.006364531501330407,119131,789,0.0364935219113182,3799,205,2,0,207,16076,0.01690738535345433,7689,1,203,2,0.07208389907540412,3,3505,0,971,600,1,5076,2534,0.04465136137772993,241357,122226,
9,0.17647058823529413,0,4,5,13,27495,11488,391078,0.006364531501330407,119131,789,0.0364935219113182,3799,205,2,0,207,16076,0.01690738535345433,7689,1,203,2,0.07208389907540412,3,3505,0,971,600,1,5076,2534,0.04465136137772993,241357,122226,
9,0.17647058823529413,0,4,5,13,27495,11488,391078,0.006364531501330407,119131,789,0.0364935219113182,3799,205,2,0,207,16076,0.01690738535345433,7689,1,203,2,0.07208389907540412,3,3505,0,971,600,1,5076,2534,0.04465136137772993,241357,122226,
9,0.17647058823529413,0,4,5,13,27495,11488,391078,0.006364531501330407,119131,789,0.0364935219113182,3799,205,2,0,207,16076,0.01690738535345433,7689,1,203,2,0.07208389907540412,3,3505,0,971,600,1,5076,2534,0.04465136137772993,241357,122226,
9,0.17647058823529413,0,4,5,13,27495,11488,391078,0.006364531501330407,119131,789,0.0364935219113182,3799,205,2,0,207,16076,0.01690738535345433,7689,1,203,2,0.07208389907540412,3,3505,0,971,600,1,5076,2534,0.04465136137772993,241357,122226,
9,0.0,0,4,5,13,27495,11488,391078,0.006364531501330407,119131,789,0.0364935219113182,3799,12,11,11,34,16076,0.01690738535345433,7689,0,1,0,0.0016405863115435894,0,3505,0,971,600,0,5076,2534,0.04465136137772993,241357,122226,
9,0.0,0,4,5,13,27495,11488,391078,0.006364531501330407,119131,789,0.0364935219113182,3799,12,11,11,34,16076,0.01690738535345433,7689,0,1,0,0.0016405863115435894,0,3505,0,971,600,0,5076,2534,0.04465136137772993,241357,122226,
9,0.0,0,4,5,13,27495,11488,391078,0.006364531501330407,119131,789,0.0364935219113182,3799,17,13,12,42,16076,0.01690738535345433,7689,0,4,0,0.06418165338336233,0,3505,0,971,600,0,5076,2534,0.04465136137772993,241357,122226,
9,0.0,0,4,5,13,27495,11488,391078,0.006364531501330407,119131,789,0.0364935219113182,3799,162,155,6,323,16076,0.01690738535345433,7689,0,7,0,0.11677709086970661,0,3505,0,971,600,0,5076,2534,0.04465136137772993,241357,122226,
9,0.0,0,4,5,13,27495,11488,391078,0.006364531501330407,119131,789,0.0364935219113182,3799,162,155,6,323,16076,0.01690738535345433,7689,0,7,0,0.11677709086970661,0,3505,0,971,600,0,5076,2534,0.04465136137772993,241357,122226,
9,0.0,0,4,5,13,27495,11488,391078,0.006364531501330407,119131,789,0.0364935219113182,3799,162,155,6,323,16076,0.01690738535345433,7689,0,7,0,0.11677709086970661,0,3505,0,971,600,0,5076,2534,0.04465136137772993,241357,122226,
9,0.0,0,4,5,13,27495,11488,391078,0.006364531501330407,119131,789,0.0364935219113182,3799,96,49,373,518,16076,0.01690738535345433,7689,0,47,0,0.08623313063692108,0,3505,0,971,600,0,5076,2534,0.04465136137772993,241357,122226,
9,0.0,0,4,5,13,27495,11488,391078,0.006364531501330407,119131,789,0.0364935219113182,3799,52,35,0,87,16076,0.01690738535345433,7689,0,17,0,0.08486939321180331,0,3505,0,971,600,0,5076,2534,0.04465136137772993,241357,122226,
9,0.0,0,4,5,13,27495,11488,391078,0.006364531501330407,119131,789,0.0364935219113182,3799,36,9,1,46,16076,0.01690738535345433,7689,0,27,0,0.014884822935591078,0,3505,0,971,600,0,5076,2534,0.04465136137772993,241357,122226,
9,0.0,0,4,5,13,27495,11488,391078,0.006364531501330407,119131,789,0.0364935219113182,3799,218,35,9,262,16076,0.01690738535345433,7689,0,183,0,0.04302076515633946,0,3505,0,971,600,0,5076,2534,0.04465136137772993,241357,122226,
9,0.0,0,4,5,13,27495,11488,391078,0.006364531501330407,119131,789,0.0364935219113182,3799,218,35,9,262,16076,0.01690738535345433,7689,0,183,0,0.04302076515633946,0,3505,0,971,600,0,5076,2534,0.04465136137772993,241357,122226,
9,0.0,0,4,5,13,27495,11488,391078,0.006364531501330407,119131,789,0.0364935219113182,3799,38,0,0,38,16076,0.01690738535345433,7689,0,38,0,0.12751677852348994,0,3505,0,971,600,0,5076,2534,0.04465136137772993,241357,122226,
9,0.0,0,4,5,13,27495,11488,391078,0.006364531501330407,119131,789,0.0364935219113182,3799,52,35,0,87,16076,0.01690738535345433,7689,0,17,0,0.08486939321180331,0,3505,0,971,600,0,5076,2534,0.04465136137772993,241357,122226,
132,0.0,8,177,-45,317,27495,11488,391078,0.01825651619606162,119131,789,0.0364935219113182,3799,525,276,31,832,16076,0.01690738535345433,7689,0,249,0,0.14688671846718487,0,4448,0,1465,348,0,6261,2983,0.10195363428787214,241357,122226,
132,0.012121212121212121,8,177,-45,317,27495,11488,391078,0.01825651619606162,119131,789,0.0364935219113182,3799,176,19,4,199,16076,0.01690738535345433,7689,1,157,1,0.34967933301266635,2,4448,0,1465,348,0,6261,2983,0.10195363428787214,241357,122226,
132,0.012121212121212121,8,177,-45,317,27495,11488,391078,0.01825651619606162,119131,789,0.0364935219113182,3799,176,19,4,199,16076,0.01690738535345433,7689,1,157,1,0.34967933301266635,2,4448,0,1465,348,0,6261,2983,0.10195363428787214,241357,122226,
132,0.012121212121212121,8,177,-45,317,27495,11488,391078,0.01825651619606162,119131,789,0.0364935219113182,3799,176,19,4,199,16076,0.01690738535345433,7689,1,157,1,0.34967933301266635,2,4448,0,1465,348,0,6261,2983,0.10195363428787214,241357,122226,
132,0.012121212121212121,8,177,-45,317,27495,11488,391078,0.01825651619606162,119131,789,0.0364935219113182,3799,176,19,4,199,16076,0.01690738535345433,7689,1,157,1,0.34967933301266635,2,4448,0,1465,348,0,6261,2983,0.10195363428787214,241357,122226,
132,0.0,8,177,-45,317,27495,11488,391078,0.01825651619606162,119131,789,0.0364935219113182,3799,71,0,0,71,16076,0.01690738535345433,7689,0,71,0,0.2132132132132132,0,4448,0,1465,348,0,6261,2983,0.10195363428787214,241357,122226,
132,0.0,8,177,-45,317,27495,11488,391078,0.01825651619606162,119131,789,0.0364935219113182,3799,71,0,0,71,16076,0.01690738535345433,7689,0,71,0,0.2132132132132132,0,4448,0,1465,348,0,6261,2983,0.10195363428787214,241357,122226,
132,0.0,8,177,-45,317,27495,11488,391078,0.01825651619606162,119131,789,0.0364935219113182,3799,71,0,0,71,16076,0.01690738535345433,7689,0,71,0,0.2132132132132132,0,4448,0,1465,348,0,6261,2983,0.10195363428787214,241357,122226,
132,0.0,8,177,-45,317,27495,11488,391078,0.01825651619606162,119131,789,0.0364935219113182,3799,84,1,4,89,16076,0.01690738535345433,7689,0,83,0,0.1155142069452082,0,4448,0,1465,348,0,6261,2983,0.10195363428787214,241357,122226,
132,0.0,8,177,-45,317,27495,11488,391078,0.01825651619606162,119131,789,0.0364935219113182,3799,84,1,4,89,16076,0.01690738535345433,7689,0,83,0,0.1155142069452082,0,4448,0,1465,348,0,6261,2983,0.10195363428787214,241357,122226,
132,0.0,8,177,-45,317,27495,11488,391078,0.01825651619606162,119131,789,0.0364935219113182,3799,84,1,4,89,16076,0.01690738535345433,7689,0,83,0,0.1155142069452082,0,4448,0,1465,348,0,6261,2983,0.10195363428787214,241357,122226,
132,0.0,8,177,-45,317,27495,11488,391078,0.01825651619606162,119131,789,0.0364935219113182,3799,127,0,0,127,16076,0.01690738535345433,7689,0,127,0,0.26475237091675446,0,4448,0,1465,348,0,6261,2983,0.10195363428787214,241357,122226,
132,0.0,8,177,-45,317,27495,11488,391078,0.01825651619606162,119131,789,0.0364935219113182,3799,127,0,0,127,16076,0.01690738535345433,7689,0,127,0,0.26475237091675446,0,4448,0,1465,348,0,6261,2983,0.10195363428787214,241357,122226,
132,0.0,8,177,-45,317,27495,11488,391078,0.01825651619606162,119131,789,0.0364935219113182,3799,127,0,0,127,16076,0.01690738535345433,7689,0,127,0,0.26475237091675446,0,4448,0,1465,348,0,6261,2983,0.10195363428787214,241357,122226,
132,0.0,8,177,-45,317,27495,11488,391078,0.01825651619606162,119131,789,0.0364935219113182,3799,210,59,13,282,16076,0.01690738535345433,7689,0,151,0,0.08757002727228608,0,4448,0,1465,348,0,6261,2983,0.10195363428787214,241357,122226,
132,0.0,8,177,-45,317,27495,11488,391078,0.01825651619606162,119131,789,0.0364935219113182,3799,210,59,13,282,16076,0.01690738535345433,7689,0,151,0,0.08757002727228608,0,4448,0,1465,348,0,6261,2983,0.10195363428787214,241357,122226,
132,0.0,8,177,-45,317,27495,11488,391078,0.01825651619606162,119131,789,0.0364935219113182,3799,210,59,13,282,16076,0.01690738535345433,7689,0,151,0,0.08757002727228608,0,4448,0,1465,348,0,6261,2983,0.10195363428787214,241357,122226,
132,0.0,8,177,-45,317,27495,11488,391078,0.01825651619606162,119131,789,0.0364935219113182,3799,210,59,13,282,16076,0.01690738535345433,7689,0,151,0,0.08757002727228608,0,4448,0,1465,348,0,6261,2983,0.10195363428787214,241357,122226,
132,0.0,8,177,-45,317,27495,11488,391078,0.01825651619606162,119131,789,0.0364935219113182,3799,54,11,0,65,16076,0.01690738535345433,7689,0,43,0,0.14407313172835493,0,4448,0,1465,348,0,6261,2983,0.10195363428787214,241357,122226,
132,0.4337727311327049,8,177,-45,317,27495,11488,391078,0.01825651619606162,119131,789,0.0364935219113182,3799,1158,467,239,1864,16076,0.01690738535345433,7689,173,691,102,0.16595949404783694,278,4448,3,1465,348,-71,6261,2983,0.10195363428787214,241357,122226,
5,0.03773584905660377,0,2,3,7,27495,11488,391078,0.006140056409598188,119131,789,0.0364935219113182,3799,2,0,0,2,16076,0.01690738535345433,7689,0,2,2,0.03773584905660377,2,2525,0,639,39,2,3203,1886,0.07289799407751682,241357,122226,
5,0.015384615384615385,0,2,3,7,27495,11488,391078,0.006140056409598188,119131,789,0.0364935219113182,3799,1,0,0,1,16076,0.01690738535345433,7689,0,1,1,0.015384615384615385,1,2525,0,639,39,1,3203,1886,0.07289799407751682,241357,122226,
5,0.0,0,2,3,7,27495,11488,391078,0.006140056409598188,119131,789,0.0364935219113182,3799,108,21,0,129,16076,0.01690738535345433,7689,0,87,0,0.11669523180844521,0,2525,0,639,39,0,3203,1886,0.07289799407751682,241357,122226,
5,0.0,0,2,3,7,27495,11488,391078,0.006140056409598188,119131,789,0.0364935219113182,3799,108,21,0,129,16076,0.01690738535345433,7689,0,87,0,0.11669523180844521,0,2525,0,639,39,0,3203,1886,0.07289799407751682,241357,122226,
5,0.0,0,2,3,7,27495,11488,391078,0.006140056409598188,119131,789,0.0364935219113182,3799,108,21,0,129,16076,0.01690738535345433,7689,0,87,0,0.11669523180844521,0,2525,0,639,39,0,3203,1886,0.07289799407751682,241357,122226,
5,0.0,0,2,3,7,27495,11488,391078,0.006140056409598188,119131,789,0.0364935219113182,3799,108,21,0,129,16076,0.01690738535345433,7689,0,87,0,0.11669523180844521,0,2525,0,639,39,0,3203,1886,0.07289799407751682,241357,122226,
5,0.0,0,2,3,7,27495,11488,391078,0.006140056409598188,119131,789,0.0364935219113182,3799,108,21,0,129,16076,0.01690738535345433,7689,0,87,0,0.11669523180844521,0,2525,0,639,39,0,3203,1886,0.07289799407751682,241357,122226,
5,0.0,0,2,3,7,27495,11488,391078,0.006140056409598188,119131,789,0.0364935219113182,3799,108,21,0,129,16076,0.01690738535345433,7689,0,87,0,0.11669523180844521,0,2525,0,639,39,0,3203,1886,0.07289799407751682,241357,122226,
5,0.0,0,2,3,7,27495,11488,391078,0.006140056409598188,119131,789,0.0364935219113182,3799,108,21,0,129,16076,0.01690738535345433,7689,0,87,0,0.11669523180844521,0,2525,0,639,39,0,3203,1886,0.07289799407751682,241357,122226,
5,0.0,0,2,3,7,27495,11488,391078,0.006140056409598188,119131,789,0.0364935219113182,3799,17,0,0,17,16076,0.01690738535345433,7689,0,17,0,0.3090909090909091,0,2525,0,639,39,0,3203,1886,0.07289799407751682,241357,122226,
5,0.0,0,2,3,7,27495,11488,391078,0.006140056409598188,119131,789,0.0364935219113182,3799,989,212,5,1206,16076,0.01690738535345433,7689,0,777,0,0.1268784058647712,0,2525,0,639,39,0,3203,1886,0.07289799407751682,241357,122226,
5,0.0,0,2,3,7,27495,11488,391078,0.006140056409598188,119131,789,0.0364935219113182,3799,989,212,5,1206,16076,0.01690738535345433,7689,0,777,0,0.1268784058647712,0,2525,0,639,39,0,3203,1886,0.07289799407751682,241357,122226,
5,0.0,0,2,3,7,27495,11488,391078,0.006140056409598188,119131,789,0.0364935219113182,3799,989,212,5,1206,16076,0.01690738535345433,7689,0,777,0,0.1268784058647712,0,2525,0,639,39,0,3203,1886,0.07289799407751682,241357,122226,
5,0.0,0,2,3,7,27495,11488,391078,0.006140056409598188,119131,789,0.0364935219113182,3799,989,212,5,1206,16076,0.01690738535345433,7689,0,777,0,0.1268784058647712,0,2525,0,639,39,0,3203,1886,0.07289799407751682,241357,122226,
5,0.0,0,2,3,7,27495,11488,391078,0.006140056409598188,119131,789,0.0364935219113182,3799,989,212,5,1206,16076,0.01690738535345433,7689,0,777,0,0.1268784058647712,0,2525,0,639,39,0,3203,1886,0.07289799407751682,241357,122226,
5,0.0,0,2,3,7,27495,11488,391078,0.006140056409598188,119131,789,0.0364935219113182,3799,989,212,5,1206,16076,0.01690738535345433,7689,0,777,0,0.1268784058647712,0,2525,0,639,39,0,3203,1886,0.07289799407751682,241357,122226,
5,0.0,0,2,3,7,27495,11488,391078,0.006140056409598188,119131,789,0.0364935219113182,3799,989,212,5,1206,16076,0.01690738535345433,7689,0,777,0,0.1268784058647712,0,2525,0,639,39,0,3203,1886,0.07289799407751682,241357,122226,
5,0.0,0,2,3,7,27495,11488,391078,0.006140056409598188,119131,789,0.0364935219113182,3799,989,212,5,1206,16076,0.01690738535345433,7689,0,777,0,0.1268784058647712,0,2525,0,639,39,0,3203,1886,0.07289799407751682,241357,122226,
5,0.0,0,2,3,7,27495,11488,391078,0.006140056409598188,119131,789,0.0364935219113182,3799,989,212,5,1206,16076,0.01690738535345433,7689,0,777,0,0.1268784058647712,0,2525,0,639,39,0,3203,1886,0.07289799407751682,241357,122226,
5,0.0,0,2,3,7,27495,11488,391078,0.006140056409598188,119131,789,0.0364935219113182,3799,989,212,5,1206,16076,0.01690738535345433,7689,0,777,0,0.1268784058647712,0,2525,0,639,39,0,3203,1886,0.07289799407751682,241357,122226,
5,0.0,0,2,3,7,27495,11488,391078,0.006140056409598188,119131,789,0.0364935219113182,3799,989,212,5,1206,16076,0.01690738535345433,7689,0,777,0,0.1268784058647712,0,2525,0,639,39,0,3203,1886,0.07289799407751682,241357,122226,
5,0.0,0,2,3,7,27495,11488,391078,0.006140056409598188,119131,789,0.0364935219113182,3799,989,212,5,1206,16076,0.01690738535345433,7689,0,777,0,0.1268784058647712,0,2525,0,639,39,0,3203,1886,0.07289799407751682,241357,122226,
5,0.0,0,2,3,7,27495,11488,391078,0.006140056409598188,119131,789,0.0364935219113182,3799,989,212,5,1206,16076,0.01690738535345433,7689,0,777,0,0.1268784058647712,0,2525,0,639,39,0,3203,1886,0.07289799407751682,241357,122226,
5,0.0,0,2,3,7,27495,11488,391078,0.006140056409598188,119131,789,0.0364935219113182,3799,989,212,5,1206,16076,0.01690738535345433,7689,0,777,0,0.1268784058647712,0,2525,0,639,39,0,3203,1886,0.07289799407751682,241357,122226,
5,0.0,0,2,3,7,27495,11488,391078,0.006140056409598188,119131,789,0.0364935219113182,3799,989,212,5,1206,16076,0.01690738535345433,7689,0,777,0,0.1268784058647712,0,2525,0,639,39,0,3203,1886,0.07289799407751682,241357,122226,
5,0.0,0,2,3,7,27495,11488,391078,0.006140056409598188,119131,789,0.0364935219113182,3799,989,212,5,1206,16076,0.01690738535345433,7689,0,777,0,0.1268784058647712,0,2525,0,639,39,0,3203,1886,0.07289799407751682,241357,122226,
5,0.0,0,2,3,7,27495,11488,391078,0.006140056409598188,119131,789,0.0364935219113182,3799,989,212,5,1206,16076,0.01690738535345433,7689,0,777,0,0.1268784058647712,0,2525,0,639,39,0,3203,1886,0.07289799407751682,241357,122226,
5,0.0,0,2,3,7,27495,11488,391078,0.006140056409598188,119131,789,0.0364935219113182,3799,989,212,5,1206,16076,0.01690738535345433,7689,0,777,0,0.1268784058647712,0,2525,0,639,39,0,3203,1886,0.07289799407751682,241357,122226,
5,0.0,0,2,3,7,27495,11488,391078,0.006140056409598188,119131,789,0.0364935219113182,3799,989,212,5,1206,16076,0.01690738535345433,7689,0,777,0,0.1268784058647712,0,2525,0,639,39,0,3203,1886,0.07289799407751682,241357,122226,
5,0.0,0,2,3,7,27495,11488,391078,0.006140056409598188,119131,789,0.0364935219113182,3799,989,212,5,1206,16076,0.01690738535345433,7689,0,777,0,0.1268784058647712,0,2525,0,639,39,0,3203,1886,0.07289799407751682,241357,122226,
5,0.0,0,2,3,7,27495,11488,391078,0.006140056409598188,119131,789,0.0364935219113182,3799,989,212,5,1206,16076,0.01690738535345433,7689,0,777,0,0.1268784058647712,0,2525,0,639,39,0,3203,1886,0.07289799407751682,241357,122226,
5,0.0,0,2,3,7,27495,11488,391078,0.006140056409598188,119131,789,0.0364935219113182,3799,989,212,5,1206,16076,0.01690738535345433,7689,0,777,0,0.1268784058647712,0,2525,0,639,39,0,3203,1886,0.07289799407751682,241357,122226,
5,0.0,0,2,3,7,27495,11488,391078,0.006140056409598188,119131,789,0.0364935219113182,3799,989,212,5,1206,16076,0.01690738535345433,7689,0,777,0,0.1268784058647712,0,2525,0,639,39,0,3203,1886,0.07289799407751682,241357,122226,
5,0.0,0,2,3,7,27495,11488,391078,0.006140056409598188,119131,789,0.0364935219113182,3799,989,212,5,1206,16076,0.01690738535345433,7689,0,777,0,0.1268784058647712,0,2525,0,639,39,0,3203,1886,0.07289799407751682,241357,122226,
5,0.0,0,2,3,7,27495,11488,391078,0.006140056409598188,119131,789,0.0364935219113182,3799,989,212,5,1206,16076,0.01690738535345433,7689,0,777,0,0.1268784058647712,0,2525,0,639,39,0,3203,1886,0.07289799407751682,241357,122226,
5,0.0,0,2,3,7,27495,11488,391078,0.006140056409598188,119131,789,0.0364935219113182,3799,989,212,5,1206,16076,0.01690738535345433,7689,0,777,0,0.1268784058647712,0,2525,0,639,39,0,3203,1886,0.07289799407751682,241357,122226,
5,0.0,0,2,3,7,27495,11488,391078,0.006140056409598188,119131,789,0.0364935219113182,3799,989,212,5,1206,16076,0.01690738535345433,7689,0,777,0,0.1268784058647712,0,2525,0,639,39,0,3203,1886,0.07289799407751682,241357,122226,
5,0.0,0,2,3,7,27495,11488,391078,0.006140056409598188,119131,789,0.0364935219113182,3799,989,212,5,1206,16076,0.01690738535345433,7689,0,777,0,0.1268784058647712,0,2525,0,639,39,0,3203,1886,0.07289799407751682,241357,122226,
5,0.0,0,2,3,7,27495,11488,391078,0.006140056409598188,119131,789,0.0364935219113182,3799,989,212,5,1206,16076,0.01690738535345433,7689,0,777,0,0.1268784058647712,0,2525,0,639,39,0,3203,1886,0.07289799407751682,241357,122226,
5,0.0,0,2,3,7,27495,11488,391078,0.006140056409598188,119131,789,0.0364935219113182,3799,989,212,5,1206,16076,0.01690738535345433,7689,0,777,0,0.1268784058647712,0,2525,0,639,39,0,3203,1886,0.07289799407751682,241357,122226,
5,0.0,0,2,3,7,27495,11488,391078,0.006140056409598188,119131,789,0.0364935219113182,3799,989,212,5,1206,16076,0.01690738535345433,7689,0,777,0,0.1268784058647712,0,2525,0,639,39,0,3203,1886,0.07289799407751682,241357,122226,
5,0.0,0,2,3,7,27495,11488,391078,0.006140056409598188,119131,789,0.0364935219113182,3799,989,212,5,1206,16076,0.01690738535345433,7689,0,777,0,0.1268784058647712,0,2525,0,639,39,0,3203,1886,0.07289799407751682,241357,122226,
5,0.0,0,2,3,7,27495,11488,391078,0.006140056409598188,119131,789,0.0364935219113182,3799,989,212,5,1206,16076,0.01690738535345433,7689,0,777,0,0.1268784058647712,0,2525,0,639,39,0,3203,1886,0.07289799407751682,241357,122226,
5,0.0,0,2,3,7,27495,11488,391078,0.006140056409598188,119131,789,0.0364935219113182,3799,16,11,0,27,16076,0.01690738535345433,7689,0,5,0,0.026256175750812096,0,2525,0,639,39,0,3203,1886,0.07289799407751682,241357,122226,
5,0.0,0,2,3,7,27495,11488,391078,0.006140056409598188,119131,789,0.0364935219113182,3799,16,11,0,27,16076,0.01690738535345433,7689,0,5,0,0.026256175750812096,0,2525,0,639,39,0,3203,1886,0.07289799407751682,241357,122226,
5,0.0,0,2,3,7,27495,11488,391078,0.006140056409598188,119131,789,0.0364935219113182,3799,16,11,0,27,16076,0.01690738535345433,7689,0,5,0,0.026256175750812096,0,2525,0,639,39,0,3203,1886,0.07289799407751682,241357,122226,
5,0.0,0,2,3,7,27495,11488,391078,0.006140056409598188,119131,789,0.0364935219113182,3799,89,12,0,101,16076,0.01690738535345433,7689,0,77,0,0.0357417750632304,0,2525,0,639,39,0,3203,1886,0.07289799407751682,241357,122226,
5,0.0,0,2,3,7,27495,11488,391078,0.006140056409598188,119131,789,0.0364935219113182,3799,89,12,0,101,16076,0.01690738535345433,7689,0,77,0,0.0357417750632304,0,2525,0,639,39,0,3203,1886,0.07289799407751682,241357,122226,
5,0.0,0,2,3,7,27495,11488,391078,0.006140056409598188,119131,789,0.0364935219113182,3799,143,34,0,177,16076,0.01690738535345433,7689,0,109,0,0.06125384319347704,0,2525,0,639,39,0,3203,1886,0.07289799407751682,241357,122226,
5,0.0,0,2,3,7,27495,11488,391078,0.006140056409598188,119131,789,0.0364935219113182,3799,143,34,0,177,16076,0.01690738535345433,7689,0,109,0,0.06125384319347704,0,2525,0,639,39,0,3203,1886,0.07289799407751682,241357,122226,
5,0.0,0,2,3,7,27495,11488,391078,0.006140056409598188,119131,789,0.0364935219113182,3799,143,34,0,177,16076,0.01690738535345433,7689,0,109,0,0.06125384319347704,0,2525,0,639,39,0,3203,1886,0.07289799407751682,241357,122226,
5,0.0,0,2,3,7,27495,11488,391078,0.006140056409598188,119131,789,0.0364935219113182,3799,143,34,0,177,16076,0.01690738535345433,7689,0,109,0,0.06125384319347704,0,2525,0,639,39,0,3203,1886,0.07289799407751682,241357,122226,
5,0.0,0,2,3,7,27495,11488,391078,0.006140056409598188,119131,789,0.0364935219113182,3799,143,34,0,177,16076,0.01690738535345433,7689,0,109,0,0.06125384319347704,0,2525,0,639,39,0,3203,1886,0.07289799407751682,241357,122226,
5,0.0,0,2,3,7,27495,11488,391078,0.006140056409598188,119131,789,0.0364935219113182,3799,143,34,0,177,16076,0.01690738535345433,7689,0,109,0,0.06125384319347704,0,2525,0,639,39,0,3203,1886,0.07289799407751682,241357,122226,
5,0.0,0,2,3,7,27495,11488,391078,0.006140056409598188,119131,789,0.0364935219113182,3799,143,34,0,177,16076,0.01690738535345433,7689,0,109,0,0.06125384319347704,0,2525,0,639,39,0,3203,1886,0.07289799407751682,241357,122226,
5,0.0,0,2,3,7,27495,11488,391078,0.006140056409598188,119131,789,0.0364935219113182,3799,143,34,0,177,16076,0.01690738535345433,7689,0,109,0,0.06125384319347704,0,2525,0,639,39,0,3203,1886,0.07289799407751682,241357,122226,
5,0.0,0,2,3,7,27495,11488,391078,0.006140056409598188,119131,789,0.0364935219113182,3799,143,34,0,177,16076,0.01690738535345433,7689,0,109,0,0.06125384319347704,0,2525,0,639,39,0,3203,1886,0.07289799407751682,241357,122226,
5,0.0,0,2,3,7,27495,11488,391078,0.006140056409598188,119131,789,0.0364935219113182,3799,143,34,0,177,16076,0.01690738535345433,7689,0,109,0,0.06125384319347704,0,2525,0,639,39,0,3203,1886,0.07289799407751682,241357,122226,
5,0.0,0,2,3,7,27495,11488,391078,0.006140056409598188,119131,789,0.0364935219113182,3799,143,34,0,177,16076,0.01690738535345433,7689,0,109,0,0.06125384319347704,0,2525,0,639,39,0,3203,1886,0.07289799407751682,241357,122226,
5,0.0,0,2,3,7,27495,11488,391078,0.006140056409598188,119131,789,0.0364935219113182,3799,143,34,0,177,16076,0.01690738535345433,7689,0,109,0,0.06125384319347704,0,2525,0,639,39,0,3203,1886,0.07289799407751682,241357,122226,
5,0.0,0,2,3,7,27495,11488,391078,0.006140056409598188,119131,789,0.0364935219113182,3799,143,34,0,177,16076,0.01690738535345433,7689,0,109,0,0.06125384319347704,0,2525,0,639,39,0,3203,1886,0.07289799407751682,241357,122226,
5,0.0,0,2,3,7,27495,11488,391078,0.006140056409598188,119131,789,0.0364935219113182,3799,143,34,0,177,16076,0.01690738535345433,7689,0,109,0,0.06125384319347704,0,2525,0,639,39,0,3203,1886,0.07289799407751682,241357,122226,
5,0.0,0,2,3,7,27495,11488,391078,0.006140056409598188,119131,789,0.0364935219113182,3799,0,47,0,47,16076,0.01690738535345433,7689,0,-47,0,0.11809045226130653,0,2525,0,639,39,0,3203,1886,0.07289799407751682,241357,122226,
5,0.0,0,2,3,7,27495,11488,391078,0.006140056409598188,119131,789,0.0364935219113182,3799,0,47,0,47,16076,0.01690738535345433,7689,0,-47,0,0.11809045226130653,0,2525,0,639,39,0,3203,1886,0.07289799407751682,241357,122226,
5,0.0,0,2,3,7,27495,11488,391078,0.006140056409598188,119131,789,0.0364935219113182,3799,0,47,0,47,16076,0.01690738535345433,7689,0,-47,0,0.11809045226130653,0,2525,0,639,39,0,3203,1886,0.07289799407751682,241357,122226,
5,0.0,0,2,3,7,27495,11488,391078,0.006140056409598188,119131,789,0.0364935219113182,3799,11,8,0,19,16076,0.01690738535345433,7689,0,3,0,0.006799461623642219,0,2525,0,639,39,0,3203,1886,0.07289799407751682,241357,122226,
5,0.13333333333333333,0,2,3,7,27495,11488,391078,0.006140056409598188,119131,789,0.0364935219113182,3799,527,145,26,698,16076,0.01690738535345433,7689,1,382,1,0.36740440245113143,2,2525,0,639,39,0,3203,1886,0.07289799407751682,241357,122226,
5,0.13333333333333333,0,2,3,7,27495,11488,391078,0.006140056409598188,119131,789,0.0364935219113182,3799,527,145,26,698,16076,0.01690738535345433,7689,1,382,1,0.36740440245113143,2,2525,0,639,39,0,3203,1886,0.07289799407751682,241357,122226,
5,0.13333333333333333,0,2,3,7,27495,11488,391078,0.006140056409598188,119131,789,0.0364935219113182,3799,527,145,26,698,16076,0.01690738535345433,7689,1,382,1,0.36740440245113143,2,2525,0,639,39,0,3203,1886,0.07289799407751682,241357,122226,
5,0.13333333333333333,0,2,3,7,27495,11488,391078,0.006140056409598188,119131,789,0.0364935219113182,3799,527,145,26,698,16076,0.01690738535345433,7689,1,382,1,0.36740440245113143,2,2525,0,639,39,0,3203,1886,0.07289799407751682,241357,122226,
5,0.13333333333333333,0,2,3,7,27495,11488,391078,0.006140056409598188,119131,789,0.0364935219113182,3799,527,145,26,698,16076,0.01690738535345433,7689,1,382,1,0.36740440245113143,2,2525,0,639,39,0,3203,1886,0.07289799407751682,241357,122226,
5,0.13333333333333333,0,2,3,7,27495,11488,391078,0.006140056409598188,119131,789,0.0364935219113182,3799,527,145,26,698,16076,0.01690738535345433,7689,1,382,1,0.36740440245113143,2,2525,0,639,39,0,3203,1886,0.07289799407751682,241357,122226,
5,0.13333333333333333,0,2,3,7,27495,11488,391078,0.006140056409598188,119131,789,0.0364935219113182,3799,527,145,26,698,16076,0.01690738535345433,7689,1,382,1,0.36740440245113143,2,2525,0,639,39,0,3203,1886,0.07289799407751682,241357,122226,
5,0.13333333333333333,0,2,3,7,27495,11488,391078,0.006140056409598188,119131,789,0.0364935219113182,3799,527,145,26,698,16076,0.01690738535345433,7689,1,382,1,0.36740440245113143,2,2525,0,639,39,0,3203,1886,0.07289799407751682,241357,122226,
5,0.13333333333333333,0,2,3,7,27495,11488,391078,0.006140056409598188,119131,789,0.0364935219113182,3799,527,145,26,698,16076,0.01690738535345433,7689,1,382,1,0.36740440245113143,2,2525,0,639,39,0,3203,1886,0.07289799407751682,241357,122226,
5,0.13333333333333333,0,2,3,7,27495,11488,391078,0.006140056409598188,119131,789,0.0364935219113182,3799,527,145,26,698,16076,0.01690738535345433,7689,1,382,1,0.36740440245113143,2,2525,0,639,39,0,3203,1886,0.07289799407751682,241357,122226,
5,0.13333333333333333,0,2,3,7,27495,11488,391078,0.006140056409598188,119131,789,0.0364935219113182,3799,527,145,26,698,16076,0.01690738535345433,7689,1,382,1,0.36740440245113143,2,2525,0,639,39,0,3203,1886,0.07289799407751682,241357,122226,
5,0.13333333333333333,0,2,3,7,27495,11488,391078,0.006140056409598188,119131,789,0.0364935219113182,3799,527,145,26,698,16076,0.01690738535345433,7689,1,382,1,0.36740440245113143,2,2525,0,639,39,0,3203,1886,0.07289799407751682,241357,122226,
5,0.13333333333333333,0,2,3,7,27495,11488,391078,0.006140056409598188,119131,789,0.0364935219113182,3799,527,145,26,698,16076,0.01690738535345433,7689,1,382,1,0.36740440245113143,2,2525,0,639,39,0,3203,1886,0.07289799407751682,241357,122226,
5,0.13333333333333333,0,2,3,7,27495,11488,391078,0.006140056409598188,119131,789,0.0364935219113182,3799,527,145,26,698,16076,0.01690738535345433,7689,1,382,1,0.36740440245113143,2,2525,0,639,39,0,3203,1886,0.07289799407751682,241357,122226,
5,0.13333333333333333,0,2,3,7,27495,11488,391078,0.006140056409598188,119131,789,0.0364935219113182,3799,527,145,26,698,16076,0.01690738535345433,7689,1,382,1,0.36740440245113143,2,2525,0,639,39,0,3203,1886,0.07289799407751682,241357,122226,
5,0.13333333333333333,0,2,3,7,27495,11488,391078,0.006140056409598188,119131,789,0.0364935219113182,3799,527,145,26,698,16076,0.01690738535345433,7689,1,382,1,0.36740440245113143,2,2525,0,639,39,0,3203,1886,0.07289799407751682,241357,122226,
5,0.13333333333333333,0,2,3,7,27495,11488,391078,0.006140056409598188,119131,789,0.0364935219113182,3799,527,145,26,698,16076,0.01690738535345433,7689,1,382,1,0.36740440245113143,2,2525,0,639,39,0,3203,1886,0.07289799407751682,241357,122226,
5,0.13333333333333333,0,2,3,7,27495,11488,391078,0.006140056409598188,119131,789,0.0364935219113182,3799,527,145,26,698,16076,0.01690738535345433,7689,1,382,1,0.36740440245113143,2,2525,0,639,39,0,3203,1886,0.07289799407751682,241357,122226,
5,0.13333333333333333,0,2,3,7,27495,11488,391078,0.006140056409598188,119131,789,0.0364935219113182,3799,527,145,26,698,16076,0.01690738535345433,7689,1,382,1,0.36740440245113143,2,2525,0,639,39,0,3203,1886,0.07289799407751682,241357,122226,
5,0.13333333333333333,0,2,3,7,27495,11488,391078,0.006140056409598188,119131,789,0.0364935219113182,3799,527,145,26,698,16076,0.01690738535345433,7689,1,382,1,0.36740440245113143,2,2525,0,639,39,0,3203,1886,0.07289799407751682,241357,122226,
5,0.13333333333333333,0,2,3,7,27495,11488,391078,0.006140056409598188,119131,789,0.0364935219113182,3799,527,145,26,698,16076,0.01690738535345433,7689,1,382,1,0.36740440245113143,2,2525,0,639,39,0,3203,1886,0.07289799407751682,241357,122226,
5,0.13333333333333333,0,2,3,7,27495,11488,391078,0.006140056409598188,119131,789,0.0364935219113182,3799,527,145,26,698,16076,0.01690738535345433,7689,1,382,1,0.36740440245113143,2,2525,0,639,39,0,3203,1886,0.07289799407751682,241357,122226,
5,0.13333333333333333,0,2,3,7,27495,11488,391078,0.006140056409598188,119131,789,0.0364935219113182,3799,527,145,26,698,16076,0.01690738535345433,7689,1,382,1,0.36740440245113143,2,2525,0,639,39,0,3203,1886,0.07289799407751682,241357,122226,
5,0.13333333333333333,0,2,3,7,27495,11488,391078,0.006140056409598188,119131,789,0.0364935219113182,3799,527,145,26,698,16076,0.01690738535345433,7689,1,382,1,0.36740440245113143,2,2525,0,639,39,0,3203,1886,0.07289799407751682,241357,122226,
5,0.13333333333333333,0,2,3,7,27495,11488,391078,0.006140056409598188,119131,789,0.0364935219113182,3799,527,145,26,698,16076,0.01690738535345433,7689,1,382,1,0.36740440245113143,2,2525,0,639,39,0,3203,1886,0.07289799407751682,241357,122226,
5,0.13333333333333333,0,2,3,7,27495,11488,391078,0.006140056409598188,119131,789,0.0364935219113182,3799,527,145,26,698,16076,0.01690738535345433,7689,1,382,1,0.36740440245113143,2,2525,0,639,39,0,3203,1886,0.07289799407751682,241357,122226,
5,0.13333333333333333,0,2,3,7,27495,11488,391078,0.006140056409598188,119131,789,0.0364935219113182,3799,527,145,26,698,16076,0.01690738535345433,7689,1,382,1,0.36740440245113143,2,2525,0,639,39,0,3203,1886,0.07289799407751682,241357,122226,
5,0.13333333333333333,0,2,3,7,27495,11488,391078,0.006140056409598188,119131,789,0.0364935219113182,3799,527,145,26,698,16076,0.01690738535345433,7689,1,382,1,0.36740440245113143,2,2525,0,639,39,0,3203,1886,0.07289799407751682,241357,122226,
5,0.13333333333333333,0,2,3,7,27495,11488,391078,0.006140056409598188,119131,789,0.0364935219113182,3799,527,145,26,698,16076,0.01690738535345433,7689,1,382,1,0.36740440245113143,2,2525,0,639,39,0,3203,1886,0.07289799407751682,241357,122226,
5,0.13333333333333333,0,2,3,7,27495,11488,391078,0.006140056409598188,119131,789,0.0364935219113182,3799,527,145,26,698,16076,0.01690738535345433,7689,1,382,1,0.36740440245113143,2,2525,0,639,39,0,3203,1886,0.07289799407751682,241357,122226,
5,0.0,0,2,3,7,27495,11488,391078,0.006140056409598188,119131,789,0.0364935219113182,3799,40,0,0,40,16076,0.01690738535345433,7689,0,40,0,0.6779661016949152,0,2525,0,639,39,0,3203,1886,0.07289799407751682,241357,122226,
5,0.0,0,2,3,7,27495,11488,391078,0.006140056409598188,119131,789,0.0364935219113182,3799,84,0,0,84,16076,0.01690738535345433,7689,0,84,0,0.06436781609195402,0,2525,0,639,39,0,3203,1886,0.07289799407751682,241357,122226,
5,0.0,0,2,3,7,27495,11488,391078,0.006140056409598188,119131,789,0.0364935219113182,3799,84,0,0,84,16076,0.01690738535345433,7689,0,84,0,0.06436781609195402,0,2525,0,639,39,0,3203,1886,0.07289799407751682,241357,122226,
5,0.0,0,2,3,7,27495,11488,391078,0.006140056409598188,119131,789,0.0364935219113182,3799,84,0,0,84,16076,0.01690738535345433,7689,0,84,0,0.06436781609195402,0,2525,0,639,39,0,3203,1886,0.07289799407751682,241357,122226,
5,0.0,0,2,3,7,27495,11488,391078,0.006140056409598188,119131,789,0.0364935219113182,3799,84,0,0,84,16076,0.01690738535345433,7689,0,84,0,0.06436781609195402,0,2525,0,639,39,0,3203,1886,0.07289799407751682,241357,122226,
5,0.0,0,2,3,7,27495,11488,391078,0.006140056409598188,119131,789,0.0364935219113182,3799,84,0,0,84,16076,0.01690738535345433,7689,0,84,0,0.06436781609195402,0,2525,0,639,39,0,3203,1886,0.07289799407751682,241357,122226,
5,0.0,0,2,3,7,27495,11488,391078,0.006140056409598188,119131,789,0.0364935219113182,3799,84,0,0,84,16076,0.01690738535345433,7689,0,84,0,0.06436781609195402,0,2525,0,639,39,0,3203,1886,0.07289799407751682,241357,122226,
5,0.0,0,2,3,7,27495,11488,391078,0.006140056409598188,119131,789,0.0364935219113182,3799,84,0,0,84,16076,0.01690738535345433,7689,0,84,0,0.06436781609195402,0,2525,0,639,39,0,3203,1886,0.07289799407751682,241357,122226,
5,0.0,0,2,3,7,27495,11488,391078,0.006140056409598188,119131,789,0.0364935219113182,3799,84,0,0,84,16076,0.01690738535345433,7689,0,84,0,0.06436781609195402,0,2525,0,639,39,0,3203,1886,0.07289799407751682,241357,122226,
5,0.0,0,2,3,7,27495,11488,391078,0.006140056409598188,119131,789,0.0364935219113182,3799,84,0,0,84,16076,0.01690738535345433,7689,0,84,0,0.06436781609195402,0,2525,0,639,39,0,3203,1886,0.07289799407751682,241357,122226,
5,0.0,0,2,3,7,27495,11488,391078,0.006140056409598188,119131,789,0.0364935219113182,3799,84,0,0,84,16076,0.01690738535345433,7689,0,84,0,0.06436781609195402,0,2525,0,639,39,0,3203,1886,0.07289799407751682,241357,122226,
5,0.0,0,2,3,7,27495,11488,391078,0.006140056409598188,119131,789,0.0364935219113182,3799,16,38,0,54,16076,0.01690738535345433,7689,0,-22,0,0.018770229051369776,0,2525,0,639,39,0,3203,1886,0.07289799407751682,241357,122226,
5,0.0,0,2,3,7,27495,11488,391078,0.006140056409598188,119131,789,0.0364935219113182,3799,16,38,0,54,16076,0.01690738535345433,7689,0,-22,0,0.018770229051369776,0,2525,0,639,39,0,3203,1886,0.07289799407751682,241357,122226,
5,0.0,0,2,3,7,27495,11488,391078,0.006140056409598188,119131,789,0.0364935219113182,3799,16,38,0,54,16076,0.01690738535345433,7689,0,-22,0,0.018770229051369776,0,2525,0,639,39,0,3203,1886,0.07289799407751682,241357,122226,
61,0.0,13,12,49,86,27495,11488,391078,0.024876446758004527,119131,789,0.0364935219113182,3799,96,26,12,134,16076,0.01690738535345433,7689,0,70,0,0.5951432511107706,0,3948,0,1638,981,0,6567,2310,0.06922558077967654,241357,122226,
61,0.0,13,12,49,86,27495,11488,391078,0.024876446758004527,119131,789,0.0364935219113182,3799,30,18,0,48,16076,0.01690738535345433,7689,0,12,0,0.04285509225957951,0,3948,0,1638,981,0,6567,2310,0.06922558077967654,241357,122226,
61,0.09438792254676731,13,12,49,86,27495,11488,391078,0.024876446758004527,119131,789,0.0364935219113182,3799,2275,972,764,4011,16076,0.01690738535345433,7689,11,1303,0,0.11380070925564033,20,3948,9,1638,981,-11,6567,2310,0.06922558077967654,241357,122226,
61,0.09438792254676731,13,12,49,86,27495,11488,391078,0.024876446758004527,119131,789,0.0364935219113182,3799,2275,972,764,4011,16076,0.01690738535345433,7689,11,1303,0,0.11380070925564033,20,3948,9,1638,981,-11,6567,2310,0.06922558077967654,241357,122226,
61,0.09438792254676731,13,12,49,86,27495,11488,391078,0.024876446758004527,119131,789,0.0364935219113182,3799,2275,972,764,4011,16076,0.01690738535345433,7689,11,1303,0,0.11380070925564033,20,3948,9,1638,981,-11,6567,2310,0.06922558077967654,241357,122226,
61,0.09438792254676731,13,12,49,86,27495,11488,391078,0.024876446758004527,119131,789,0.0364935219113182,3799,2275,972,764,4011,16076,0.01690738535345433,7689,11,1303,0,0.11380070925564033,20,3948,9,1638,981,-11,6567,2310,0.06922558077967654,241357,122226,
61,0.09438792254676731,13,12,49,86,27495,11488,391078,0.024876446758004527,119131,789,0.0364935219113182,3799,2275,972,764,4011,16076,0.01690738535345433,7689,11,1303,0,0.11380070925564033,20,3948,9,1638,981,-11,6567,2310,0.06922558077967654,241357,122226,
61,0.09438792254676731,13,12,49,86,27495,11488,391078,0.024876446758004527,119131,789,0.0364935219113182,3799,2275,972,764,4011,16076,0.01690738535345433,7689,11,1303,0,0.11380070925564033,20,3948,9,1638,981,-11,6567,2310,0.06922558077967654,241357,122226,
61,0.09438792254676731,13,12,49,86,27495,11488,391078,0.024876446758004527,119131,789,0.0364935219113182,3799,2275,972,764,4011,16076,0.01690738535345433,7689,11,1303,0,0.11380070925564033,20,3948,9,1638,981,-11,6567,2310,0.06922558077967654,241357,122226,
61,0.09438792254676731,13,12,49,86,27495,11488,391078,0.024876446758004527,119131,789,0.0364935219113182,3799,2275,972,764,4011,16076,0.01690738535345433,7689,11,1303,0,0.11380070925564033,20,3948,9,1638,981,-11,6567,2310,0.06922558077967654,241357,122226,
61,0.09438792254676731,13,12,49,86,27495,11488,391078,0.024876446758004527,119131,789,0.0364935219113182,3799,2275,972,764,4011,16076,0.01690738535345433,7689,11,1303,0,0.11380070925564033,20,3948,9,1638,981,-11,6567,2310,0.06922558077967654,241357,122226,
61,0.09438792254676731,13,12,49,86,27495,11488,391078,0.024876446758004527,119131,789,0.0364935219113182,3799,2275,972,764,4011,16076,0.01690738535345433,7689,11,1303,0,0.11380070925564033,20,3948,9,1638,981,-11,6567,2310,0.06922558077967654,241357,122226,
61,0.09438792254676731,13,12,49,86,27495,11488,391078,0.024876446758004527,119131,789,0.0364935219113182,3799,2275,972,764,4011,16076,0.01690738535345433,7689,11,1303,0,0.11380070925564033,20,3948,9,1638,981,-11,6567,2310,0.06922558077967654,241357,122226,
61,0.09438792254676731,13,12,49,86,27495,11488,391078,0.024876446758004527,119131,789,0.0364935219113182,3799,2275,972,764,4011,16076,0.01690738535345433,7689,11,1303,0,0.11380070925564033,20,3948,9,1638,981,-11,6567,2310,0.06922558077967654,241357,122226,
61,0.09438792254676731,13,12,49,86,27495,11488,391078,0.024876446758004527,119131,789,0.0364935219113182,3799,2275,972,764,4011,16076,0.01690738535345433,7689,11,1303,0,0.11380070925564033,20,3948,9,1638,981,-11,6567,2310,0.06922558077967654,241357,122226,
61,0.09438792254676731,13,12,49,86,27495,11488,391078,0.024876446758004527,119131,789,0.0364935219113182,3799,2275,972,764,4011,16076,0.01690738535345433,7689,11,1303,0,0.11380070925564033,20,3948,9,1638,981,-11,6567,2310,0.06922558077967654,241357,122226,
61,0.09438792254676731,13,12,49,86,27495,11488,391078,0.024876446758004527,119131,789,0.0364935219113182,3799,2275,972,764,4011,16076,0.01690738535345433,7689,11,1303,0,0.11380070925564033,20,3948,9,1638,981,-11,6567,2310,0.06922558077967654,241357,122226,
61,0.07407407407407407,13,12,49,86,27495,11488,391078,0.024876446758004527,119131,789,0.0364935219113182,3799,573,287,104,964,16076,0.01690738535345433,7689,1,286,1,0.11917365277268986,2,3948,0,1638,981,0,6567,2310,0.06922558077967654,241357,122226,
61,0.07407407407407407,13,12,49,86,27495,11488,391078,0.024876446758004527,119131,789,0.0364935219113182,3799,573,287,104,964,16076,0.01690738535345433,7689,1,286,1,0.11917365277268986,2,3948,0,1638,981,0,6567,2310,0.06922558077967654,241357,122226,
0,0.0,0,0,0,0,27495,11488,391078,0.0,119131,789,0.0364935219113182,3799,23,0,0,23,16076,0.01690738535345433,7689,0,23,0,0.19827586206896552,0,143,0,30,14,0,187,113,0.048383672951920184,241357,122226,
0,0.0,0,0,0,0,27495,11488,391078,0.0,119131,789,0.0364935219113182,3799,27,13,4,44,16076,0.01690738535345433,7689,0,14,0,0.01845557581315536,0,143,0,30,14,0,187,113,0.048383672951920184,241357,122226,
596,0.10635660314626444,35,527,69,1158,27495,11488,391078,0.11959236640109284,119131,789,0.0364935219113182,3799,516,64,14,594,16076,0.01690738535345433,7689,53,452,99,0.21905963689719268,166,3401,14,699,43,46,4143,2702,0.19113094373443473,241357,122226,
596,0.10635660314626444,35,527,69,1158,27495,11488,391078,0.11959236640109284,119131,789,0.0364935219113182,3799,516,64,14,594,16076,0.01690738535345433,7689,53,452,99,0.21905963689719268,166,3401,14,699,43,46,4143,2702,0.19113094373443473,241357,122226,
596,0.10635660314626444,35,527,69,1158,27495,11488,391078,0.11959236640109284,119131,789,0.0364935219113182,3799,516,64,14,594,16076,0.01690738535345433,7689,53,452,99,0.21905963689719268,166,3401,14,699,43,46,4143,2702,0.19113094373443473,241357,122226,
596,0.006773548199214898,35,527,69,1158,27495,11488,391078,0.11959236640109284,119131,789,0.0364935219113182,3799,244,53,2,299,16076,0.01690738535345433,7689,52,191,8,0.054671507118255615,62,3401,2,699,43,-44,4143,2702,0.19113094373443473,241357,122226,
596,0.006773548199214898,35,527,69,1158,27495,11488,391078,0.11959236640109284,119131,789,0.0364935219113182,3799,244,53,2,299,16076,0.01690738535345433,7689,52,191,8,0.054671507118255615,62,3401,2,699,43,-44,4143,2702,0.19113094373443473,241357,122226,
596,0.006773548199214898,35,527,69,1158,27495,11488,391078,0.11959236640109284,119131,789,0.0364935219113182,3799,244,53,2,299,16076,0.01690738535345433,7689,52,191,8,0.054671507118255615,62,3401,2,699,43,-44,4143,2702,0.19113094373443473,241357,122226,
596,0.05342459441511397,35,527,69,1158,27495,11488,391078,0.11959236640109284,119131,789,0.0364935219113182,3799,1747,368,12,2127,16076,0.01690738535345433,7689,253,1379,230,0.20148160723059208,487,3401,4,699,43,-23,4143,2702,0.19113094373443473,241357,122226,
48,0.0,5,6,42,59,27495,11488,391078,0.02642166338502758,119131,789,0.0364935219113182,3799,21,6,0,27,16076,0.01690738535345433,7689,0,15,0,0.002525255037431303,0,1202,0,113,22,0,1337,1089,0.053508829203120355,241357,122226,
48,0.0,5,6,42,59,27495,11488,391078,0.02642166338502758,119131,789,0.0364935219113182,3799,21,6,0,27,16076,0.01690738535345433,7689,0,15,0,0.002525255037431303,0,1202,0,113,22,0,1337,1089,0.053508829203120355,241357,122226,
48,0.0,5,6,42,59,27495,11488,391078,0.02642166338502758,119131,789,0.0364935219113182,3799,60,1,0,61,16076,0.01690738535345433,7689,0,59,0,0.06624006381549485,0,1202,0,113,22,0,1337,1089,0.053508829203120355,241357,122226,
48,0.15730337078651685,5,6,42,59,27495,11488,391078,0.02642166338502758,119131,789,0.0364935219113182,3799,212,41,11,264,16076,0.01690738535345433,7689,3,171,11,0.16109827331857204,14,1202,0,113,22,8,1337,1089,0.053508829203120355,241357,122226,
48,0.0,5,6,42,59,27495,11488,391078,0.02642166338502758,119131,789,0.0364935219113182,3799,73,1,0,74,16076,0.01690738535345433,7689,0,72,0,0.021878396799605095,0,1202,0,113,22,0,1337,1089,0.053508829203120355,241357,122226,
48,0.07142857142857142,5,6,42,59,27495,11488,391078,0.02642166338502758,119131,789,0.0364935219113182,3799,285,13,0,298,16076,0.01690738535345433,7689,1,272,8,0.07391435862140822,9,1202,0,113,22,7,1337,1089,0.053508829203120355,241357,122226,
48,0.07142857142857142,5,6,42,59,27495,11488,391078,0.02642166338502758,119131,789,0.0364935219113182,3799,285,13,0,298,16076,0.01690738535345433,7689,1,272,8,0.07391435862140822,9,1202,0,113,22,7,1337,1089,0.053508829203120355,241357,122226,
48,0.07142857142857142,5,6,42,59,27495,11488,391078,0.02642166338502758,119131,789,0.0364935219113182,3799,285,13,0,298,16076,0.01690738535345433,7689,1,272,8,0.07391435862140822,9,1202,0,113,22,7,1337,1089,0.053508829203120355,241357,122226,
48,0.0,5,6,42,59,27495,11488,391078,0.02642166338502758,119131,789,0.0364935219113182,3799,95,0,0,95,16076,0.01690738535345433,7689,0,95,0,0.06924198250728864,0,1202,0,113,22,0,1337,1089,0.053508829203120355,241357,122226,
48,0.0,5,6,42,59,27495,11488,391078,0.02642166338502758,119131,789,0.0364935219113182,3799,137,7,0,144,16076,0.01690738535345433,7689,0,130,0,0.014950728367877551,0,1202,0,113,22,0,1337,1089,0.053508829203120355,241357,122226,
48,0.0,5,6,42,59,27495,11488,391078,0.02642166338502758,119131,789,0.0364935219113182,3799,137,7,0,144,16076,0.01690738535345433,7689,0,130,0,0.014950728367877551,0,1202,0,113,22,0,1337,1089,0.053508829203120355,241357,122226,
0,0.0,0,0,0,0,27495,11488,391078,0.0,119131,789,0.0364935219113182,3799,80,2,0,82,16076,0.01690738535345433,7689,0,78,0,0.01973529357378894,0,250,0,8,0,0,258,242,0.009933680249136989,241357,122226,
0,0.0,0,0,0,0,27495,11488,391078,0.0,119131,789,0.0364935219113182,3799,80,2,0,82,16076,0.01690738535345433,7689,0,78,0,0.01973529357378894,0,250,0,8,0,0,258,242,0.009933680249136989,241357,122226,
0,0.0,0,0,0,0,27495,11488,391078,0.0,119131,789,0.0364935219113182,3799,80,2,0,82,16076,0.01690738535345433,7689,0,78,0,0.01973529357378894,0,250,0,8,0,0,258,242,0.009933680249136989,241357,122226,
0,0.0,0,0,0,0,27495,11488,391078,0.0,119131,789,0.0364935219113182,3799,80,2,0,82,16076,0.01690738535345433,7689,0,78,0,0.01973529357378894,0,250,0,8,0,0,258,242,0.009933680249136989,241357,122226,
0,0.0,0,0,0,0,27495,11488,391078,0.0,119131,789,0.0364935219113182,3799,40,24,9,73,16076,0.01690738535345433,7689,0,16,0,0.13546907003003153,0,181,0,56,29,0,266,125,0.06731147067551538,241357,122226,
15,0.26785714285714285,0,0,15,15,27495,11488,391078,0.02435064935064935,119131,789,0.0364935219113182,3799,82,37,3,122,16076,0.01690738535345433,7689,0,45,15,0.14836904471986886,15,82,0,37,3,15,122,45,0.013488094974533533,241357,122226,
15,0.26785714285714285,0,0,15,15,27495,11488,391078,0.02435064935064935,119131,789,0.0364935219113182,3799,82,37,3,122,16076,0.01690738535345433,7689,0,45,15,0.14836904471986886,15,82,0,37,3,15,122,45,0.013488094974533533,241357,122226,
15,0.26785714285714285,0,0,15,15,27495,11488,391078,0.02435064935064935,119131,789,0.0364935219113182,3799,82,37,3,122,16076,0.01690738535345433,7689,0,45,15,0.14836904471986886,15,82,0,37,3,15,122,45,0.013488094974533533,241357,122226,
15,0.26785714285714285,0,0,15,15,27495,11488,391078,0.02435064935064935,119131,789,0.0364935219113182,3799,82,37,3,122,16076,0.01690738535345433,7689,0,45,15,0.14836904471986886,15,82,0,37,3,15,122,45,0.013488094974533533,241357,122226,
15,0.26785714285714285,0,0,15,15,27495,11488,391078,0.02435064935064935,119131,789,0.0364935219113182,3799,82,37,3,122,16076,0.01690738535345433,7689,0,45,15,0.14836904471986886,15,82,0,37,3,15,122,45,0.013488094974533533,241357,122226,
12,0.0,2,0,12,14,27495,11488,391078,9.461402180421733E-4,119131,789,0.0364935219113182,3799,3,14,1,18,16076,0.01690738535345433,7689,0,-11,0,0.012802275960170697,0,975,0,173,12,0,1160,802,0.04588483508805943,241357,122226,
12,0.0,2,0,12,14,27495,11488,391078,9.461402180421733E-4,119131,789,0.0364935219113182,3799,51,1,0,52,16076,0.01690738535345433,7689,0,50,0,0.0058055011001001185,0,975,0,173,12,0,1160,802,0.04588483508805943,241357,122226,
12,0.0,2,0,12,14,27495,11488,391078,9.461402180421733E-4,119131,789,0.0364935219113182,3799,51,1,0,52,16076,0.01690738535345433,7689,0,50,0,0.0058055011001001185,0,975,0,173,12,0,1160,802,0.04588483508805943,241357,122226,
12,0.0,2,0,12,14,27495,11488,391078,9.461402180421733E-4,119131,789,0.0364935219113182,3799,51,1,0,52,16076,0.01690738535345433,7689,0,50,0,0.0058055011001001185,0,975,0,173,12,0,1160,802,0.04588483508805943,241357,122226,
12,0.0,2,0,12,14,27495,11488,391078,9.461402180421733E-4,119131,789,0.0364935219113182,3799,61,0,0,61,16076,0.01690738535345433,7689,0,61,0,0.14055299539170507,0,975,0,173,12,0,1160,802,0.04588483508805943,241357,122226,
12,0.0,2,0,12,14,27495,11488,391078,9.461402180421733E-4,119131,789,0.0364935219113182,3799,143,1,0,144,16076,0.01690738535345433,7689,0,142,0,0.03285821646477384,0,975,0,173,12,0,1160,802,0.04588483508805943,241357,122226,
402,0.019704433497536946,134,384,18,920,27495,11488,391078,0.03290811160867375,119131,789,0.0364935219113182,3799,255,900,6,1161,16076,0.01690738535345433,7689,2,-645,2,0.11101854750212148,4,15900,0,10526,3546,0,29972,5374,0.05741873839722478,241357,122226,
402,0.019704433497536946,134,384,18,920,27495,11488,391078,0.03290811160867375,119131,789,0.0364935219113182,3799,255,900,6,1161,16076,0.01690738535345433,7689,2,-645,2,0.11101854750212148,4,15900,0,10526,3546,0,29972,5374,0.05741873839722478,241357,122226,
402,0.019704433497536946,134,384,18,920,27495,11488,391078,0.03290811160867375,119131,789,0.0364935219113182,3799,255,900,6,1161,16076,0.01690738535345433,7689,2,-645,2,0.11101854750212148,4,15900,0,10526,3546,0,29972,5374,0.05741873839722478,241357,122226,
402,0.019704433497536946,134,384,18,920,27495,11488,391078,0.03290811160867375,119131,789,0.0364935219113182,3799,255,900,6,1161,16076,0.01690738535345433,7689,2,-645,2,0.11101854750212148,4,15900,0,10526,3546,0,29972,5374,0.05741873839722478,241357,122226,
402,0.019704433497536946,134,384,18,920,27495,11488,391078,0.03290811160867375,119131,789,0.0364935219113182,3799,255,900,6,1161,16076,0.01690738535345433,7689,2,-645,2,0.11101854750212148,4,15900,0,10526,3546,0,29972,5374,0.05741873839722478,241357,122226,
402,0.019704433497536946,134,384,18,920,27495,11488,391078,0.03290811160867375,119131,789,0.0364935219113182,3799,255,900,6,1161,16076,0.01690738535345433,7689,2,-645,2,0.11101854750212148,4,15900,0,10526,3546,0,29972,5374,0.05741873839722478,241357,122226,
402,0.019704433497536946,134,384,18,920,27495,11488,391078,0.03290811160867375,119131,789,0.0364935219113182,3799,255,900,6,1161,16076,0.01690738535345433,7689,2,-645,2,0.11101854750212148,4,15900,0,10526,3546,0,29972,5374,0.05741873839722478,241357,122226,
402,0.0,134,384,18,920,27495,11488,391078,0.03290811160867375,119131,789,0.0364935219113182,3799,136,133,0,269,16076,0.01690738535345433,7689,0,3,0,0.014229831348345757,0,15900,0,10526,3546,0,29972,5374,0.05741873839722478,241357,122226,
402,0.15151515151515152,134,384,18,920,27495,11488,391078,0.03290811160867375,119131,789,0.0364935219113182,3799,126,126,14,266,16076,0.01690738535345433,7689,0,0,10,0.07156556155379513,10,15900,0,10526,3546,10,29972,5374,0.05741873839722478,241357,122226,
402,0.15151515151515152,134,384,18,920,27495,11488,391078,0.03290811160867375,119131,789,0.0364935219113182,3799,126,126,14,266,16076,0.01690738535345433,7689,0,0,10,0.07156556155379513,10,15900,0,10526,3546,10,29972,5374,0.05741873839722478,241357,122226,
402,0.09057925321876942,134,384,18,920,27495,11488,391078,0.03290811160867375,119131,789,0.0364935219113182,3799,803,327,24,1154,16076,0.01690738535345433,7689,9,476,8,0.11711954684776583,17,15900,0,10526,3546,-1,29972,5374,0.05741873839722478,241357,122226,
402,0.09057925321876942,134,384,18,920,27495,11488,391078,0.03290811160867375,119131,789,0.0364935219113182,3799,803,327,24,1154,16076,0.01690738535345433,7689,9,476,8,0.11711954684776583,17,15900,0,10526,3546,-1,29972,5374,0.05741873839722478,241357,122226,
402,0.09057925321876942,134,384,18,920,27495,11488,391078,0.03290811160867375,119131,789,0.0364935219113182,3799,803,327,24,1154,16076,0.01690738535345433,7689,9,476,8,0.11711954684776583,17,15900,0,10526,3546,-1,29972,5374,0.05741873839722478,241357,122226,
402,0.09057925321876942,134,384,18,920,27495,11488,391078,0.03290811160867375,119131,789,0.0364935219113182,3799,803,327,24,1154,16076,0.01690738535345433,7689,9,476,8,0.11711954684776583,17,15900,0,10526,3546,-1,29972,5374,0.05741873839722478,241357,122226,
402,0.09057925321876942,134,384,18,920,27495,11488,391078,0.03290811160867375,119131,789,0.0364935219113182,3799,803,327,24,1154,16076,0.01690738535345433,7689,9,476,8,0.11711954684776583,17,15900,0,10526,3546,-1,29972,5374,0.05741873839722478,241357,122226,
402,0.09057925321876942,134,384,18,920,27495,11488,391078,0.03290811160867375,119131,789,0.0364935219113182,3799,803,327,24,1154,16076,0.01690738535345433,7689,9,476,8,0.11711954684776583,17,15900,0,10526,3546,-1,29972,5374,0.05741873839722478,241357,122226,
402,0.09057925321876942,134,384,18,920,27495,11488,391078,0.03290811160867375,119131,789,0.0364935219113182,3799,803,327,24,1154,16076,0.01690738535345433,7689,9,476,8,0.11711954684776583,17,15900,0,10526,3546,-1,29972,5374,0.05741873839722478,241357,122226,
402,0.09779801409682565,134,384,18,920,27495,11488,391078,0.03290811160867375,119131,789,0.0364935219113182,3799,606,192,25,823,16076,0.01690738535345433,7689,10,414,7,0.10068024630789581,17,15900,0,10526,3546,-3,29972,5374,0.05741873839722478,241357,122226,
402,0.0,134,384,18,920,27495,11488,391078,0.03290811160867375,119131,789,0.0364935219113182,3799,19,8,0,27,16076,0.01690738535345433,7689,0,11,0,0.07658804610024122,0,15900,0,10526,3546,0,29972,5374,0.05741873839722478,241357,122226,
402,0.0,134,384,18,920,27495,11488,391078,0.03290811160867375,119131,789,0.0364935219113182,3799,89,139,16,244,16076,0.01690738535345433,7689,0,-50,0,0.16045175654933774,0,15900,0,10526,3546,0,29972,5374,0.05741873839722478,241357,122226,
402,0.0,134,384,18,920,27495,11488,391078,0.03290811160867375,119131,789,0.0364935219113182,3799,89,139,16,244,16076,0.01690738535345433,7689,0,-50,0,0.16045175654933774,0,15900,0,10526,3546,0,29972,5374,0.05741873839722478,241357,122226,
402,0.4337091915655784,134,384,18,920,27495,11488,391078,0.03290811160867375,119131,789,0.0364935219113182,3799,269,302,52,623,16076,0.01690738535345433,7689,6,-33,87,0.16743337214577453,135,15900,42,10526,3546,81,29972,5374,0.05741873839722478,241357,122226,
402,0.4337091915655784,134,384,18,920,27495,11488,391078,0.03290811160867375,119131,789,0.0364935219113182,3799,269,302,52,623,16076,0.01690738535345433,7689,6,-33,87,0.16743337214577453,135,15900,42,10526,3546,81,29972,5374,0.05741873839722478,241357,122226,
402,0.4337091915655784,134,384,18,920,27495,11488,391078,0.03290811160867375,119131,789,0.0364935219113182,3799,269,302,52,623,16076,0.01690738535345433,7689,6,-33,87,0.16743337214577453,135,15900,42,10526,3546,81,29972,5374,0.05741873839722478,241357,122226,
402,0.0,134,384,18,920,27495,11488,391078,0.03290811160867375,119131,789,0.0364935219113182,3799,277,182,0,459,16076,0.01690738535345433,7689,0,95,0,0.10159989661051766,0,15900,0,10526,3546,0,29972,5374,0.05741873839722478,241357,122226,
402,0.0,134,384,18,920,27495,11488,391078,0.03290811160867375,119131,789,0.0364935219113182,3799,10,26,0,36,16076,0.01690738535345433,7689,0,-16,0,0.11763675923633125,0,15900,0,10526,3546,0,29972,5374,0.05741873839722478,241357,122226,
402,0.04481736960460752,134,384,18,920,27495,11488,391078,0.03290811160867375,119131,789,0.0364935219113182,3799,544,444,78,1066,16076,0.01690738535345433,7689,25,100,20,0.06952935180216126,45,15900,0,10526,3546,-5,29972,5374,0.05741873839722478,241357,122226,
402,0.0,134,384,18,920,27495,11488,391078,0.03290811160867375,119131,789,0.0364935219113182,3799,20,22,0,42,16076,0.01690738535345433,7689,0,-2,0,0.0203933346598263,0,15900,0,10526,3546,0,29972,5374,0.05741873839722478,241357,122226,
402,0.186231884057971,134,384,18,920,27495,11488,391078,0.03290811160867375,119131,789,0.0364935219113182,3799,445,70,0,515,16076,0.01690738535345433,7689,69,375,4,0.326288701987753,73,15900,0,10526,3546,-65,29972,5374,0.05741873839722478,241357,122226,
402,0.186231884057971,134,384,18,920,27495,11488,391078,0.03290811160867375,119131,789,0.0364935219113182,3799,445,70,0,515,16076,0.01690738535345433,7689,69,375,4,0.326288701987753,73,15900,0,10526,3546,-65,29972,5374,0.05741873839722478,241357,122226,
402,0.0,134,384,18,920,27495,11488,391078,0.03290811160867375,119131,789,0.0364935219113182,3799,261,21,1,283,16076,0.01690738535345433,7689,0,240,0,0.06168299435334591,0,15900,0,10526,3546,0,29972,5374,0.05741873839722478,241357,122226,
402,0.0,134,384,18,920,27495,11488,391078,0.03290811160867375,119131,789,0.0364935219113182,3799,261,21,1,283,16076,0.01690738535345433,7689,0,240,0,0.06168299435334591,0,15900,0,10526,3546,0,29972,5374,0.05741873839722478,241357,122226,
402,0.0,134,384,18,920,27495,11488,391078,0.03290811160867375,119131,789,0.0364935219113182,3799,167,77,0,244,16076,0.01690738535345433,7689,0,90,0,0.030990192220373892,0,15900,0,10526,3546,0,29972,5374,0.05741873839722478,241357,122226,
402,0.0,134,384,18,920,27495,11488,391078,0.03290811160867375,119131,789,0.0364935219113182,3799,94,37,5,136,16076,0.01690738535345433,7689,0,57,0,0.046877709557858104,0,15900,0,10526,3546,0,29972,5374,0.05741873839722478,241357,122226,
402,0.0,134,384,18,920,27495,11488,391078,0.03290811160867375,119131,789,0.0364935219113182,3799,94,37,5,136,16076,0.01690738535345433,7689,0,57,0,0.046877709557858104,0,15900,0,10526,3546,0,29972,5374,0.05741873839722478,241357,122226,
402,0.1596138271240136,134,384,18,920,27495,11488,391078,0.03290811160867375,119131,789,0.0364935219113182,3799,3224,2705,1420,7349,16076,0.01690738535345433,7689,62,519,37,0.10986853021959206,185,15900,86,10526,3546,-25,29972,5374,0.05741873839722478,241357,122226,
402,0.1596138271240136,134,384,18,920,27495,11488,391078,0.03290811160867375,119131,789,0.0364935219113182,3799,3224,2705,1420,7349,16076,0.01690738535345433,7689,62,519,37,0.10986853021959206,185,15900,86,10526,3546,-25,29972,5374,0.05741873839722478,241357,122226,
402,0.16477462926686684,134,384,18,920,27495,11488,391078,0.03290811160867375,119131,789,0.0364935219113182,3799,5619,3239,1564,10422,16076,0.01690738535345433,7689,165,2380,115,0.12513089842113206,286,15900,6,10526,3546,-50,29972,5374,0.05741873839722478,241357,122226,
402,0.16477462926686684,134,384,18,920,27495,11488,391078,0.03290811160867375,119131,789,0.0364935219113182,3799,5619,3239,1564,10422,16076,0.01690738535345433,7689,165,2380,115,0.12513089842113206,286,15900,6,10526,3546,-50,29972,5374,0.05741873839722478,241357,122226,
402,0.16477462926686684,134,384,18,920,27495,11488,391078,0.03290811160867375,119131,789,0.0364935219113182,3799,5619,3239,1564,10422,16076,0.01690738535345433,7689,165,2380,115,0.12513089842113206,286,15900,6,10526,3546,-50,29972,5374,0.05741873839722478,241357,122226,
402,0.16477462926686684,134,384,18,920,27495,11488,391078,0.03290811160867375,119131,789,0.0364935219113182,3799,5619,3239,1564,10422,16076,0.01690738535345433,7689,165,2380,115,0.12513089842113206,286,15900,6,10526,3546,-50,29972,5374,0.05741873839722478,241357,122226,
402,0.16477462926686684,134,384,18,920,27495,11488,391078,0.03290811160867375,119131,789,0.0364935219113182,3799,5619,3239,1564,10422,16076,0.01690738535345433,7689,165,2380,115,0.12513089842113206,286,15900,6,10526,3546,-50,29972,5374,0.05741873839722478,241357,122226,
402,0.16477462926686684,134,384,18,920,27495,11488,391078,0.03290811160867375,119131,789,0.0364935219113182,3799,5619,3239,1564,10422,16076,0.01690738535345433,7689,165,2380,115,0.12513089842113206,286,15900,6,10526,3546,-50,29972,5374,0.05741873839722478,241357,122226,
402,0.16477462926686684,134,384,18,920,27495,11488,391078,0.03290811160867375,119131,789,0.0364935219113182,3799,5619,3239,1564,10422,16076,0.01690738535345433,7689,165,2380,115,0.12513089842113206,286,15900,6,10526,3546,-50,29972,5374,0.05741873839722478,241357,122226,
402,0.3053435114503817,134,384,18,920,27495,11488,391078,0.03290811160867375,119131,789,0.0364935219113182,3799,210,17,0,227,16076,0.01690738535345433,7689,0,193,40,0.09334525739446486,40,15900,0,10526,3546,40,29972,5374,0.05741873839722478,241357,122226,
0,0.0,0,0,0,0,27495,11488,391078,0.0,119131,789,0.0364935219113182,3799,60,1,0,61,16076,0.01690738535345433,7689,0,59,0,0.01510064521114245,0,780,0,117,8,0,905,663,0.04936484044834953,241357,122226,
0,0.0,0,0,0,0,27495,11488,391078,0.0,119131,789,0.0364935219113182,3799,60,1,0,61,16076,0.01690738535345433,7689,0,59,0,0.01510064521114245,0,780,0,117,8,0,905,663,0.04936484044834953,241357,122226,
0,0.0,0,0,0,0,27495,11488,391078,0.0,119131,789,0.0364935219113182,3799,11,4,6,21,16076,0.01690738535345433,7689,0,7,0,0.07721869155977683,0,780,0,117,8,0,905,663,0.04936484044834953,241357,122226,
0,0.0,0,0,0,0,27495,11488,391078,0.0,119131,789,0.0364935219113182,3799,11,4,6,21,16076,0.01690738535345433,7689,0,7,0,0.07721869155977683,0,780,0,117,8,0,905,663,0.04936484044834953,241357,122226,
96,0.21,3,69,27,168,27495,11488,391078,0.056650668542322195,119131,789,0.0364935219113182,3799,141,122,24,287,16076,0.01690738535345433,7689,40,19,2,0.15062983712493463,42,2482,0,815,125,-38,3422,1667,0.060444261277547304,241357,122226,
96,0.21,3,69,27,168,27495,11488,391078,0.056650668542322195,119131,789,0.0364935219113182,3799,141,122,24,287,16076,0.01690738535345433,7689,40,19,2,0.15062983712493463,42,2482,0,815,125,-38,3422,1667,0.060444261277547304,241357,122226,
96,0.21,3,69,27,168,27495,11488,391078,0.056650668542322195,119131,789,0.0364935219113182,3799,141,122,24,287,16076,0.01690738535345433,7689,40,19,2,0.15062983712493463,42,2482,0,815,125,-38,3422,1667,0.060444261277547304,241357,122226,
96,0.0,3,69,27,168,27495,11488,391078,0.056650668542322195,119131,789,0.0364935219113182,3799,7,3,0,10,16076,0.01690738535345433,7689,0,4,0,0.06622516556291391,0,2482,0,815,125,0,3422,1667,0.060444261277547304,241357,122226,
96,0.0,3,69,27,168,27495,11488,391078,0.056650668542322195,119131,789,0.0364935219113182,3799,154,0,0,154,16076,0.01690738535345433,7689,0,154,0,0.034984407731860595,0,2482,0,815,125,0,3422,1667,0.060444261277547304,241357,122226,
96,0.0,3,69,27,168,27495,11488,391078,0.056650668542322195,119131,789,0.0364935219113182,3799,154,0,0,154,16076,0.01690738535345433,7689,0,154,0,0.034984407731860595,0,2482,0,815,125,0,3422,1667,0.060444261277547304,241357,122226,
96,0.0,3,69,27,168,27495,11488,391078,0.056650668542322195,119131,789,0.0364935219113182,3799,3,3,0,6,16076,0.01690738535345433,7689,0,0,0,0.0044411547002220575,0,2482,0,815,125,0,3422,1667,0.060444261277547304,241357,122226,
96,0.0,3,69,27,168,27495,11488,391078,0.056650668542322195,119131,789,0.0364935219113182,3799,27,0,0,27,16076,0.01690738535345433,7689,0,27,0,0.008961168270826419,0,2482,0,815,125,0,3422,1667,0.060444261277547304,241357,122226,
96,0.25,3,69,27,168,27495,11488,391078,0.056650668542322195,119131,789,0.0364935219113182,3799,183,112,6,301,16076,0.01690738535345433,7689,0,71,3,0.15707835465144696,5,2482,2,815,125,3,3422,1667,0.060444261277547304,241357,122226,
96,0.25,3,69,27,168,27495,11488,391078,0.056650668542322195,119131,789,0.0364935219113182,3799,183,112,6,301,16076,0.01690738535345433,7689,0,71,3,0.15707835465144696,5,2482,2,815,125,3,3422,1667,0.060444261277547304,241357,122226,
96,0.16326530612244897,3,69,27,168,27495,11488,391078,0.056650668542322195,119131,789,0.0364935219113182,3799,53,12,5,70,16076,0.01690738535345433,7689,0,41,8,0.06058383169446886,8,2482,0,815,125,8,3422,1667,0.060444261277547304,241357,122226,
96,0.02631578947368421,3,69,27,168,27495,11488,391078,0.056650668542322195,119131,789,0.0364935219113182,3799,671,137,40,848,16076,0.01690738535345433,7689,1,534,10,0.0998046222208062,11,2482,0,815,125,9,3422,1667,0.060444261277547304,241357,122226,
96,0.02631578947368421,3,69,27,168,27495,11488,391078,0.056650668542322195,119131,789,0.0364935219113182,3799,671,137,40,848,16076,0.01690738535345433,7689,1,534,10,0.0998046222208062,11,2482,0,815,125,9,3422,1667,0.060444261277547304,241357,122226,
96,0.02631578947368421,3,69,27,168,27495,11488,391078,0.056650668542322195,119131,789,0.0364935219113182,3799,671,137,40,848,16076,0.01690738535345433,7689,1,534,10,0.0998046222208062,11,2482,0,815,125,9,3422,1667,0.060444261277547304,241357,122226,
96,0.02631578947368421,3,69,27,168,27495,11488,391078,0.056650668542322195,119131,789,0.0364935219113182,3799,671,137,40,848,16076,0.01690738535345433,7689,1,534,10,0.0998046222208062,11,2482,0,815,125,9,3422,1667,0.060444261277547304,241357,122226,
96,0.0,3,69,27,168,27495,11488,391078,0.056650668542322195,119131,789,0.0364935219113182,3799,37,0,0,37,16076,0.01690738535345433,7689,0,37,0,0.006561447065082462,0,2482,0,815,125,0,3422,1667,0.060444261277547304,241357,122226,
96,0.0,3,69,27,168,27495,11488,391078,0.056650668542322195,119131,789,0.0364935219113182,3799,37,0,0,37,16076,0.01690738535345433,7689,0,37,0,0.006561447065082462,0,2482,0,815,125,0,3422,1667,0.060444261277547304,241357,122226,
96,0.0,3,69,27,168,27495,11488,391078,0.056650668542322195,119131,789,0.0364935219113182,3799,1,1,0,2,16076,0.01690738535345433,7689,0,0,0,6.523157208088715E-4,0,2482,0,815,125,0,3422,1667,0.060444261277547304,241357,122226,
96,0.0,3,69,27,168,27495,11488,391078,0.056650668542322195,119131,789,0.0364935219113182,3799,71,6,3,80,16076,0.01690738535345433,7689,0,65,0,0.03848019555636601,0,2482,0,815,125,0,3422,1667,0.060444261277547304,241357,122226,
96,0.003218884120171674,3,69,27,168,27495,11488,391078,0.056650668542322195,119131,789,0.0364935219113182,3799,488,197,17,702,16076,0.01690738535345433,7689,3,291,3,0.051725309284111315,6,2482,0,815,125,0,3422,1667,0.060444261277547304,241357,122226,
96,0.003218884120171674,3,69,27,168,27495,11488,391078,0.056650668542322195,119131,789,0.0364935219113182,3799,488,197,17,702,16076,0.01690738535345433,7689,3,291,3,0.051725309284111315,6,2482,0,815,125,0,3422,1667,0.060444261277547304,241357,122226,
96,0.003218884120171674,3,69,27,168,27495,11488,391078,0.056650668542322195,119131,789,0.0364935219113182,3799,488,197,17,702,16076,0.01690738535345433,7689,3,291,3,0.051725309284111315,6,2482,0,815,125,0,3422,1667,0.060444261277547304,241357,122226,
96,0.003218884120171674,3,69,27,168,27495,11488,391078,0.056650668542322195,119131,789,0.0364935219113182,3799,488,197,17,702,16076,0.01690738535345433,7689,3,291,3,0.051725309284111315,6,2482,0,815,125,0,3422,1667,0.060444261277547304,241357,122226,
22,0.011764705882352941,0,6,16,28,27495,11488,391078,0.05591937474290416,119131,789,0.0364935219113182,3799,131,7,1,139,16076,0.01690738535345433,7689,1,124,1,0.08027596885301938,2,309,0,21,1,0,331,288,0.06002756755809715,241357,122226,
22,0.19090909090909092,0,6,16,28,27495,11488,391078,0.05591937474290416,119131,789,0.0364935219113182,3799,96,8,0,104,16076,0.01690738535345433,7689,5,88,16,0.15156257329772513,21,309,0,21,1,11,331,288,0.06002756755809715,241357,122226,
22,0.0,0,6,16,28,27495,11488,391078,0.05591937474290416,119131,789,0.0364935219113182,3799,70,0,0,70,16076,0.01690738535345433,7689,0,70,0,0.0341796875,0,309,0,21,1,0,331,288,0.06002756755809715,241357,122226,
0,0.0,0,0,0,0,27495,11488,391078,0.0,119131,789,0.0364935219113182,3799,12,1,3,16,16076,0.01690738535345433,7689,0,11,0,0.3018867924528302,0,319,0,16,3,0,338,303,0.21179000233485148,241357,122226,
0,0.0,0,0,0,0,27495,11488,391078,0.0,119131,789,0.0364935219113182,3799,12,1,3,16,16076,0.01690738535345433,7689,0,11,0,0.3018867924528302,0,319,0,16,3,0,338,303,0.21179000233485148,241357,122226,
0,0.0,0,0,0,0,27495,11488,391078,0.0,119131,789,0.0364935219113182,3799,12,1,3,16,16076,0.01690738535345433,7689,0,11,0,0.3018867924528302,0,319,0,16,3,0,338,303,0.21179000233485148,241357,122226,
0,0.0,0,0,0,0,27495,11488,391078,0.0,119131,789,0.0364935219113182,3799,32,3,0,35,16076,0.01690738535345433,7689,0,29,0,0.4430379746835443,0,319,0,16,3,0,338,303,0.21179000233485148,241357,122226,
0,0.0,0,0,0,0,27495,11488,391078,0.0,119131,789,0.0364935219113182,3799,91,6,2,99,16076,0.01690738535345433,7689,0,85,0,0.06721372990680027,0,284,0,27,6,0,317,257,0.013403654236864494,241357,122226,
0,0.0,0,0,0,0,27495,11488,391078,0.0,119131,789,0.0364935219113182,3799,14,1,0,15,16076,0.01690738535345433,7689,0,13,0,0.02717807692611481,0,284,0,27,6,0,317,257,0.013403654236864494,241357,122226,
0,0.0,0,0,0,0,27495,11488,391078,0.0,119131,789,0.0364935219113182,3799,91,6,2,99,16076,0.01690738535345433,7689,0,85,0,0.06721372990680027,0,284,0,27,6,0,317,257,0.013403654236864494,241357,122226,
0,0.0,0,0,0,0,27495,11488,391078,0.0,119131,789,0.0364935219113182,3799,91,6,2,99,16076,0.01690738535345433,7689,0,85,0,0.06721372990680027,0,284,0,27,6,0,317,257,0.013403654236864494,241357,122226,
0,0.0,0,0,0,0,27495,11488,391078,0.0,119131,789,0.0364935219113182,3799,91,6,2,99,16076,0.01690738535345433,7689,0,85,0,0.06721372990680027,0,284,0,27,6,0,317,257,0.013403654236864494,241357,122226,
0,0.0,0,0,0,0,27495,11488,391078,0.0,119131,789,0.0364935219113182,3799,91,6,2,99,16076,0.01690738535345433,7689,0,85,0,0.06721372990680027,0,284,0,27,6,0,317,257,0.013403654236864494,241357,122226,
0,0.0,0,0,0,0,27495,11488,391078,0.0,119131,789,0.0364935219113182,3799,91,6,2,99,16076,0.01690738535345433,7689,0,85,0,0.06721372990680027,0,284,0,27,6,0,317,257,0.013403654236864494,241357,122226,
0,0.0,0,0,0,0,27495,11488,391078,0.0,119131,789,0.0364935219113182,3799,91,6,2,99,16076,0.01690738535345433,7689,0,85,0,0.06721372990680027,0,284,0,27,6,0,317,257,0.013403654236864494,241357,122226,
0,0.0,0,0,0,0,27495,11488,391078,0.0,119131,789,0.0364935219113182,3799,101,13,0,114,16076,0.01690738535345433,7689,0,88,0,0.014133416186789607,0,284,0,27,6,0,317,257,0.013403654236864494,241357,122226,
239,0.050314465408805034,50,275,-36,564,27495,11488,391078,0.0578085559987781,119131,789,0.0364935219113182,3799,60,18,2,80,16076,0.01690738535345433,7689,2,42,6,0.15886528395408314,8,637,0,359,66,4,1062,278,0.06586750930729728,241357,122226,
287,8.244023083264633E-4,0,3,284,290,27495,11488,391078,0.00663467235885191,119131,789,0.0364935219113182,3799,1,1,0,2,16076,0.01690738535345433,7689,1,0,1,8.244023083264633E-4,2,287,0,3,0,0,290,284,0.00663467235885191,241357,122226,
287,8.244023083264633E-4,0,3,284,290,27495,11488,391078,0.00663467235885191,119131,789,0.0364935219113182,3799,1,1,0,2,16076,0.01690738535345433,7689,1,0,1,8.244023083264633E-4,2,287,0,3,0,0,290,284,0.00663467235885191,241357,122226,
239,0.0,50,275,-36,564,27495,11488,391078,0.0578085559987781,119131,789,0.0364935219113182,3799,218,27,0,245,16076,0.01690738535345433,7689,0,191,0,0.09027647467133942,0,637,0,359,66,0,1062,278,0.06586750930729728,241357,122226,
239,0.2712553353805023,50,275,-36,564,27495,11488,391078,0.0578085559987781,119131,789,0.0364935219113182,3799,179,258,63,500,16076,0.01690738535345433,7689,233,-79,117,0.14238565802832542,399,637,49,359,66,-116,1062,278,0.06586750930729728,241357,122226,
239,0.2712553353805023,50,275,-36,564,27495,11488,391078,0.0578085559987781,119131,789,0.0364935219113182,3799,179,258,63,500,16076,0.01690738535345433,7689,233,-79,117,0.14238565802832542,399,637,49,359,66,-116,1062,278,0.06586750930729728,241357,122226,
239,0.2712553353805023,50,275,-36,564,27495,11488,391078,0.0578085559987781,119131,789,0.0364935219113182,3799,179,258,63,500,16076,0.01690738535345433,7689,233,-79,117,0.14238565802832542,399,637,49,359,66,-116,1062,278,0.06586750930729728,241357,122226,
239,0.2712553353805023,50,275,-36,564,27495,11488,391078,0.0578085559987781,119131,789,0.0364935219113182,3799,179,258,63,500,16076,0.01690738535345433,7689,233,-79,117,0.14238565802832542,399,637,49,359,66,-116,1062,278,0.06586750930729728,241357,122226,
239,0.10570593677979305,50,275,-36,564,27495,11488,391078,0.0578085559987781,119131,789,0.0364935219113182,3799,93,30,1,124,16076,0.01690738535345433,7689,30,63,74,0.09005607890360323,105,637,1,359,66,44,1062,278,0.06586750930729728,241357,122226,
239,0.13541666666666666,50,275,-36,564,27495,11488,391078,0.0578085559987781,119131,789,0.0364935219113182,3799,7,7,0,14,16076,0.01690738535345433,7689,7,0,7,0.13541666666666666,14,637,0,359,66,0,1062,278,0.06586750930729728,241357,122226,
239,0.13541666666666666,50,275,-36,564,27495,11488,391078,0.0578085559987781,119131,789,0.0364935219113182,3799,7,7,0,14,16076,0.01690738535345433,7689,7,0,7,0.13541666666666666,14,637,0,359,66,0,1062,278,0.06586750930729728,241357,122226,
239,0.13541666666666666,50,275,-36,564,27495,11488,391078,0.0578085559987781,119131,789,0.0364935219113182,3799,7,7,0,14,16076,0.01690738535345433,7689,7,0,7,0.13541666666666666,14,637,0,359,66,0,1062,278,0.06586750930729728,241357,122226,
239,0.015393155752013915,50,275,-36,564,27495,11488,391078,0.0578085559987781,119131,789,0.0364935219113182,3799,35,3,0,38,16076,0.01690738535345433,7689,3,32,35,0.015393155752013915,38,637,0,359,66,32,1062,278,0.06586750930729728,241357,122226,
239,0.13541666666666666,50,275,-36,564,27495,11488,391078,0.0578085559987781,119131,789,0.0364935219113182,3799,7,7,0,14,16076,0.01690738535345433,7689,7,0,7,0.13541666666666666,14,637,0,359,66,0,1062,278,0.06586750930729728,241357,122226,
239,0.13541666666666666,50,275,-36,564,27495,11488,391078,0.0578085559987781,119131,789,0.0364935219113182,3799,7,7,0,14,16076,0.01690738535345433,7689,7,0,7,0.13541666666666666,14,637,0,359,66,0,1062,278,0.06586750930729728,241357,122226,
239,0.0,50,275,-36,564,27495,11488,391078,0.0578085559987781,119131,789,0.0364935219113182,3799,45,16,0,61,16076,0.01690738535345433,7689,0,29,0,0.026281775096940973,0,637,0,359,66,0,1062,278,0.06586750930729728,241357,122226,
239,0.13541666666666666,50,275,-36,564,27495,11488,391078,0.0578085559987781,119131,789,0.0364935219113182,3799,7,7,0,14,16076,0.01690738535345433,7689,7,0,7,0.13541666666666666,14,637,0,359,66,0,1062,278,0.06586750930729728,241357,122226,
239,0.13541666666666666,50,275,-36,564,27495,11488,391078,0.0578085559987781,119131,789,0.0364935219113182,3799,7,7,0,14,16076,0.01690738535345433,7689,7,0,7,0.13541666666666666,14,637,0,359,66,0,1062,278,0.06586750930729728,241357,122226,
1255,0.03638368246968027,21,48,1207,1324,27495,11488,391078,0.03708688212778469,119131,789,0.0364935219113182,3799,66,0,0,66,16076,0.01690738535345433,7689,0,66,66,0.03638368246968027,66,1255,0,48,21,66,1324,1207,0.03708688212778469,241357,122226,
1255,0.03638368246968027,21,48,1207,1324,27495,11488,391078,0.03708688212778469,119131,789,0.0364935219113182,3799,66,0,0,66,16076,0.01690738535345433,7689,0,66,66,0.03638368246968027,66,1255,0,48,21,66,1324,1207,0.03708688212778469,241357,122226,
1255,0.03638368246968027,21,48,1207,1324,27495,11488,391078,0.03708688212778469,119131,789,0.0364935219113182,3799,66,0,0,66,16076,0.01690738535345433,7689,0,66,66,0.03638368246968027,66,1255,0,48,21,66,1324,1207,0.03708688212778469,241357,122226,
1255,0.021454735740450027,21,48,1207,1324,27495,11488,391078,0.03708688212778469,119131,789,0.0364935219113182,3799,41,0,0,41,16076,0.01690738535345433,7689,0,41,41,0.021454735740450027,41,1255,0,48,21,41,1324,1207,0.03708688212778469,241357,122226,
1255,0.010278117266336609,21,48,1207,1324,27495,11488,391078,0.03708688212778469,119131,789,0.0364935219113182,3799,31,0,0,31,16076,0.01690738535345433,7689,0,31,31,0.010278117266336609,31,1255,0,48,21,31,1324,1207,0.03708688212778469,241357,122226,
1255,0.030392156862745098,21,48,1207,1324,27495,11488,391078,0.03708688212778469,119131,789,0.0364935219113182,3799,62,0,0,62,16076,0.01690738535345433,7689,0,62,62,0.030392156862745098,62,1255,0,48,21,62,1324,1207,0.03708688212778469,241357,122226,
1255,0.07940161104718067,21,48,1207,1324,27495,11488,391078,0.03708688212778469,119131,789,0.0364935219113182,3799,69,0,0,69,16076,0.01690738535345433,7689,0,69,69,0.07940161104718067,69,1255,0,48,21,69,1324,1207,0.03708688212778469,241357,122226,
1255,0.14969239586635527,21,48,1207,1324,27495,11488,391078,0.03708688212778469,119131,789,0.0364935219113182,3799,493,46,21,560,16076,0.01690738535345433,7689,46,447,493,0.14969239586635527,560,1255,21,48,21,447,1324,1207,0.03708688212778469,241357,122226,
1255,0.14969239586635527,21,48,1207,1324,27495,11488,391078,0.03708688212778469,119131,789,0.0364935219113182,3799,493,46,21,560,16076,0.01690738535345433,7689,46,447,493,0.14969239586635527,560,1255,21,48,21,447,1324,1207,0.03708688212778469,241357,122226,
1255,0.0867579908675799,21,48,1207,1324,27495,11488,391078,0.03708688212778469,119131,789,0.0364935219113182,3799,19,0,0,19,16076,0.01690738535345433,7689,0,19,19,0.0867579908675799,19,1255,0,48,21,19,1324,1207,0.03708688212778469,241357,122226,
1255,0.0867579908675799,21,48,1207,1324,27495,11488,391078,0.03708688212778469,119131,789,0.0364935219113182,3799,19,0,0,19,16076,0.01690738535345433,7689,0,19,19,0.0867579908675799,19,1255,0,48,21,19,1324,1207,0.03708688212778469,241357,122226,
1255,0.018139262726740785,21,48,1207,1324,27495,11488,391078,0.03708688212778469,119131,789,0.0364935219113182,3799,31,0,0,31,16076,0.01690738535345433,7689,0,31,31,0.018139262726740785,31,1255,0,48,21,31,1324,1207,0.03708688212778469,241357,122226,
1255,0.018139262726740785,21,48,1207,1324,27495,11488,391078,0.03708688212778469,119131,789,0.0364935219113182,3799,31,0,0,31,16076,0.01690738535345433,7689,0,31,31,0.018139262726740785,31,1255,0,48,21,31,1324,1207,0.03708688212778469,241357,122226,
106,0.014885874958650347,0,22,84,128,27495,11488,391078,0.0018139014982815037,119131,789,0.0364935219113182,3799,45,0,0,45,16076,0.01690738535345433,7689,0,45,45,0.014885874958650347,45,106,0,22,0,45,128,84,0.0018139014982815037,241357,122226,
287,0.00975609756097561,0,3,284,290,27495,11488,391078,0.00663467235885191,119131,789,0.0364935219113182,3799,1,1,0,2,16076,0.01690738535345433,7689,1,0,1,0.00975609756097561,2,287,0,3,0,0,290,284,0.00663467235885191,241357,122226,
287,0.00975609756097561,0,3,284,290,27495,11488,391078,0.00663467235885191,119131,789,0.0364935219113182,3799,1,1,0,2,16076,0.01690738535345433,7689,1,0,1,0.00975609756097561,2,287,0,3,0,0,290,284,0.00663467235885191,241357,122226,
287,0.00975609756097561,0,3,284,290,27495,11488,391078,0.00663467235885191,119131,789,0.0364935219113182,3799,1,1,0,2,16076,0.01690738535345433,7689,1,0,1,0.00975609756097561,2,287,0,3,0,0,290,284,0.00663467235885191,241357,122226,
287,0.00975609756097561,0,3,284,290,27495,11488,391078,0.00663467235885191,119131,789,0.0364935219113182,3799,1,1,0,2,16076,0.01690738535345433,7689,1,0,1,0.00975609756097561,2,287,0,3,0,0,290,284,0.00663467235885191,241357,122226,
287,0.00975609756097561,0,3,284,290,27495,11488,391078,0.00663467235885191,119131,789,0.0364935219113182,3799,1,1,0,2,16076,0.01690738535345433,7689,1,0,1,0.00975609756097561,2,287,0,3,0,0,290,284,0.00663467235885191,241357,122226,
287,0.00975609756097561,0,3,284,290,27495,11488,391078,0.00663467235885191,119131,789,0.0364935219113182,3799,1,1,0,2,16076,0.01690738535345433,7689,1,0,1,0.00975609756097561,2,287,0,3,0,0,290,284,0.00663467235885191,241357,122226,
287,0.00975609756097561,0,3,284,290,27495,11488,391078,0.00663467235885191,119131,789,0.0364935219113182,3799,1,1,0,2,16076,0.01690738535345433,7689,1,0,1,0.00975609756097561,2,287,0,3,0,0,290,284,0.00663467235885191,241357,122226,
287,0.00975609756097561,0,3,284,290,27495,11488,391078,0.00663467235885191,119131,789,0.0364935219113182,3799,1,1,0,2,16076,0.01690738535345433,7689,1,0,1,0.00975609756097561,2,287,0,3,0,0,290,284,0.00663467235885191,241357,122226,
287,0.00975609756097561,0,3,284,290,27495,11488,391078,0.00663467235885191,119131,789,0.0364935219113182,3799,1,1,0,2,16076,0.01690738535345433,7689,1,0,1,0.00975609756097561,2,287,0,3,0,0,290,284,0.00663467235885191,241357,122226,
361,0.016943479897920763,20,68,293,449,27495,11488,391078,0.009639013486471375,119131,789,0.0364935219113182,3799,118,23,15,156,16076,0.01690738535345433,7689,23,95,118,0.016943479897920763,156,361,15,68,20,95,449,293,0.009639013486471375,241357,122226,
821,0.0010526315789473684,7,171,650,999,27495,11488,391078,0.041134013325333535,119131,789,0.0364935219113182,3799,46,1,0,47,16076,0.01690738535345433,7689,1,45,2,0.003772589952082508,3,2574,0,273,16,1,2863,2301,0.0347912013359212,241357,122226,
821,0.0010526315789473684,7,171,650,999,27495,11488,391078,0.041134013325333535,119131,789,0.0364935219113182,3799,46,1,0,47,16076,0.01690738535345433,7689,1,45,2,0.003772589952082508,3,2574,0,273,16,1,2863,2301,0.0347912013359212,241357,122226,
821,0.0025541365907828985,7,171,650,999,27495,11488,391078,0.041134013325333535,119131,789,0.0364935219113182,3799,133,41,1,175,16076,0.01690738535345433,7689,15,92,7,0.02402294816181034,23,2574,1,273,16,-8,2863,2301,0.0347912013359212,241357,122226,
821,0.0025541365907828985,7,171,650,999,27495,11488,391078,0.041134013325333535,119131,789,0.0364935219113182,3799,133,41,1,175,16076,0.01690738535345433,7689,15,92,7,0.02402294816181034,23,2574,1,273,16,-8,2863,2301,0.0347912013359212,241357,122226,
821,0.014492753623188406,7,171,650,999,27495,11488,391078,0.041134013325333535,119131,789,0.0364935219113182,3799,295,7,0,302,16076,0.01690738535345433,7689,3,288,0,0.01821415867350658,3,2574,0,273,16,-3,2863,2301,0.0347912013359212,241357,122226,
821,0.014492753623188406,7,171,650,999,27495,11488,391078,0.041134013325333535,119131,789,0.0364935219113182,3799,295,7,0,302,16076,0.01690738535345433,7689,3,288,0,0.01821415867350658,3,2574,0,273,16,-3,2863,2301,0.0347912013359212,241357,122226,
821,0.014492753623188406,7,171,650,999,27495,11488,391078,0.041134013325333535,119131,789,0.0364935219113182,3799,295,7,0,302,16076,0.01690738535345433,7689,3,288,0,0.01821415867350658,3,2574,0,273,16,-3,2863,2301,0.0347912013359212,241357,122226,
821,0.014492753623188406,7,171,650,999,27495,11488,391078,0.041134013325333535,119131,789,0.0364935219113182,3799,295,7,0,302,16076,0.01690738535345433,7689,3,288,0,0.01821415867350658,3,2574,0,273,16,-3,2863,2301,0.0347912013359212,241357,122226,
821,0.014492753623188406,7,171,650,999,27495,11488,391078,0.041134013325333535,119131,789,0.0364935219113182,3799,295,7,0,302,16076,0.01690738535345433,7689,3,288,0,0.01821415867350658,3,2574,0,273,16,-3,2863,2301,0.0347912013359212,241357,122226,
821,0.0,7,171,650,999,27495,11488,391078,0.041134013325333535,119131,789,0.0364935219113182,3799,14,0,0,14,16076,0.01690738535345433,7689,0,14,0,0.0012895421271838883,0,2574,0,273,16,0,2863,2301,0.0347912013359212,241357,122226,
821,0.14242424242424243,7,171,650,999,27495,11488,391078,0.041134013325333535,119131,789,0.0364935219113182,3799,26,7,0,33,16076,0.01690738535345433,7689,6,19,6,0.09283521489403843,12,2574,0,273,16,0,2863,2301,0.0347912013359212,241357,122226,
821,0.14242424242424243,7,171,650,999,27495,11488,391078,0.041134013325333535,119131,789,0.0364935219113182,3799,26,7,0,33,16076,0.01690738535345433,7689,6,19,6,0.09283521489403843,12,2574,0,273,16,0,2863,2301,0.0347912013359212,241357,122226,
821,0.14242424242424243,7,171,650,999,27495,11488,391078,0.041134013325333535,119131,789,0.0364935219113182,3799,26,7,0,33,16076,0.01690738535345433,7689,6,19,6,0.09283521489403843,12,2574,0,273,16,0,2863,2301,0.0347912013359212,241357,122226,
821,0.14242424242424243,7,171,650,999,27495,11488,391078,0.041134013325333535,119131,789,0.0364935219113182,3799,26,7,0,33,16076,0.01690738535345433,7689,6,19,6,0.09283521489403843,12,2574,0,273,16,0,2863,2301,0.0347912013359212,241357,122226,
821,0.14242424242424243,7,171,650,999,27495,11488,391078,0.041134013325333535,119131,789,0.0364935219113182,3799,26,7,0,33,16076,0.01690738535345433,7689,6,19,6,0.09283521489403843,12,2574,0,273,16,0,2863,2301,0.0347912013359212,241357,122226,
821,0.14242424242424243,7,171,650,999,27495,11488,391078,0.041134013325333535,119131,789,0.0364935219113182,3799,26,7,0,33,16076,0.01690738535345433,7689,6,19,6,0.09283521489403843,12,2574,0,273,16,0,2863,2301,0.0347912013359212,241357,122226,
821,0.14242424242424243,7,171,650,999,27495,11488,391078,0.041134013325333535,119131,789,0.0364935219113182,3799,26,7,0,33,16076,0.01690738535345433,7689,6,19,6,0.09283521489403843,12,2574,0,273,16,0,2863,2301,0.0347912013359212,241357,122226,
821,0.14242424242424243,7,171,650,999,27495,11488,391078,0.041134013325333535,119131,789,0.0364935219113182,3799,26,7,0,33,16076,0.01690738535345433,7689,6,19,6,0.09283521489403843,12,2574,0,273,16,0,2863,2301,0.0347912013359212,241357,122226,
821,0.14242424242424243,7,171,650,999,27495,11488,391078,0.041134013325333535,119131,789,0.0364935219113182,3799,26,7,0,33,16076,0.01690738535345433,7689,6,19,6,0.09283521489403843,12,2574,0,273,16,0,2863,2301,0.0347912013359212,241357,122226,
821,0.14242424242424243,7,171,650,999,27495,11488,391078,0.041134013325333535,119131,789,0.0364935219113182,3799,26,7,0,33,16076,0.01690738535345433,7689,6,19,6,0.09283521489403843,12,2574,0,273,16,0,2863,2301,0.0347912013359212,241357,122226,
821,0.14242424242424243,7,171,650,999,27495,11488,391078,0.041134013325333535,119131,789,0.0364935219113182,3799,26,7,0,33,16076,0.01690738535345433,7689,6,19,6,0.09283521489403843,12,2574,0,273,16,0,2863,2301,0.0347912013359212,241357,122226,
821,0.14242424242424243,7,171,650,999,27495,11488,391078,0.041134013325333535,119131,789,0.0364935219113182,3799,26,7,0,33,16076,0.01690738535345433,7689,6,19,6,0.09283521489403843,12,2574,0,273,16,0,2863,2301,0.0347912013359212,241357,122226,
821,0.14242424242424243,7,171,650,999,27495,11488,391078,0.041134013325333535,119131,789,0.0364935219113182,3799,26,7,0,33,16076,0.01690738535345433,7689,6,19,6,0.09283521489403843,12,2574,0,273,16,0,2863,2301,0.0347912013359212,241357,122226,
821,0.14242424242424243,7,171,650,999,27495,11488,391078,0.041134013325333535,119131,789,0.0364935219113182,3799,26,7,0,33,16076,0.01690738535345433,7689,6,19,6,0.09283521489403843,12,2574,0,273,16,0,2863,2301,0.0347912013359212,241357,122226,
821,0.14242424242424243,7,171,650,999,27495,11488,391078,0.041134013325333535,119131,789,0.0364935219113182,3799,26,7,0,33,16076,0.01690738535345433,7689,6,19,6,0.09283521489403843,12,2574,0,273,16,0,2863,2301,0.0347912013359212,241357,122226,
821,0.14242424242424243,7,171,650,999,27495,11488,391078,0.041134013325333535,119131,789,0.0364935219113182,3799,26,7,0,33,16076,0.01690738535345433,7689,6,19,6,0.09283521489403843,12,2574,0,273,16,0,2863,2301,0.0347912013359212,241357,122226,
821,0.14242424242424243,7,171,650,999,27495,11488,391078,0.041134013325333535,119131,789,0.0364935219113182,3799,26,7,0,33,16076,0.01690738535345433,7689,6,19,6,0.09283521489403843,12,2574,0,273,16,0,2863,2301,0.0347912013359212,241357,122226,
821,0.14242424242424243,7,171,650,999,27495,11488,391078,0.041134013325333535,119131,789,0.0364935219113182,3799,26,7,0,33,16076,0.01690738535345433,7689,6,19,6,0.09283521489403843,12,2574,0,273,16,0,2863,2301,0.0347912013359212,241357,122226,
821,0.048503470213996536,7,171,650,999,27495,11488,391078,0.041134013325333535,119131,789,0.0364935219113182,3799,48,3,0,51,16076,0.01690738535345433,7689,3,45,48,0.048503470213996536,51,2574,0,273,16,45,2863,2301,0.0347912013359212,241357,122226,
821,0.07692307692307693,7,171,650,999,27495,11488,391078,0.041134013325333535,119131,789,0.0364935219113182,3799,24,1,0,25,16076,0.01690738535345433,7689,0,23,4,0.03004763209834053,4,2574,0,273,16,4,2863,2301,0.0347912013359212,241357,122226,
821,0.048503470213996536,7,171,650,999,27495,11488,391078,0.041134013325333535,119131,789,0.0364935219113182,3799,48,3,0,51,16076,0.01690738535345433,7689,3,45,48,0.048503470213996536,51,2574,0,273,16,45,2863,2301,0.0347912013359212,241357,122226,
821,0.016416502226679175,7,171,650,999,27495,11488,391078,0.041134013325333535,119131,789,0.0364935219113182,3799,116,1,0,117,16076,0.01690738535345433,7689,1,115,116,0.016416502226679175,117,2574,0,273,16,115,2863,2301,0.0347912013359212,241357,122226,
821,0.07692307692307693,7,171,650,999,27495,11488,391078,0.041134013325333535,119131,789,0.0364935219113182,3799,21,1,1,23,16076,0.01690738535345433,7689,0,20,1,0.030126262184684557,2,2574,1,273,16,1,2863,2301,0.0347912013359212,241357,122226,
821,0.07692307692307693,7,171,650,999,27495,11488,391078,0.041134013325333535,119131,789,0.0364935219113182,3799,24,1,0,25,16076,0.01690738535345433,7689,0,23,4,0.03004763209834053,4,2574,0,273,16,4,2863,2301,0.0347912013359212,241357,122226,
821,0.07692307692307693,7,171,650,999,27495,11488,391078,0.041134013325333535,119131,789,0.0364935219113182,3799,24,1,0,25,16076,0.01690738535345433,7689,0,23,4,0.03004763209834053,4,2574,0,273,16,4,2863,2301,0.0347912013359212,241357,122226,
821,0.02683699657640167,7,171,650,999,27495,11488,391078,0.041134013325333535,119131,789,0.0364935219113182,3799,179,29,3,211,16076,0.01690738535345433,7689,23,150,21,0.02210948765893589,47,2574,3,273,16,-2,2863,2301,0.0347912013359212,241357,122226,
821,0.02683699657640167,7,171,650,999,27495,11488,391078,0.041134013325333535,119131,789,0.0364935219113182,3799,179,29,3,211,16076,0.01690738535345433,7689,23,150,21,0.02210948765893589,47,2574,3,273,16,-2,2863,2301,0.0347912013359212,241357,122226,
821,0.02683699657640167,7,171,650,999,27495,11488,391078,0.041134013325333535,119131,789,0.0364935219113182,3799,179,29,3,211,16076,0.01690738535345433,7689,23,150,21,0.02210948765893589,47,2574,3,273,16,-2,2863,2301,0.0347912013359212,241357,122226,
821,0.02683699657640167,7,171,650,999,27495,11488,391078,0.041134013325333535,119131,789,0.0364935219113182,3799,179,29,3,211,16076,0.01690738535345433,7689,23,150,21,0.02210948765893589,47,2574,3,273,16,-2,2863,2301,0.0347912013359212,241357,122226,
821,0.02683699657640167,7,171,650,999,27495,11488,391078,0.041134013325333535,119131,789,0.0364935219113182,3799,179,29,3,211,16076,0.01690738535345433,7689,23,150,21,0.02210948765893589,47,2574,3,273,16,-2,2863,2301,0.0347912013359212,241357,122226,
821,0.02683699657640167,7,171,650,999,27495,11488,391078,0.041134013325333535,119131,789,0.0364935219113182,3799,179,29,3,211,16076,0.01690738535345433,7689,23,150,21,0.02210948765893589,47,2574,3,273,16,-2,2863,2301,0.0347912013359212,241357,122226,
821,0.02683699657640167,7,171,650,999,27495,11488,391078,0.041134013325333535,119131,789,0.0364935219113182,3799,179,29,3,211,16076,0.01690738535345433,7689,23,150,21,0.02210948765893589,47,2574,3,273,16,-2,2863,2301,0.0347912013359212,241357,122226,
821,0.08759149192666942,7,171,650,999,27495,11488,391078,0.041134013325333535,119131,789,0.0364935219113182,3799,90,66,1,157,16076,0.01690738535345433,7689,51,24,81,0.06984126175743674,132,2574,0,273,16,30,2863,2301,0.0347912013359212,241357,122226,
821,0.08759149192666942,7,171,650,999,27495,11488,391078,0.041134013325333535,119131,789,0.0364935219113182,3799,90,66,1,157,16076,0.01690738535345433,7689,51,24,81,0.06984126175743674,132,2574,0,273,16,30,2863,2301,0.0347912013359212,241357,122226,
821,0.08759149192666942,7,171,650,999,27495,11488,391078,0.041134013325333535,119131,789,0.0364935219113182,3799,90,66,1,157,16076,0.01690738535345433,7689,51,24,81,0.06984126175743674,132,2574,0,273,16,30,2863,2301,0.0347912013359212,241357,122226,
821,0.08759149192666942,7,171,650,999,27495,11488,391078,0.041134013325333535,119131,789,0.0364935219113182,3799,90,66,1,157,16076,0.01690738535345433,7689,51,24,81,0.06984126175743674,132,2574,0,273,16,30,2863,2301,0.0347912013359212,241357,122226,
821,0.026532725124396556,7,171,650,999,27495,11488,391078,0.041134013325333535,119131,789,0.0364935219113182,3799,114,8,0,122,16076,0.01690738535345433,7689,8,106,114,0.026532725124396556,122,2574,0,273,16,106,2863,2301,0.0347912013359212,241357,122226,
821,0.026532725124396556,7,171,650,999,27495,11488,391078,0.041134013325333535,119131,789,0.0364935219113182,3799,114,8,0,122,16076,0.01690738535345433,7689,8,106,114,0.026532725124396556,122,2574,0,273,16,106,2863,2301,0.0347912013359212,241357,122226,
821,0.026532725124396556,7,171,650,999,27495,11488,391078,0.041134013325333535,119131,789,0.0364935219113182,3799,114,8,0,122,16076,0.01690738535345433,7689,8,106,114,0.026532725124396556,122,2574,0,273,16,106,2863,2301,0.0347912013359212,241357,122226,
821,0.026532725124396556,7,171,650,999,27495,11488,391078,0.041134013325333535,119131,789,0.0364935219113182,3799,114,8,0,122,16076,0.01690738535345433,7689,8,106,114,0.026532725124396556,122,2574,0,273,16,106,2863,2301,0.0347912013359212,241357,122226,
821,0.027278415573160682,7,171,650,999,27495,11488,391078,0.041134013325333535,119131,789,0.0364935219113182,3799,7,8,0,15,16076,0.01690738535345433,7689,8,-1,7,0.027278415573160682,15,2574,0,273,16,-1,2863,2301,0.0347912013359212,241357,122226,
821,0.027278415573160682,7,171,650,999,27495,11488,391078,0.041134013325333535,119131,789,0.0364935219113182,3799,7,8,0,15,16076,0.01690738535345433,7689,8,-1,7,0.027278415573160682,15,2574,0,273,16,-1,2863,2301,0.0347912013359212,241357,122226,
821,0.014801373774890282,7,171,650,999,27495,11488,391078,0.041134013325333535,119131,789,0.0364935219113182,3799,8,11,0,19,16076,0.01690738535345433,7689,11,-3,8,0.014801373774890282,19,2574,0,273,16,-3,2863,2301,0.0347912013359212,241357,122226,
821,0.014801373774890282,7,171,650,999,27495,11488,391078,0.041134013325333535,119131,789,0.0364935219113182,3799,8,11,0,19,16076,0.01690738535345433,7689,11,-3,8,0.014801373774890282,19,2574,0,273,16,-3,2863,2301,0.0347912013359212,241357,122226,
821,0.01968851013811343,7,171,650,999,27495,11488,391078,0.041134013325333535,119131,789,0.0364935219113182,3799,67,0,0,67,16076,0.01690738535345433,7689,0,67,67,0.01968851013811343,67,2574,0,273,16,67,2863,2301,0.0347912013359212,241357,122226,
821,0.01968851013811343,7,171,650,999,27495,11488,391078,0.041134013325333535,119131,789,0.0364935219113182,3799,67,0,0,67,16076,0.01690738535345433,7689,0,67,67,0.01968851013811343,67,2574,0,273,16,67,2863,2301,0.0347912013359212,241357,122226,
821,0.02164009111617312,7,171,650,999,27495,11488,391078,0.041134013325333535,119131,789,0.0364935219113182,3799,76,0,0,76,16076,0.01690738535345433,7689,0,76,76,0.02164009111617312,76,2574,0,273,16,76,2863,2301,0.0347912013359212,241357,122226,
821,0.02164009111617312,7,171,650,999,27495,11488,391078,0.041134013325333535,119131,789,0.0364935219113182,3799,76,0,0,76,16076,0.01690738535345433,7689,0,76,76,0.02164009111617312,76,2574,0,273,16,76,2863,2301,0.0347912013359212,241357,122226,
821,0.0,7,171,650,999,27495,11488,391078,0.041134013325333535,119131,789,0.0364935219113182,3799,74,1,0,75,16076,0.01690738535345433,7689,0,73,0,0.04642857142857143,0,2574,0,273,16,0,2863,2301,0.0347912013359212,241357,122226,
821,0.0,7,171,650,999,27495,11488,391078,0.041134013325333535,119131,789,0.0364935219113182,3799,74,1,0,75,16076,0.01690738535345433,7689,0,73,0,0.04642857142857143,0,2574,0,273,16,0,2863,2301,0.0347912013359212,241357,122226,
821,0.0,7,171,650,999,27495,11488,391078,0.041134013325333535,119131,789,0.0364935219113182,3799,74,1,0,75,16076,0.01690738535345433,7689,0,73,0,0.04642857142857143,0,2574,0,273,16,0,2863,2301,0.0347912013359212,241357,122226,
821,0.0,7,171,650,999,27495,11488,391078,0.041134013325333535,119131,789,0.0364935219113182,3799,74,1,0,75,16076,0.01690738535345433,7689,0,73,0,0.04642857142857143,0,2574,0,273,16,0,2863,2301,0.0347912013359212,241357,122226,
821,0.0,7,171,650,999,27495,11488,391078,0.041134013325333535,119131,789,0.0364935219113182,3799,74,1,0,75,16076,0.01690738535345433,7689,0,73,0,0.04642857142857143,0,2574,0,273,16,0,2863,2301,0.0347912013359212,241357,122226,
821,0.0,7,171,650,999,27495,11488,391078,0.041134013325333535,119131,789,0.0364935219113182,3799,175,2,0,177,16076,0.01690738535345433,7689,0,173,0,0.006862022405048106,0,2574,0,273,16,0,2863,2301,0.0347912013359212,241357,122226,
821,0.0,7,171,650,999,27495,11488,391078,0.041134013325333535,119131,789,0.0364935219113182,3799,175,2,0,177,16076,0.01690738535345433,7689,0,173,0,0.006862022405048106,0,2574,0,273,16,0,2863,2301,0.0347912013359212,241357,122226,
821,0.0,7,171,650,999,27495,11488,391078,0.041134013325333535,119131,789,0.0364935219113182,3799,175,2,0,177,16076,0.01690738535345433,7689,0,173,0,0.006862022405048106,0,2574,0,273,16,0,2863,2301,0.0347912013359212,241357,122226,
821,0.0,7,171,650,999,27495,11488,391078,0.041134013325333535,119131,789,0.0364935219113182,3799,175,2,0,177,16076,0.01690738535345433,7689,0,173,0,0.006862022405048106,0,2574,0,273,16,0,2863,2301,0.0347912013359212,241357,122226,
821,0.0,7,171,650,999,27495,11488,391078,0.041134013325333535,119131,789,0.0364935219113182,3799,175,2,0,177,16076,0.01690738535345433,7689,0,173,0,0.006862022405048106,0,2574,0,273,16,0,2863,2301,0.0347912013359212,241357,122226,
821,0.0,7,171,650,999,27495,11488,391078,0.041134013325333535,119131,789,0.0364935219113182,3799,175,2,0,177,16076,0.01690738535345433,7689,0,173,0,0.006862022405048106,0,2574,0,273,16,0,2863,2301,0.0347912013359212,241357,122226,
821,5.539143279172822E-4,7,171,650,999,27495,11488,391078,0.041134013325333535,119131,789,0.0364935219113182,3799,131,22,0,153,16076,0.01690738535345433,7689,2,109,4,0.005636016167453736,6,2574,0,273,16,2,2863,2301,0.0347912013359212,241357,122226,
821,5.539143279172822E-4,7,171,650,999,27495,11488,391078,0.041134013325333535,119131,789,0.0364935219113182,3799,131,22,0,153,16076,0.01690738535345433,7689,2,109,4,0.005636016167453736,6,2574,0,273,16,2,2863,2301,0.0347912013359212,241357,122226,
821,5.539143279172822E-4,7,171,650,999,27495,11488,391078,0.041134013325333535,119131,789,0.0364935219113182,3799,131,22,0,153,16076,0.01690738535345433,7689,2,109,4,0.005636016167453736,6,2574,0,273,16,2,2863,2301,0.0347912013359212,241357,122226,
821,0.29333333333333333,7,171,650,999,27495,11488,391078,0.041134013325333535,119131,789,0.0364935219113182,3799,40,1,0,41,16076,0.01690738535345433,7689,1,39,21,0.15169312169312169,22,2574,0,273,16,20,2863,2301,0.0347912013359212,241357,122226,
821,0.29333333333333333,7,171,650,999,27495,11488,391078,0.041134013325333535,119131,789,0.0364935219113182,3799,40,1,0,41,16076,0.01690738535345433,7689,1,39,21,0.15169312169312169,22,2574,0,273,16,20,2863,2301,0.0347912013359212,241357,122226,
821,0.29333333333333333,7,171,650,999,27495,11488,391078,0.041134013325333535,119131,789,0.0364935219113182,3799,40,1,0,41,16076,0.01690738535345433,7689,1,39,21,0.15169312169312169,22,2574,0,273,16,20,2863,2301,0.0347912013359212,241357,122226,
821,0.03607578510251752,7,171,650,999,27495,11488,391078,0.041134013325333535,119131,789,0.0364935219113182,3799,139,0,0,139,16076,0.01690738535345433,7689,0,139,139,0.03607578510251752,139,2574,0,273,16,139,2863,2301,0.0347912013359212,241357,122226,
821,0.03607578510251752,7,171,650,999,27495,11488,391078,0.041134013325333535,119131,789,0.0364935219113182,3799,139,0,0,139,16076,0.01690738535345433,7689,0,139,139,0.03607578510251752,139,2574,0,273,16,139,2863,2301,0.0347912013359212,241357,122226,
821,0.03607578510251752,7,171,650,999,27495,11488,391078,0.041134013325333535,119131,789,0.0364935219113182,3799,139,0,0,139,16076,0.01690738535345433,7689,0,139,139,0.03607578510251752,139,2574,0,273,16,139,2863,2301,0.0347912013359212,241357,122226,
821,0.007263922518159807,7,171,650,999,27495,11488,391078,0.041134013325333535,119131,789,0.0364935219113182,3799,53,0,0,53,16076,0.01690738535345433,7689,0,53,3,0.006185326594592108,3,2574,0,273,16,3,2863,2301,0.0347912013359212,241357,122226,
821,0.007263922518159807,7,171,650,999,27495,11488,391078,0.041134013325333535,119131,789,0.0364935219113182,3799,53,0,0,53,16076,0.01690738535345433,7689,0,53,3,0.006185326594592108,3,2574,0,273,16,3,2863,2301,0.0347912013359212,241357,122226,
821,0.13793103448275862,7,171,650,999,27495,11488,391078,0.041134013325333535,119131,789,0.0364935219113182,3799,32,11,0,43,16076,0.01690738535345433,7689,11,21,13,0.07383731211317418,24,2574,0,273,16,2,2863,2301,0.0347912013359212,241357,122226,
821,0.13793103448275862,7,171,650,999,27495,11488,391078,0.041134013325333535,119131,789,0.0364935219113182,3799,32,11,0,43,16076,0.01690738535345433,7689,11,21,13,0.07383731211317418,24,2574,0,273,16,2,2863,2301,0.0347912013359212,241357,122226,
821,0.014386642636609399,7,171,650,999,27495,11488,391078,0.041134013325333535,119131,789,0.0364935219113182,3799,198,32,3,233,16076,0.01690738535345433,7689,17,166,3,0.024905783799562715,21,2574,1,273,16,-14,2863,2301,0.0347912013359212,241357,122226,
821,0.014386642636609399,7,171,650,999,27495,11488,391078,0.041134013325333535,119131,789,0.0364935219113182,3799,198,32,3,233,16076,0.01690738535345433,7689,17,166,3,0.024905783799562715,21,2574,1,273,16,-14,2863,2301,0.0347912013359212,241357,122226,
821,0.014386642636609399,7,171,650,999,27495,11488,391078,0.041134013325333535,119131,789,0.0364935219113182,3799,198,32,3,233,16076,0.01690738535345433,7689,17,166,3,0.024905783799562715,21,2574,1,273,16,-14,2863,2301,0.0347912013359212,241357,122226,
821,1.8145527127563056E-4,7,171,650,999,27495,11488,391078,0.041134013325333535,119131,789,0.0364935219113182,3799,114,1,0,115,16076,0.01690738535345433,7689,1,113,1,0.00625879394168212,2,2574,0,273,16,0,2863,2301,0.0347912013359212,241357,122226,
821,1.8145527127563056E-4,7,171,650,999,27495,11488,391078,0.041134013325333535,119131,789,0.0364935219113182,3799,114,1,0,115,16076,0.01690738535345433,7689,1,113,1,0.00625879394168212,2,2574,0,273,16,0,2863,2301,0.0347912013359212,241357,122226,
821,1.8145527127563056E-4,7,171,650,999,27495,11488,391078,0.041134013325333535,119131,789,0.0364935219113182,3799,114,1,0,115,16076,0.01690738535345433,7689,1,113,1,0.00625879394168212,2,2574,0,273,16,0,2863,2301,0.0347912013359212,241357,122226,
821,1.8145527127563056E-4,7,171,650,999,27495,11488,391078,0.041134013325333535,119131,789,0.0364935219113182,3799,114,1,0,115,16076,0.01690738535345433,7689,1,113,1,0.00625879394168212,2,2574,0,273,16,0,2863,2301,0.0347912013359212,241357,122226,
821,0.009547580500089943,7,171,650,999,27495,11488,391078,0.041134013325333535,119131,789,0.0364935219113182,3799,59,7,6,72,16076,0.01690738535345433,7689,5,52,23,0.008099913318226326,29,2574,1,273,16,18,2863,2301,0.0347912013359212,241357,122226,
821,0.009547580500089943,7,171,650,999,27495,11488,391078,0.041134013325333535,119131,789,0.0364935219113182,3799,59,7,6,72,16076,0.01690738535345433,7689,5,52,23,0.008099913318226326,29,2574,1,273,16,18,2863,2301,0.0347912013359212,241357,122226,
821,0.009547580500089943,7,171,650,999,27495,11488,391078,0.041134013325333535,119131,789,0.0364935219113182,3799,59,7,6,72,16076,0.01690738535345433,7689,5,52,23,0.008099913318226326,29,2574,1,273,16,18,2863,2301,0.0347912013359212,241357,122226,
821,0.009547580500089943,7,171,650,999,27495,11488,391078,0.041134013325333535,119131,789,0.0364935219113182,3799,59,7,6,72,16076,0.01690738535345433,7689,5,52,23,0.008099913318226326,29,2574,1,273,16,18,2863,2301,0.0347912013359212,241357,122226,
257,0.0079464405304045,1,12,245,270,27495,11488,391078,0.021902302791336488,119131,789,0.0364935219113182,3799,198,2,1,201,16076,0.01690738535345433,7689,1,196,3,0.01744547465997228,5,615,1,17,1,2,633,598,0.024525587949856632,241357,122226,
821,0.009547580500089943,7,171,650,999,27495,11488,391078,0.041134013325333535,119131,789,0.0364935219113182,3799,59,7,6,72,16076,0.01690738535345433,7689,5,52,23,0.008099913318226326,29,2574,1,273,16,18,2863,2301,0.0347912013359212,241357,122226,
257,0.05074345055463771,1,12,245,270,27495,11488,391078,0.021902302791336488,119131,789,0.0364935219113182,3799,215,0,0,215,16076,0.01690738535345433,7689,0,215,215,0.05074345055463771,215,615,0,17,1,215,633,598,0.024525587949856632,241357,122226,
257,0.07428571428571429,1,12,245,270,27495,11488,391078,0.021902302791336488,119131,789,0.0364935219113182,3799,16,7,0,23,16076,0.01690738535345433,7689,3,9,10,0.0804616724738676,13,615,0,17,1,7,633,598,0.024525587949856632,241357,122226,
257,0.102803738317757,1,12,245,270,27495,11488,391078,0.021902302791336488,119131,789,0.0364935219113182,3799,8,3,0,11,16076,0.01690738535345433,7689,3,5,8,0.102803738317757,11,615,0,17,1,5,633,598,0.024525587949856632,241357,122226,
257,0.0680594243268338,1,12,245,270,27495,11488,391078,0.021902302791336488,119131,789,0.0364935219113182,3799,56,1,0,57,16076,0.01690738535345433,7689,1,55,13,0.04659104535587396,14,615,0,17,1,12,633,598,0.024525587949856632,241357,122226,
257,0.0680594243268338,1,12,245,270,27495,11488,391078,0.021902302791336488,119131,789,0.0364935219113182,3799,56,1,0,57,16076,0.01690738535345433,7689,1,55,13,0.04659104535587396,14,615,0,17,1,12,633,598,0.024525587949856632,241357,122226,
0,0.0,0,0,0,0,27495,11488,391078,0.0,119131,789,0.0364935219113182,3799,0,0,0,0,16076,0.01690738535345433,7689,0,0,0,0.0,0,0,0,0,0,0,0,0,0.0,241357,122226,
0,0.0,0,0,0,0,27495,11488,391078,0.0,119131,789,0.0364935219113182,3799,0,0,0,0,16076,0.01690738535345433,7689,0,0,0,0.0,0,0,0,0,0,0,0,0,0.0,241357,122226,
0,0.0,0,0,0,0,27495,11488,391078,0.0,119131,789,0.0364935219113182,3799,0,0,0,0,16076,0.01690738535345433,7689,0,0,0,0.0,0,0,0,0,0,0,0,0,0.0,241357,122226,
0,0.0,0,0,0,0,27495,11488,391078,0.0,119131,789,0.0364935219113182,3799,0,0,0,0,16076,0.01690738535345433,7689,0,0,0,0.0,0,0,0,0,0,0,0,0,0.0,241357,122226,
0,0.0,0,0,0,0,27495,11488,391078,0.0,119131,789,0.0364935219113182,3799,0,0,0,0,16076,0.01690738535345433,7689,0,0,0,0.0,0,0,0,0,0,0,0,0,0.0,241357,122226,
0,0.0,0,0,0,0,27495,11488,391078,0.0,119131,789,0.0364935219113182,3799,0,0,0,0,16076,0.01690738535345433,7689,0,0,0,0.0,0,0,0,0,0,0,0,0,0.0,241357,122226,
0,0.0,0,0,0,0,27495,11488,391078,0.0,119131,789,0.0364935219113182,3799,0,0,0,0,16076,0.01690738535345433,7689,0,0,0,0.0,0,0,0,0,0,0,0,0,0.0,241357,122226,
0,0.0,0,0,0,0,27495,11488,391078,0.0,119131,789,0.0364935219113182,3799,0,0,0,0,16076,0.01690738535345433,7689,0,0,0,0.0,0,0,0,0,0,0,0,0,0.0,241357,122226,
0,0.0,0,0,0,0,27495,11488,391078,0.0,119131,789,0.0364935219113182,3799,0,0,0,0,16076,0.01690738535345433,7689,0,0,0,0.0,0,0,0,0,0,0,0,0,0.0,241357,122226,
0,0.0,0,0,0,0,27495,11488,391078,0.0,119131,789,0.0364935219113182,3799,0,0,0,0,16076,0.01690738535345433,7689,0,0,0,0.0,0,0,0,0,0,0,0,0,0.0,241357,122226,
0,0.0,0,0,0,0,27495,11488,391078,0.0,119131,789,0.0364935219113182,3799,0,0,0,0,16076,0.01690738535345433,7689,0,0,0,0.0,0,0,0,0,0,0,0,0,0.0,241357,122226,
0,0.0,0,0,0,0,27495,11488,391078,0.0,119131,789,0.0364935219113182,3799,0,0,0,0,16076,0.01690738535345433,7689,0,0,0,0.0,0,0,0,0,0,0,0,0,0.0,241357,122226,
0,0.0,0,0,0,0,27495,11488,391078,0.0,119131,789,0.0364935219113182,3799,0,0,0,0,16076,0.01690738535345433,7689,0,0,0,0.0,0,0,0,0,0,0,0,0,0.0,241357,122226,
0,0.0,0,0,0,0,27495,11488,391078,0.0,119131,789,0.0364935219113182,3799,0,0,0,0,16076,0.01690738535345433,7689,0,0,0,0.0,0,0,0,0,0,0,0,0,0.0,241357,122226,
0,0.0,0,0,0,0,27495,11488,391078,0.0,119131,789,0.0364935219113182,3799,0,0,0,0,16076,0.01690738535345433,7689,0,0,0,0.0,0,0,0,0,0,0,0,0,0.0,241357,122226,
0,0.0,0,0,0,0,27495,11488,391078,0.0,119131,789,0.0364935219113182,3799,0,0,0,0,16076,0.01690738535345433,7689,0,0,0,0.0,0,0,0,0,0,0,0,0,0.0,241357,122226,
0,0.0,0,0,0,0,27495,11488,391078,0.0,119131,789,0.0364935219113182,3799,0,0,0,0,16076,0.01690738535345433,7689,0,0,0,0.0,0,0,0,0,0,0,0,0,0.0,241357,122226,
0,0.0,0,0,0,0,27495,11488,391078,0.0,119131,789,0.0364935219113182,3799,0,0,0,0,16076,0.01690738535345433,7689,0,0,0,0.0,0,0,0,0,0,0,0,0,0.0,241357,122226,
0,0.0,0,0,0,0,27495,11488,391078,0.0,119131,789,0.0364935219113182,3799,0,0,0,0,16076,0.01690738535345433,7689,0,0,0,0.0,0,0,0,0,0,0,0,0,0.0,241357,122226,
0,0.0,0,0,0,0,27495,11488,391078,0.0,119131,789,0.0364935219113182,3799,0,0,0,0,16076,0.01690738535345433,7689,0,0,0,0.0,0,0,0,0,0,0,0,0,0.0,241357,122226,
0,0.0,0,0,0,0,27495,11488,391078,0.0,119131,789,0.0364935219113182,3799,0,0,0,0,16076,0.01690738535345433,7689,0,0,0,0.0,0,0,0,0,0,0,0,0,0.0,241357,122226,
0,0.0,0,0,0,0,27495,11488,391078,0.0,119131,789,0.0364935219113182,3799,0,0,0,0,16076,0.01690738535345433,7689,0,0,0,0.0,0,0,0,0,0,0,0,0,0.0,241357,122226,
0,0.0,0,0,0,0,27495,11488,391078,0.0,119131,789,0.0364935219113182,3799,0,0,0,0,16076,0.01690738535345433,7689,0,0,0,0.0,0,0,0,0,0,0,0,0,0.0,241357,122226,
0,0.0,0,0,0,0,27495,11488,391078,0.0,119131,789,0.0364935219113182,3799,0,0,0,0,16076,0.01690738535345433,7689,0,0,0,0.0,0,0,0,0,0,0,0,0,0.0,241357,122226,
0,0.0,0,0,0,0,27495,11488,391078,0.0,119131,789,0.0364935219113182,3799,0,0,0,0,16076,0.01690738535345433,7689,0,0,0,0.0,0,0,0,0,0,0,0,0,0.0,241357,122226,
0,0.0,0,0,0,0,27495,11488,391078,0.0,119131,789,0.0364935219113182,3799,0,0,0,0,16076,0.01690738535345433,7689,0,0,0,0.0,0,0,0,0,0,0,0,0,0.0,241357,122226,
0,0.0,0,0,0,0,27495,11488,391078,0.0,119131,789,0.0364935219113182,3799,0,0,0,0,16076,0.01690738535345433,7689,0,0,0,0.0,0,0,0,0,0,0,0,0,0.0,241357,122226,
0,0.0,0,0,0,0,27495,11488,391078,0.0,119131,789,0.0364935219113182,3799,0,0,0,0,16076,0.01690738535345433,7689,0,0,0,0.0,0,0,0,0,0,0,0,0,0.0,241357,122226,
0,0.0,0,0,0,0,27495,11488,391078,0.0,119131,789,0.0364935219113182,3799,0,0,0,0,16076,0.01690738535345433,7689,0,0,0,0.0,0,0,0,0,0,0,0,0,0.0,241357,122226,
0,0.0,0,0,0,0,27495,11488,391078,0.0,119131,789,0.0364935219113182,3799,0,0,0,0,16076,0.01690738535345433,7689,0,0,0,0.0,0,0,0,0,0,0,0,0,0.0,241357,122226,
0,0.0,0,0,0,0,27495,11488,391078,0.0,119131,789,0.0364935219113182,3799,0,0,0,0,16076,0.01690738535345433,7689,0,0,0,0.0,0,0,0,0,0,0,0,0,0.0,241357,122226,
0,0.0,0,0,0,0,27495,11488,391078,0.0,119131,789,0.0364935219113182,3799,0,0,0,0,16076,0.01690738535345433,7689,0,0,0,0.0,0,0,0,0,0,0,0,0,0.0,241357,122226,
0,0.0,0,0,0,0,27495,11488,391078,0.0,119131,789,0.0364935219113182,3799,0,0,0,0,16076,0.01690738535345433,7689,0,0,0,0.0,0,0,0,0,0,0,0,0,0.0,241357,122226,
0,0.0,0,0,0,0,27495,11488,391078,0.0,119131,789,0.0364935219113182,3799,0,0,0,0,16076,0.01690738535345433,7689,0,0,0,0.0,0,0,0,0,0,0,0,0,0.0,241357,122226,
0,0.0,0,0,0,0,27495,11488,391078,0.0,119131,789,0.0364935219113182,3799,0,0,0,0,16076,0.01690738535345433,7689,0,0,0,0.0,0,0,0,0,0,0,0,0,0.0,241357,122226,
0,0.0,0,0,0,0,27495,11488,391078,0.0,119131,789,0.0364935219113182,3799,0,0,0,0,16076,0.01690738535345433,7689,0,0,0,0.0,0,0,0,0,0,0,0,0,0.0,241357,122226,
0,0.0,0,0,0,0,27495,11488,391078,0.0,119131,789,0.0364935219113182,3799,0,0,0,0,16076,0.01690738535345433,7689,0,0,0,0.0,0,0,0,0,0,0,0,0,0.0,241357,122226,
0,0.0,0,0,0,0,27495,11488,391078,0.0,119131,789,0.0364935219113182,3799,0,0,0,0,16076,0.01690738535345433,7689,0,0,0,0.0,0,0,0,0,0,0,0,0,0.0,241357,122226,
0,0.0,0,0,0,0,27495,11488,391078,0.0,119131,789,0.0364935219113182,3799,0,0,0,0,16076,0.01690738535345433,7689,0,0,0,0.0,0,0,0,0,0,0,0,0,0.0,241357,122226,
0,0.0,0,0,0,0,27495,11488,391078,0.0,119131,789,0.0364935219113182,3799,0,0,0,0,16076,0.01690738535345433,7689,0,0,0,0.0,0,0,0,0,0,0,0,0,0.0,241357,122226,
0,0.0,0,0,0,0,27495,11488,391078,0.0,119131,789,0.0364935219113182,3799,0,0,0,0,16076,0.01690738535345433,7689,0,0,0,0.0,0,0,0,0,0,0,0,0,0.0,241357,122226,
0,0.0,0,0,0,0,27495,11488,391078,0.0,119131,789,0.0364935219113182,3799,0,0,0,0,16076,0.01690738535345433,7689,0,0,0,0.0,0,0,0,0,0,0,0,0,0.0,241357,122226,
0,0.0,0,0,0,0,27495,11488,391078,0.0,119131,789,0.0364935219113182,3799,0,0,0,0,16076,0.01690738535345433,7689,0,0,0,0.0,0,0,0,0,0,0,0,0,0.0,241357,122226,
0,0.0,0,0,0,0,27495,11488,391078,0.0,119131,789,0.0364935219113182,3799,0,0,0,0,16076,0.01690738535345433,7689,0,0,0,0.0,0,0,0,0,0,0,0,0,0.0,241357,122226,
0,0.0,0,0,0,0,27495,11488,391078,0.0,119131,789,0.0364935219113182,3799,0,0,0,0,16076,0.01690738535345433,7689,0,0,0,0.0,0,0,0,0,0,0,0,0,0.0,241357,122226,
0,0.0,0,0,0,0,27495,11488,391078,0.0,119131,789,0.0364935219113182,3799,0,0,0,0,16076,0.01690738535345433,7689,0,0,0,0.0,0,0,0,0,0,0,0,0,0.0,241357,122226,
0,0.0,0,0,0,0,27495,11488,391078,0.0,119131,789,0.0364935219113182,3799,0,0,0,0,16076,0.01690738535345433,7689,0,0,0,0.0,0,0,0,0,0,0,0,0,0.0,241357,122226,
0,0.0,0,0,0,0,27495,11488,391078,0.0,119131,789,0.0364935219113182,3799,0,0,0,0,16076,0.01690738535345433,7689,0,0,0,0.0,0,0,0,0,0,0,0,0,0.0,241357,122226,
0,0.0,0,0,0,0,27495,11488,391078,0.0,119131,789,0.0364935219113182,3799,0,0,0,0,16076,0.01690738535345433,7689,0,0,0,0.0,0,0,0,0,0,0,0,0,0.0,241357,122226,
0,0.0,0,0,0,0,27495,11488,391078,0.0,119131,789,0.0364935219113182,3799,0,0,0,0,16076,0.01690738535345433,7689,0,0,0,0.0,0,0,0,0,0,0,0,0,0.0,241357,122226,
0,0.0,0,0,0,0,27495,11488,391078,0.0,119131,789,0.0364935219113182,3799,0,0,0,0,16076,0.01690738535345433,7689,0,0,0,0.0,0,0,0,0,0,0,0,0,0.0,241357,122226,
0,0.0,0,0,0,0,27495,11488,391078,0.0,119131,789,0.0364935219113182,3799,0,0,0,0,16076,0.01690738535345433,7689,0,0,0,0.0,0,0,0,0,0,0,0,0,0.0,241357,122226,
0,0.0,0,0,0,0,27495,11488,391078,0.0,119131,789,0.0364935219113182,3799,0,0,0,0,16076,0.01690738535345433,7689,0,0,0,0.0,0,0,0,0,0,0,0,0,0.0,241357,122226,
0,0.0,0,0,0,0,27495,11488,391078,0.0,119131,789,0.0364935219113182,3799,0,0,0,0,16076,0.01690738535345433,7689,0,0,0,0.0,0,0,0,0,0,0,0,0,0.0,241357,122226,
0,0.0,0,0,0,0,27495,11488,391078,0.0,119131,789,0.0364935219113182,3799,0,0,0,0,16076,0.01690738535345433,7689,0,0,0,0.0,0,0,0,0,0,0,0,0,0.0,241357,122226,
0,0.0,0,0,0,0,27495,11488,391078,0.0,119131,789,0.0364935219113182,3799,0,0,0,0,16076,0.01690738535345433,7689,0,0,0,0.0,0,0,0,0,0,0,0,0,0.0,241357,122226,
0,0.0,0,0,0,0,27495,11488,391078,0.0,119131,789,0.0364935219113182,3799,0,0,0,0,16076,0.01690738535345433,7689,0,0,0,0.0,0,0,0,0,0,0,0,0,0.0,241357,122226,
0,0.0,0,0,0,0,27495,11488,391078,0.0,119131,789,0.0364935219113182,3799,0,0,0,0,16076,0.01690738535345433,7689,0,0,0,0.0,0,0,0,0,0,0,0,0,0.0,241357,122226,
0,0.0,0,0,0,0,27495,11488,391078,0.0,119131,789,0.0364935219113182,3799,0,0,0,0,16076,0.01690738535345433,7689,0,0,0,0.0,0,0,0,0,0,0,0,0,0.0,241357,122226,
0,0.0,0,0,0,0,27495,11488,391078,0.0,119131,789,0.0364935219113182,3799,0,0,0,0,16076,0.01690738535345433,7689,0,0,0,0.0,0,0,0,0,0,0,0,0,0.0,241357,122226,
0,0.0,0,0,0,0,27495,11488,391078,0.0,119131,789,0.0364935219113182,3799,0,0,0,0,16076,0.01690738535345433,7689,0,0,0,0.0,0,0,0,0,0,0,0,0,0.0,241357,122226,
0,0.0,0,0,0,0,27495,11488,391078,0.0,119131,789,0.0364935219113182,3799,0,0,0,0,16076,0.01690738535345433,7689,0,0,0,0.0,0,0,0,0,0,0,0,0,0.0,241357,122226,
0,0.0,0,0,0,0,27495,11488,391078,0.0,119131,789,0.0364935219113182,3799,0,0,0,0,16076,0.01690738535345433,7689,0,0,0,0.0,0,0,0,0,0,0,0,0,0.0,241357,122226,
0,0.0,0,0,0,0,27495,11488,391078,0.0,119131,789,0.0364935219113182,3799,0,0,0,0,16076,0.01690738535345433,7689,0,0,0,0.0,0,0,0,0,0,0,0,0,0.0,241357,122226,
0,0.0,0,0,0,0,27495,11488,391078,0.0,119131,789,0.0364935219113182,3799,0,0,0,0,16076,0.01690738535345433,7689,0,0,0,0.0,0,0,0,0,0,0,0,0,0.0,241357,122226,
0,0.0,0,0,0,0,27495,11488,391078,0.0,119131,789,0.0364935219113182,3799,0,0,0,0,16076,0.01690738535345433,7689,0,0,0,0.0,0,0,0,0,0,0,0,0,0.0,241357,122226,
0,0.0,0,0,0,0,27495,11488,391078,0.0,119131,789,0.0364935219113182,3799,0,0,0,0,16076,0.01690738535345433,7689,0,0,0,0.0,0,0,0,0,0,0,0,0,0.0,241357,122226,
0,0.0,0,0,0,0,27495,11488,391078,0.0,119131,789,0.0364935219113182,3799,0,0,0,0,16076,0.01690738535345433,7689,0,0,0,0.0,0,0,0,0,0,0,0,0,0.0,241357,122226,
0,0.0,0,0,0,0,27495,11488,391078,0.0,119131,789,0.0364935219113182,3799,0,0,0,0,16076,0.01690738535345433,7689,0,0,0,0.0,0,0,0,0,0,0,0,0,0.0,241357,122226,
0,0.0,0,0,0,0,27495,11488,391078,0.0,119131,789,0.0364935219113182,3799,0,0,0,0,16076,0.01690738535345433,7689,0,0,0,0.0,0,0,0,0,0,0,0,0,0.0,241357,122226,
0,0.0,0,0,0,0,27495,11488,391078,0.0,119131,789,0.0364935219113182,3799,0,0,0,0,16076,0.01690738535345433,7689,0,0,0,0.0,0,0,0,0,0,0,0,0,0.0,241357,122226,
0,0.0,0,0,0,0,27495,11488,391078,0.0,119131,789,0.0364935219113182,3799,0,0,0,0,16076,0.01690738535345433,7689,0,0,0,0.0,0,0,0,0,0,0,0,0,0.0,241357,122226,
0,0.0,0,0,0,0,27495,11488,391078,0.0,119131,789,0.0364935219113182,3799,0,0,0,0,16076,0.01690738535345433,7689,0,0,0,0.0,0,0,0,0,0,0,0,0,0.0,241357,122226,
0,0.0,0,0,0,0,27495,11488,391078,0.0,119131,789,0.0364935219113182,3799,0,0,0,0,16076,0.01690738535345433,7689,0,0,0,0.0,0,0,0,0,0,0,0,0,0.0,241357,122226,
0,0.0,0,0,0,0,27495,11488,391078,0.0,119131,789,0.0364935219113182,3799,0,0,0,0,16076,0.01690738535345433,7689,0,0,0,0.0,0,0,0,0,0,0,0,0,0.0,241357,122226,
0,0.0,0,0,0,0,27495,11488,391078,0.0,119131,789,0.0364935219113182,3799,0,0,0,0,16076,0.01690738535345433,7689,0,0,0,0.0,0,0,0,0,0,0,0,0,0.0,241357,122226,
0,0.0,0,0,0,0,27495,11488,391078,0.0,119131,789,0.0364935219113182,3799,0,0,0,0,16076,0.01690738535345433,7689,0,0,0,0.0,0,0,0,0,0,0,0,0,0.0,241357,122226,
0,0.0,0,0,0,0,27495,11488,391078,0.0,119131,789,0.0364935219113182,3799,0,0,0,0,16076,0.01690738535345433,7689,0,0,0,0.0,0,0,0,0,0,0,0,0,0.0,241357,122226,
0,0.0,0,0,0,0,27495,11488,391078,0.0,119131,789,0.0364935219113182,3799,0,0,0,0,16076,0.01690738535345433,7689,0,0,0,0.0,0,0,0,0,0,0,0,0,0.0,241357,122226,
0,0.0,0,0,0,0,27495,11488,391078,0.0,119131,789,0.0364935219113182,3799,0,0,0,0,16076,0.01690738535345433,7689,0,0,0,0.0,0,0,0,0,0,0,0,0,0.0,241357,122226,
0,0.0,0,0,0,0,27495,11488,391078,0.0,119131,789,0.0364935219113182,3799,0,0,0,0,16076,0.01690738535345433,7689,0,0,0,0.0,0,0,0,0,0,0,0,0,0.0,241357,122226,
0,0.0,0,0,0,0,27495,11488,391078,0.0,119131,789,0.0364935219113182,3799,0,0,0,0,16076,0.01690738535345433,7689,0,0,0,0.0,0,0,0,0,0,0,0,0,0.0,241357,122226,
0,0.0,0,0,0,0,27495,11488,391078,0.0,119131,789,0.0364935219113182,3799,0,0,0,0,16076,0.01690738535345433,7689,0,0,0,0.0,0,0,0,0,0,0,0,0,0.0,241357,122226,
0,0.0,0,0,0,0,27495,11488,391078,0.0,119131,789,0.0364935219113182,3799,0,0,0,0,16076,0.01690738535345433,7689,0,0,0,0.0,0,0,0,0,0,0,0,0,0.0,241357,122226,
0,0.0,0,0,0,0,27495,11488,391078,0.0,119131,789,0.0364935219113182,3799,0,0,0,0,16076,0.01690738535345433,7689,0,0,0,0.0,0,0,0,0,0,0,0,0,0.0,241357,122226,
0,0.0,0,0,0,0,27495,11488,391078,0.0,119131,789,0.0364935219113182,3799,0,0,0,0,16076,0.01690738535345433,7689,0,0,0,0.0,0,0,0,0,0,0,0,0,0.0,241357,122226,
0,0.0,0,0,0,0,27495,11488,391078,0.0,119131,789,0.0364935219113182,3799,0,0,0,0,16076,0.01690738535345433,7689,0,0,0,0.0,0,0,0,0,0,0,0,0,0.0,241357,122226,
0,0.0,0,0,0,0,27495,11488,391078,0.0,119131,789,0.0364935219113182,3799,0,0,0,0,16076,0.01690738535345433,7689,0,0,0,0.0,0,0,0,0,0,0,0,0,0.0,241357,122226,
0,0.0,0,0,0,0,27495,11488,391078,0.0,119131,789,0.0364935219113182,3799,0,0,0,0,16076,0.01690738535345433,7689,0,0,0,0.0,0,0,0,0,0,0,0,0,0.0,241357,122226,
0,0.0,0,0,0,0,27495,11488,391078,0.0,119131,789,0.0364935219113182,3799,0,0,0,0,16076,0.01690738535345433,7689,0,0,0,0.0,0,0,0,0,0,0,0,0,0.0,241357,122226,
0,0.0,0,0,0,0,27495,11488,391078,0.0,119131,789,0.0364935219113182,3799,0,0,0,0,16076,0.01690738535345433,7689,0,0,0,0.0,0,0,0,0,0,0,0,0,0.0,241357,122226,
0,0.0,0,0,0,0,27495,11488,391078,0.0,119131,789,0.0364935219113182,3799,0,0,0,0,16076,0.01690738535345433,7689,0,0,0,0.0,0,0,0,0,0,0,0,0,0.0,241357,122226,
0,0.0,0,0,0,0,27495,11488,391078,0.0,119131,789,0.0364935219113182,3799,0,0,0,0,16076,0.01690738535345433,7689,0,0,0,0.0,0,0,0,0,0,0,0,0,0.0,241357,122226,
0,0.0,0,0,0,0,27495,11488,391078,0.0,119131,789,0.0364935219113182,3799,0,0,0,0,16076,0.01690738535345433,7689,0,0,0,0.0,0,0,0,0,0,0,0,0,0.0,241357,122226,
0,0.0,0,0,0,0,27495,11488,391078,0.0,119131,789,0.0364935219113182,3799,0,0,0,0,16076,0.01690738535345433,7689,0,0,0,0.0,0,0,0,0,0,0,0,0,0.0,241357,122226,
0,0.0,0,0,0,0,27495,11488,391078,0.0,119131,789,0.0364935219113182,3799,0,0,0,0,16076,0.01690738535345433,7689,0,0,0,0.0,0,0,0,0,0,0,0,0,0.0,241357,122226,
0,0.0,0,0,0,0,27495,11488,391078,0.0,119131,789,0.0364935219113182,3799,0,0,0,0,16076,0.01690738535345433,7689,0,0,0,0.0,0,0,0,0,0,0,0,0,0.0,241357,122226,
0,0.0,0,0,0,0,27495,11488,391078,0.0,119131,789,0.0364935219113182,3799,0,0,0,0,16076,0.01690738535345433,7689,0,0,0,0.0,0,0,0,0,0,0,0,0,0.0,241357,122226,
0,0.0,0,0,0,0,27495,11488,391078,0.0,119131,789,0.0364935219113182,3799,0,0,0,0,16076,0.01690738535345433,7689,0,0,0,0.0,0,0,0,0,0,0,0,0,0.0,241357,122226,
0,0.0,0,0,0,0,27495,11488,391078,0.0,119131,789,0.0364935219113182,3799,0,0,0,0,16076,0.01690738535345433,7689,0,0,0,0.0,0,0,0,0,0,0,0,0,0.0,241357,122226,
0,0.0,0,0,0,0,27495,11488,391078,0.0,119131,789,0.0364935219113182,3799,0,0,0,0,16076,0.01690738535345433,7689,0,0,0,0.0,0,0,0,0,0,0,0,0,0.0,241357,122226,
0,0.0,0,0,0,0,27495,11488,391078,0.0,119131,789,0.0364935219113182,3799,0,0,0,0,16076,0.01690738535345433,7689,0,0,0,0.0,0,0,0,0,0,0,0,0,0.0,241357,122226,
0,0.0,0,0,0,0,27495,11488,391078,0.0,119131,789,0.0364935219113182,3799,0,0,0,0,16076,0.01690738535345433,7689,0,0,0,0.0,0,0,0,0,0,0,0,0,0.0,241357,122226,
0,0.0,0,0,0,0,27495,11488,391078,0.0,119131,789,0.0364935219113182,3799,0,0,0,0,16076,0.01690738535345433,7689,0,0,0,0.0,0,0,0,0,0,0,0,0,0.0,241357,122226,
0,0.0,0,0,0,0,27495,11488,391078,0.0,119131,789,0.0364935219113182,3799,0,0,0,0,16076,0.01690738535345433,7689,0,0,0,0.0,0,0,0,0,0,0,0,0,0.0,241357,122226,
0,0.0,0,0,0,0,27495,11488,391078,0.0,119131,789,0.0364935219113182,3799,0,0,0,0,16076,0.01690738535345433,7689,0,0,0,0.0,0,0,0,0,0,0,0,0,0.0,241357,122226,
0,0.0,0,0,0,0,27495,11488,391078,0.0,119131,789,0.0364935219113182,3799,0,0,0,0,16076,0.01690738535345433,7689,0,0,0,0.0,0,0,0,0,0,0,0,0,0.0,241357,122226,
0,0.0,0,0,0,0,27495,11488,391078,0.0,119131,789,0.0364935219113182,3799,0,0,0,0,16076,0.01690738535345433,7689,0,0,0,0.0,0,0,0,0,0,0,0,0,0.0,241357,122226,
0,0.0,0,0,0,0,27495,11488,391078,0.0,119131,789,0.0364935219113182,3799,0,0,0,0,16076,0.01690738535345433,7689,0,0,0,0.0,0,0,0,0,0,0,0,0,0.0,241357,122226,
0,0.0,0,0,0,0,27495,11488,391078,0.0,119131,789,0.0364935219113182,3799,0,0,0,0,16076,0.01690738535345433,7689,0,0,0,0.0,0,0,0,0,0,0,0,0,0.0,241357,122226,
0,0.0,0,0,0,0,27495,11488,391078,0.0,119131,789,0.0364935219113182,3799,0,0,0,0,16076,0.01690738535345433,7689,0,0,0,0.0,0,0,0,0,0,0,0,0,0.0,241357,122226,
0,0.0,0,0,0,0,27495,11488,391078,0.0,119131,789,0.0364935219113182,3799,0,0,0,0,16076,0.01690738535345433,7689,0,0,0,0.0,0,0,0,0,0,0,0,0,0.0,241357,122226,
0,0.0,0,0,0,0,27495,11488,391078,0.0,119131,789,0.0364935219113182,3799,0,0,0,0,16076,0.01690738535345433,7689,0,0,0,0.0,0,0,0,0,0,0,0,0,0.0,241357,122226,
0,0.0,0,0,0,0,27495,11488,391078,0.0,119131,789,0.0364935219113182,3799,0,0,0,0,16076,0.01690738535345433,7689,0,0,0,0.0,0,0,0,0,0,0,0,0,0.0,241357,122226,
0,0.0,0,0,0,0,27495,11488,391078,0.0,119131,789,0.0364935219113182,3799,0,0,0,0,16076,0.01690738535345433,7689,0,0,0,0.0,0,0,0,0,0,0,0,0,0.0,241357,122226,
0,0.0,0,0,0,0,27495,11488,391078,0.0,119131,789,0.0364935219113182,3799,0,0,0,0,16076,0.01690738535345433,7689,0,0,0,0.0,0,0,0,0,0,0,0,0,0.0,241357,122226,
0,0.0,0,0,0,0,27495,11488,391078,0.0,119131,789,0.0364935219113182,3799,0,0,0,0,16076,0.01690738535345433,7689,0,0,0,0.0,0,0,0,0,0,0,0,0,0.0,241357,122226,
0,0.0,0,0,0,0,27495,11488,391078,0.0,119131,789,0.0364935219113182,3799,0,0,0,0,16076,0.01690738535345433,7689,0,0,0,0.0,0,0,0,0,0,0,0,0,0.0,241357,122226,
0,0.0,0,0,0,0,27495,11488,391078,0.0,119131,789,0.0364935219113182,3799,0,0,0,0,16076,0.01690738535345433,7689,0,0,0,0.0,0,0,0,0,0,0,0,0,0.0,241357,122226,
0,0.0,0,0,0,0,27495,11488,391078,0.0,119131,789,0.0364935219113182,3799,0,0,0,0,16076,0.01690738535345433,7689,0,0,0,0.0,0,0,0,0,0,0,0,0,0.0,241357,122226,
0,0.0,0,0,0,0,27495,11488,391078,0.0,119131,789,0.0364935219113182,3799,0,0,0,0,16076,0.01690738535345433,7689,0,0,0,0.0,0,0,0,0,0,0,0,0,0.0,241357,122226,
0,0.0,0,0,0,0,27495,11488,391078,0.0,119131,789,0.0364935219113182,3799,0,0,0,0,16076,0.01690738535345433,7689,0,0,0,0.0,0,0,0,0,0,0,0,0,0.0,241357,122226,
0,0.0,0,0,0,0,27495,11488,391078,0.0,119131,789,0.0364935219113182,3799,0,0,0,0,16076,0.01690738535345433,7689,0,0,0,0.0,0,0,0,0,0,0,0,0,0.0,241357,122226,
0,0.0,0,0,0,0,27495,11488,391078,0.0,119131,789,0.0364935219113182,3799,0,0,0,0,16076,0.01690738535345433,7689,0,0,0,0.0,0,0,0,0,0,0,0,0,0.0,241357,122226,
0,0.0,0,0,0,0,27495,11488,391078,0.0,119131,789,0.0364935219113182,3799,0,0,0,0,16076,0.01690738535345433,7689,0,0,0,0.0,0,0,0,0,0,0,0,0,0.0,241357,122226,
0,0.0,0,0,0,0,27495,11488,391078,0.0,119131,789,0.0364935219113182,3799,0,0,0,0,16076,0.01690738535345433,7689,0,0,0,0.0,0,0,0,0,0,0,0,0,0.0,241357,122226,
0,0.0,0,0,0,0,27495,11488,391078,0.0,119131,789,0.0364935219113182,3799,0,0,0,0,16076,0.01690738535345433,7689,0,0,0,0.0,0,0,0,0,0,0,0,0,0.0,241357,122226,
0,0.0,0,0,0,0,27495,11488,391078,0.0,119131,789,0.0364935219113182,3799,0,0,0,0,16076,0.01690738535345433,7689,0,0,0,0.0,0,0,0,0,0,0,0,0,0.0,241357,122226,
0,0.0,0,0,0,0,27495,11488,391078,0.0,119131,789,0.0364935219113182,3799,0,0,0,0,16076,0.01690738535345433,7689,0,0,0,0.0,0,0,0,0,0,0,0,0,0.0,241357,122226,
0,0.0,0,0,0,0,27495,11488,391078,0.0,119131,789,0.0364935219113182,3799,0,0,0,0,16076,0.01690738535345433,7689,0,0,0,0.0,0,0,0,0,0,0,0,0,0.0,241357,122226,
0,0.0,0,0,0,0,27495,11488,391078,0.0,119131,789,0.0364935219113182,3799,0,0,0,0,16076,0.01690738535345433,7689,0,0,0,0.0,0,0,0,0,0,0,0,0,0.0,241357,122226,
0,0.0,0,0,0,0,27495,11488,391078,0.0,119131,789,0.0364935219113182,3799,0,0,0,0,16076,0.01690738535345433,7689,0,0,0,0.0,0,0,0,0,0,0,0,0,0.0,241357,122226,
0,0.0,0,0,0,0,27495,11488,391078,0.0,119131,789,0.0364935219113182,3799,0,0,0,0,16076,0.01690738535345433,7689,0,0,0,0.0,0,0,0,0,0,0,0,0,0.0,241357,122226,
0,0.0,0,0,0,0,27495,11488,391078,0.0,119131,789,0.0364935219113182,3799,0,0,0,0,16076,0.01690738535345433,7689,0,0,0,0.0,0,0,0,0,0,0,0,0,0.0,241357,122226,
0,0.0,0,0,0,0,27495,11488,391078,0.0,119131,789,0.0364935219113182,3799,0,0,0,0,16076,0.01690738535345433,7689,0,0,0,0.0,0,0,0,0,0,0,0,0,0.0,241357,122226,
0,0.0,0,0,0,0,27495,11488,391078,0.0,119131,789,0.0364935219113182,3799,0,0,0,0,16076,0.01690738535345433,7689,0,0,0,0.0,0,0,0,0,0,0,0,0,0.0,241357,122226,
0,0.0,0,0,0,0,27495,11488,391078,0.0,119131,789,0.0364935219113182,3799,0,0,0,0,16076,0.01690738535345433,7689,0,0,0,0.0,0,0,0,0,0,0,0,0,0.0,241357,122226,
0,0.0,0,0,0,0,27495,11488,391078,0.0,119131,789,0.0364935219113182,3799,0,0,0,0,16076,0.01690738535345433,7689,0,0,0,0.0,0,0,0,0,0,0,0,0,0.0,241357,122226,
0,0.0,0,0,0,0,27495,11488,391078,0.0,119131,789,0.0364935219113182,3799,0,0,0,0,16076,0.01690738535345433,7689,0,0,0,0.0,0,0,0,0,0,0,0,0,0.0,241357,122226,
0,0.0,0,0,0,0,27495,11488,391078,0.0,119131,789,0.0364935219113182,3799,0,0,0,0,16076,0.01690738535345433,7689,0,0,0,0.0,0,0,0,0,0,0,0,0,0.0,241357,122226,
0,0.0,0,0,0,0,27495,11488,391078,0.0,119131,789,0.0364935219113182,3799,0,0,0,0,16076,0.01690738535345433,7689,0,0,0,0.0,0,0,0,0,0,0,0,0,0.0,241357,122226,
0,0.0,0,0,0,0,27495,11488,391078,0.0,119131,789,0.0364935219113182,3799,0,0,0,0,16076,0.01690738535345433,7689,0,0,0,0.0,0,0,0,0,0,0,0,0,0.0,241357,122226,
0,0.0,0,0,0,0,27495,11488,391078,0.0,119131,789,0.0364935219113182,3799,0,0,0,0,16076,0.01690738535345433,7689,0,0,0,0.0,0,0,0,0,0,0,0,0,0.0,241357,122226,
0,0.0,0,0,0,0,27495,11488,391078,0.0,119131,789,0.0364935219113182,3799,0,0,0,0,16076,0.01690738535345433,7689,0,0,0,0.0,0,0,0,0,0,0,0,0,0.0,241357,122226,
0,0.0,0,0,0,0,27495,11488,391078,0.0,119131,789,0.0364935219113182,3799,0,0,0,0,16076,0.01690738535345433,7689,0,0,0,0.0,0,0,0,0,0,0,0,0,0.0,241357,122226,
0,0.0,0,0,0,0,27495,11488,391078,0.0,119131,789,0.0364935219113182,3799,0,0,0,0,16076,0.01690738535345433,7689,0,0,0,0.0,0,0,0,0,0,0,0,0,0.0,241357,122226,
0,0.0,0,0,0,0,27495,11488,391078,0.0,119131,789,0.0364935219113182,3799,0,0,0,0,16076,0.01690738535345433,7689,0,0,0,0.0,0,0,0,0,0,0,0,0,0.0,241357,122226,
0,0.0,0,0,0,0,27495,11488,391078,0.0,119131,789,0.0364935219113182,3799,0,0,0,0,16076,0.01690738535345433,7689,0,0,0,0.0,0,0,0,0,0,0,0,0,0.0,241357,122226,
0,0.0,0,0,0,0,27495,11488,391078,0.0,119131,789,0.0364935219113182,3799,0,0,0,0,16076,0.01690738535345433,7689,0,0,0,0.0,0,0,0,0,0,0,0,0,0.0,241357,122226,
0,0.0,0,0,0,0,27495,11488,391078,0.0,119131,789,0.0364935219113182,3799,0,0,0,0,16076,0.01690738535345433,7689,0,0,0,0.0,0,0,0,0,0,0,0,0,0.0,241357,122226,
0,0.0,0,0,0,0,27495,11488,391078,0.0,119131,789,0.0364935219113182,3799,0,0,0,0,16076,0.01690738535345433,7689,0,0,0,0.0,0,0,0,0,0,0,0,0,0.0,241357,122226,
0,0.0,0,0,0,0,27495,11488,391078,0.0,119131,789,0.0364935219113182,3799,0,0,0,0,16076,0.01690738535345433,7689,0,0,0,0.0,0,0,0,0,0,0,0,0,0.0,241357,122226,
0,0.0,0,0,0,0,27495,11488,391078,0.0,119131,789,0.0364935219113182,3799,0,0,0,0,16076,0.01690738535345433,7689,0,0,0,0.0,0,0,0,0,0,0,0,0,0.0,241357,122226,
0,0.0,0,0,0,0,27495,11488,391078,0.0,119131,789,0.0364935219113182,3799,0,0,0,0,16076,0.01690738535345433,7689,0,0,0,0.0,0,0,0,0,0,0,0,0,0.0,241357,122226,
0,0.0,0,0,0,0,27495,11488,391078,0.0,119131,789,0.0364935219113182,3799,0,0,0,0,16076,0.01690738535345433,7689,0,0,0,0.0,0,0,0,0,0,0,0,0,0.0,241357,122226,
0,0.0,0,0,0,0,27495,11488,391078,0.0,119131,789,0.0364935219113182,3799,0,0,0,0,16076,0.01690738535345433,7689,0,0,0,0.0,0,0,0,0,0,0,0,0,0.0,241357,122226,
0,0.0,0,0,0,0,27495,11488,391078,0.0,119131,789,0.0364935219113182,3799,0,0,0,0,16076,0.01690738535345433,7689,0,0,0,0.0,0,0,0,0,0,0,0,0,0.0,241357,122226,
0,0.0,0,0,0,0,27495,11488,391078,0.0,119131,789,0.0364935219113182,3799,0,0,0,0,16076,0.01690738535345433,7689,0,0,0,0.0,0,0,0,0,0,0,0,0,0.0,241357,122226,
0,0.0,0,0,0,0,27495,11488,391078,0.0,119131,789,0.0364935219113182,3799,0,0,0,0,16076,0.01690738535345433,7689,0,0,0,0.0,0,0,0,0,0,0,0,0,0.0,241357,122226,
0,0.0,0,0,0,0,27495,11488,391078,0.0,119131,789,0.0364935219113182,3799,0,0,0,0,16076,0.01690738535345433,7689,0,0,0,0.0,0,0,0,0,0,0,0,0,0.0,241357,122226,
0,0.0,0,0,0,0,27495,11488,391078,0.0,119131,789,0.0364935219113182,3799,0,0,0,0,16076,0.01690738535345433,7689,0,0,0,0.0,0,0,0,0,0,0,0,0,0.0,241357,122226,
0,0.0,0,0,0,0,27495,11488,391078,0.0,119131,789,0.0364935219113182,3799,0,0,0,0,16076,0.01690738535345433,7689,0,0,0,0.0,0,0,0,0,0,0,0,0,0.0,241357,122226,
0,0.0,0,0,0,0,27495,11488,391078,0.0,119131,789,0.0364935219113182,3799,0,0,0,0,16076,0.01690738535345433,7689,0,0,0,0.0,0,0,0,0,0,0,0,0,0.0,241357,122226,
0,0.0,0,0,0,0,27495,11488,391078,0.0,119131,789,0.0364935219113182,3799,0,0,0,0,16076,0.01690738535345433,7689,0,0,0,0.0,0,0,0,0,0,0,0,0,0.0,241357,122226,
0,0.0,0,0,0,0,27495,11488,391078,0.0,119131,789,0.0364935219113182,3799,0,0,0,0,16076,0.01690738535345433,7689,0,0,0,0.0,0,0,0,0,0,0,0,0,0.0,241357,122226,
0,0.0,0,0,0,0,27495,11488,391078,0.0,119131,789,0.0364935219113182,3799,0,0,0,0,16076,0.01690738535345433,7689,0,0,0,0.0,0,0,0,0,0,0,0,0,0.0,241357,122226,
0,0.0,0,0,0,0,27495,11488,391078,0.0,119131,789,0.0364935219113182,3799,0,0,0,0,16076,0.01690738535345433,7689,0,0,0,0.0,0,0,0,0,0,0,0,0,0.0,241357,122226,
0,0.0,0,0,0,0,27495,11488,391078,0.0,119131,789,0.0364935219113182,3799,0,0,0,0,16076,0.01690738535345433,7689,0,0,0,0.0,0,0,0,0,0,0,0,0,0.0,241357,122226,
0,0.0,0,0,0,0,27495,11488,391078,0.0,119131,789,0.0364935219113182,3799,0,0,0,0,16076,0.01690738535345433,7689,0,0,0,0.0,0,0,0,0,0,0,0,0,0.0,241357,122226,
0,0.0,0,0,0,0,27495,11488,391078,0.0,119131,789,0.0364935219113182,3799,0,0,0,0,16076,0.01690738535345433,7689,0,0,0,0.0,0,0,0,0,0,0,0,0,0.0,241357,122226,
0,0.0,0,0,0,0,27495,11488,391078,0.0,119131,789,0.0364935219113182,3799,0,0,0,0,16076,0.01690738535345433,7689,0,0,0,0.0,0,0,0,0,0,0,0,0,0.0,241357,122226,
0,0.0,0,0,0,0,27495,11488,391078,0.0,119131,789,0.0364935219113182,3799,0,0,0,0,16076,0.01690738535345433,7689,0,0,0,0.0,0,0,0,0,0,0,0,0,0.0,241357,122226,
0,0.0,0,0,0,0,27495,11488,391078,0.0,119131,789,0.0364935219113182,3799,0,0,0,0,16076,0.01690738535345433,7689,0,0,0,0.0,0,0,0,0,0,0,0,0,0.0,241357,122226,
0,0.0,0,0,0,0,27495,11488,391078,0.0,119131,789,0.0364935219113182,3799,0,0,0,0,16076,0.01690738535345433,7689,0,0,0,0.0,0,0,0,0,0,0,0,0,0.0,241357,122226,
0,0.0,0,0,0,0,27495,11488,391078,0.0,119131,789,0.0364935219113182,3799,0,0,0,0,16076,0.01690738535345433,7689,0,0,0,0.0,0,0,0,0,0,0,0,0,0.0,241357,122226,
0,0.0,0,0,0,0,27495,11488,391078,0.0,119131,789,0.0364935219113182,3799,0,0,0,0,16076,0.01690738535345433,7689,0,0,0,0.0,0,0,0,0,0,0,0,0,0.0,241357,122226,
0,0.0,0,0,0,0,27495,11488,391078,0.0,119131,789,0.0364935219113182,3799,0,0,0,0,16076,0.01690738535345433,7689,0,0,0,0.0,0,0,0,0,0,0,0,0,0.0,241357,122226,
0,0.0,0,0,0,0,27495,11488,391078,0.0,119131,789,0.0364935219113182,3799,0,0,0,0,16076,0.01690738535345433,7689,0,0,0,0.0,0,0,0,0,0,0,0,0,0.0,241357,122226,
0,0.0,0,0,0,0,27495,11488,391078,0.0,119131,789,0.0364935219113182,3799,0,0,0,0,16076,0.01690738535345433,7689,0,0,0,0.0,0,0,0,0,0,0,0,0,0.0,241357,122226,
0,0.0,0,0,0,0,27495,11488,391078,0.0,119131,789,0.0364935219113182,3799,0,0,0,0,16076,0.01690738535345433,7689,0,0,0,0.0,0,0,0,0,0,0,0,0,0.0,241357,122226,
0,0.0,0,0,0,0,27495,11488,391078,0.0,119131,789,0.0364935219113182,3799,0,0,0,0,16076,0.01690738535345433,7689,0,0,0,0.0,0,0,0,0,0,0,0,0,0.0,241357,122226,
0,0.0,0,0,0,0,27495,11488,391078,0.0,119131,789,0.0364935219113182,3799,0,0,0,0,16076,0.01690738535345433,7689,0,0,0,0.0,0,0,0,0,0,0,0,0,0.0,241357,122226,
0,0.0,0,0,0,0,27495,11488,391078,0.0,119131,789,0.0364935219113182,3799,0,0,0,0,16076,0.01690738535345433,7689,0,0,0,0.0,0,0,0,0,0,0,0,0,0.0,241357,122226,
0,0.0,0,0,0,0,27495,11488,391078,0.0,119131,789,0.0364935219113182,3799,0,0,0,0,16076,0.01690738535345433,7689,0,0,0,0.0,0,0,0,0,0,0,0,0,0.0,241357,122226,
0,0.0,0,0,0,0,27495,11488,391078,0.0,119131,789,0.0364935219113182,3799,0,0,0,0,16076,0.01690738535345433,7689,0,0,0,0.0,0,0,0,0,0,0,0,0,0.0,241357,122226,
0,0.0,0,0,0,0,27495,11488,391078,0.0,119131,789,0.0364935219113182,3799,0,0,0,0,16076,0.01690738535345433,7689,0,0,0,0.0,0,0,0,0,0,0,0,0,0.0,241357,122226,
0,0.0,0,0,0,0,27495,11488,391078,0.0,119131,789,0.0364935219113182,3799,0,0,0,0,16076,0.01690738535345433,7689,0,0,0,0.0,0,0,0,0,0,0,0,0,0.0,241357,122226,
0,0.0,0,0,0,0,27495,11488,391078,0.0,119131,789,0.0364935219113182,3799,0,0,0,0,16076,0.01690738535345433,7689,0,0,0,0.0,0,0,0,0,0,0,0,0,0.0,241357,122226,
0,0.0,0,0,0,0,27495,11488,391078,0.0,119131,789,0.0364935219113182,3799,0,0,0,0,16076,0.01690738535345433,7689,0,0,0,0.0,0,0,0,0,0,0,0,0,0.0,241357,122226,
0,0.0,0,0,0,0,27495,11488,391078,0.0,119131,789,0.0364935219113182,3799,0,0,0,0,16076,0.01690738535345433,7689,0,0,0,0.0,0,0,0,0,0,0,0,0,0.0,241357,122226,
0,0.0,0,0,0,0,27495,11488,391078,0.0,119131,789,0.0364935219113182,3799,0,0,0,0,16076,0.01690738535345433,7689,0,0,0,0.0,0,0,0,0,0,0,0,0,0.0,241357,122226,
0,0.0,0,0,0,0,27495,11488,391078,0.0,119131,789,0.0364935219113182,3799,0,0,0,0,16076,0.01690738535345433,7689,0,0,0,0.0,0,0,0,0,0,0,0,0,0.0,241357,122226,
0,0.0,0,0,0,0,27495,11488,391078,0.0,119131,789,0.0364935219113182,3799,0,0,0,0,16076,0.01690738535345433,7689,0,0,0,0.0,0,0,0,0,0,0,0,0,0.0,241357,122226,
0,0.0,0,0,0,0,27495,11488,391078,0.0,119131,789,0.0364935219113182,3799,0,0,0,0,16076,0.01690738535345433,7689,0,0,0,0.0,0,0,0,0,0,0,0,0,0.0,241357,122226,
0,0.0,0,0,0,0,27495,11488,391078,0.0,119131,789,0.0364935219113182,3799,0,0,0,0,16076,0.01690738535345433,7689,0,0,0,0.0,0,0,0,0,0,0,0,0,0.0,241357,122226,
0,0.0,0,0,0,0,27495,11488,391078,0.0,119131,789,0.0364935219113182,3799,0,0,0,0,16076,0.01690738535345433,7689,0,0,0,0.0,0,0,0,0,0,0,0,0,0.0,241357,122226,
0,0.0,0,0,0,0,27495,11488,391078,0.0,119131,789,0.0364935219113182,3799,0,0,0,0,16076,0.01690738535345433,7689,0,0,0,0.0,0,0,0,0,0,0,0,0,0.0,241357,122226,
0,0.0,0,0,0,0,27495,11488,391078,0.0,119131,789,0.0364935219113182,3799,0,0,0,0,16076,0.01690738535345433,7689,0,0,0,0.0,0,0,0,0,0,0,0,0,0.0,241357,122226,
0,0.0,0,0,0,0,27495,11488,391078,0.0,119131,789,0.0364935219113182,3799,0,0,0,0,16076,0.01690738535345433,7689,0,0,0,0.0,0,0,0,0,0,0,0,0,0.0,241357,122226,
0,0.0,0,0,0,0,27495,11488,391078,0.0,119131,789,0.0364935219113182,3799,0,0,0,0,16076,0.01690738535345433,7689,0,0,0,0.0,0,0,0,0,0,0,0,0,0.0,241357,122226,
0,0.0,0,0,0,0,27495,11488,391078,0.0,119131,789,0.0364935219113182,3799,0,0,0,0,16076,0.01690738535345433,7689,0,0,0,0.0,0,0,0,0,0,0,0,0,0.0,241357,122226,
0,0.0,0,0,0,0,27495,11488,391078,0.0,119131,789,0.0364935219113182,3799,0,0,0,0,16076,0.01690738535345433,7689,0,0,0,0.0,0,0,0,0,0,0,0,0,0.0,241357,122226,
0,0.0,0,0,0,0,27495,11488,391078,0.0,119131,789,0.0364935219113182,3799,0,0,0,0,16076,0.01690738535345433,7689,0,0,0,0.0,0,0,0,0,0,0,0,0,0.0,241357,122226,
0,0.0,0,0,0,0,27495,11488,391078,0.0,119131,789,0.0364935219113182,3799,0,0,0,0,16076,0.01690738535345433,7689,0,0,0,0.0,0,0,0,0,0,0,0,0,0.0,241357,122226,
0,0.0,0,0,0,0,27495,11488,391078,0.0,119131,789,0.0364935219113182,3799,0,0,0,0,16076,0.01690738535345433,7689,0,0,0,0.0,0,0,0,0,0,0,0,0,0.0,241357,122226,
0,0.0,0,0,0,0,27495,11488,391078,0.0,119131,789,0.0364935219113182,3799,0,0,0,0,16076,0.01690738535345433,7689,0,0,0,0.0,0,0,0,0,0,0,0,0,0.0,241357,122226,
0,0.0,0,0,0,0,27495,11488,391078,0.0,119131,789,0.0364935219113182,3799,0,0,0,0,16076,0.01690738535345433,7689,0,0,0,0.0,0,0,0,0,0,0,0,0,0.0,241357,122226,
0,0.0,0,0,0,0,27495,11488,391078,0.0,119131,789,0.0364935219113182,3799,0,0,0,0,16076,0.01690738535345433,7689,0,0,0,0.0,0,0,0,0,0,0,0,0,0.0,241357,122226,
0,0.0,0,0,0,0,27495,11488,391078,0.0,119131,789,0.0364935219113182,3799,0,0,0,0,16076,0.01690738535345433,7689,0,0,0,0.0,0,0,0,0,0,0,0,0,0.0,241357,122226,
0,0.0,0,0,0,0,27495,11488,391078,0.0,119131,789,0.0364935219113182,3799,0,0,0,0,16076,0.01690738535345433,7689,0,0,0,0.0,0,0,0,0,0,0,0,0,0.0,241357,122226,
0,0.0,0,0,0,0,27495,11488,391078,0.0,119131,789,0.0364935219113182,3799,0,0,0,0,16076,0.01690738535345433,7689,0,0,0,0.0,0,0,0,0,0,0,0,0,0.0,241357,122226,
0,0.0,0,0,0,0,27495,11488,391078,0.0,119131,789,0.0364935219113182,3799,0,0,0,0,16076,0.01690738535345433,7689,0,0,0,0.0,0,0,0,0,0,0,0,0,0.0,241357,122226,
0,0.0,0,0,0,0,27495,11488,391078,0.0,119131,789,0.0364935219113182,3799,0,0,0,0,16076,0.01690738535345433,7689,0,0,0,0.0,0,0,0,0,0,0,0,0,0.0,241357,122226,
0,0.0,0,0,0,0,27495,11488,391078,0.0,119131,789,0.0364935219113182,3799,0,0,0,0,16076,0.01690738535345433,7689,0,0,0,0.0,0,0,0,0,0,0,0,0,0.0,241357,122226,
0,0.0,0,0,0,0,27495,11488,391078,0.0,119131,789,0.0364935219113182,3799,0,0,0,0,16076,0.01690738535345433,7689,0,0,0,0.0,0,0,0,0,0,0,0,0,0.0,241357,122226,
0,0.0,0,0,0,0,27495,11488,391078,0.0,119131,789,0.0364935219113182,3799,0,0,0,0,16076,0.01690738535345433,7689,0,0,0,0.0,0,0,0,0,0,0,0,0,0.0,241357,122226,
0,0.0,0,0,0,0,27495,11488,391078,0.0,119131,789,0.0364935219113182,3799,0,0,0,0,16076,0.01690738535345433,7689,0,0,0,0.0,0,0,0,0,0,0,0,0,0.0,241357,122226,
0,0.0,0,0,0,0,27495,11488,391078,0.0,119131,789,0.0364935219113182,3799,0,0,0,0,16076,0.01690738535345433,7689,0,0,0,0.0,0,0,0,0,0,0,0,0,0.0,241357,122226,
0,0.0,0,0,0,0,27495,11488,391078,0.0,119131,789,0.0364935219113182,3799,0,0,0,0,16076,0.01690738535345433,7689,0,0,0,0.0,0,0,0,0,0,0,0,0,0.0,241357,122226,
0,0.0,0,0,0,0,27495,11488,391078,0.0,119131,789,0.0364935219113182,3799,0,0,0,0,16076,0.01690738535345433,7689,0,0,0,0.0,0,0,0,0,0,0,0,0,0.0,241357,122226,
0,0.0,0,0,0,0,27495,11488,391078,0.0,119131,789,0.0364935219113182,3799,0,0,0,0,16076,0.01690738535345433,7689,0,0,0,0.0,0,0,0,0,0,0,0,0,0.0,241357,122226,
0,0.0,0,0,0,0,27495,11488,391078,0.0,119131,789,0.0364935219113182,3799,0,0,0,0,16076,0.01690738535345433,7689,0,0,0,0.0,0,0,0,0,0,0,0,0,0.0,241357,122226,
0,0.0,0,0,0,0,27495,11488,391078,0.0,119131,789,0.0364935219113182,3799,0,0,0,0,16076,0.01690738535345433,7689,0,0,0,0.0,0,0,0,0,0,0,0,0,0.0,241357,122226,
0,0.0,0,0,0,0,27495,11488,391078,0.0,119131,789,0.0364935219113182,3799,0,0,0,0,16076,0.01690738535345433,7689,0,0,0,0.0,0,0,0,0,0,0,0,0,0.0,241357,122226,
0,0.0,0,0,0,0,27495,11488,391078,0.0,119131,789,0.0364935219113182,3799,0,0,0,0,16076,0.01690738535345433,7689,0,0,0,0.0,0,0,0,0,0,0,0,0,0.0,241357,122226,
0,0.0,0,0,0,0,27495,11488,391078,0.0,119131,789,0.0364935219113182,3799,0,0,0,0,16076,0.01690738535345433,7689,0,0,0,0.0,0,0,0,0,0,0,0,0,0.0,241357,122226,
0,0.0,0,0,0,0,27495,11488,391078,0.0,119131,789,0.0364935219113182,3799,0,0,0,0,16076,0.01690738535345433,7689,0,0,0,0.0,0,0,0,0,0,0,0,0,0.0,241357,122226,
0,0.0,0,0,0,0,27495,11488,391078,0.0,119131,789,0.0364935219113182,3799,0,0,0,0,16076,0.01690738535345433,7689,0,0,0,0.0,0,0,0,0,0,0,0,0,0.0,241357,122226,
0,0.0,0,0,0,0,27495,11488,391078,0.0,119131,789,0.0364935219113182,3799,0,0,0,0,16076,0.01690738535345433,7689,0,0,0,0.0,0,0,0,0,0,0,0,0,0.0,241357,122226,
0,0.0,0,0,0,0,27495,11488,391078,0.0,119131,789,0.0364935219113182,3799,0,0,0,0,16076,0.01690738535345433,7689,0,0,0,0.0,0,0,0,0,0,0,0,0,0.0,241357,122226,
0,0.0,0,0,0,0,27495,11488,391078,0.0,119131,789,0.0364935219113182,3799,0,0,0,0,16076,0.01690738535345433,7689,0,0,0,0.0,0,0,0,0,0,0,0,0,0.0,241357,122226,
0,0.0,0,0,0,0,27495,11488,391078,0.0,119131,789,0.0364935219113182,3799,0,0,0,0,16076,0.01690738535345433,7689,0,0,0,0.0,0,0,0,0,0,0,0,0,0.0,241357,122226,
0,0.0,0,0,0,0,27495,11488,391078,0.0,119131,789,0.0364935219113182,3799,0,0,0,0,16076,0.01690738535345433,7689,0,0,0,0.0,0,0,0,0,0,0,0,0,0.0,241357,122226,
0,0.0,0,0,0,0,27495,11488,391078,0.0,119131,789,0.0364935219113182,3799,0,0,0,0,16076,0.01690738535345433,7689,0,0,0,0.0,0,0,0,0,0,0,0,0,0.0,241357,122226,
0,0.0,0,0,0,0,27495,11488,391078,0.0,119131,789,0.0364935219113182,3799,0,0,0,0,16076,0.01690738535345433,7689,0,0,0,0.0,0,0,0,0,0,0,0,0,0.0,241357,122226,
0,0.0,0,0,0,0,27495,11488,391078,0.0,119131,789,0.0364935219113182,3799,0,0,0,0,16076,0.01690738535345433,7689,0,0,0,0.0,0,0,0,0,0,0,0,0,0.0,241357,122226,
0,0.0,0,0,0,0,27495,11488,391078,0.0,119131,789,0.0364935219113182,3799,0,0,0,0,16076,0.01690738535345433,7689,0,0,0,0.0,0,0,0,0,0,0,0,0,0.0,241357,122226,
0,0.0,0,0,0,0,27495,11488,391078,0.0,119131,789,0.0364935219113182,3799,0,0,0,0,16076,0.01690738535345433,7689,0,0,0,0.0,0,0,0,0,0,0,0,0,0.0,241357,122226,
29,0.0,0,3,26,32,27495,11488,391078,0.008758306422504268,119131,789,0.0364935219113182,3799,336,330,56,722,16076,0.01690738535345433,7689,0,6,0,0.19450461286963558,0,60980,0,46857,8377,0,116214,14123,0.05808223398021103,241357,122226,
29,0.0,0,3,26,32,27495,11488,391078,0.008758306422504268,119131,789,0.0364935219113182,3799,336,330,56,722,16076,0.01690738535345433,7689,0,6,0,0.19450461286963558,0,60980,0,46857,8377,0,116214,14123,0.05808223398021103,241357,122226,
29,0.0,0,3,26,32,27495,11488,391078,0.008758306422504268,119131,789,0.0364935219113182,3799,336,330,56,722,16076,0.01690738535345433,7689,0,6,0,0.19450461286963558,0,60980,0,46857,8377,0,116214,14123,0.05808223398021103,241357,122226,
29,0.0,0,3,26,32,27495,11488,391078,0.008758306422504268,119131,789,0.0364935219113182,3799,506,406,59,971,16076,0.01690738535345433,7689,0,100,0,0.1700763777445502,0,60980,0,46857,8377,0,116214,14123,0.05808223398021103,241357,122226,
29,0.0,0,3,26,32,27495,11488,391078,0.008758306422504268,119131,789,0.0364935219113182,3799,506,406,59,971,16076,0.01690738535345433,7689,0,100,0,0.1700763777445502,0,60980,0,46857,8377,0,116214,14123,0.05808223398021103,241357,122226,
29,0.0,0,3,26,32,27495,11488,391078,0.008758306422504268,119131,789,0.0364935219113182,3799,506,406,59,971,16076,0.01690738535345433,7689,0,100,0,0.1700763777445502,0,60980,0,46857,8377,0,116214,14123,0.05808223398021103,241357,122226,
29,0.0,0,3,26,32,27495,11488,391078,0.008758306422504268,119131,789,0.0364935219113182,3799,110,323,38,471,16076,0.01690738535345433,7689,0,-213,0,0.0944372338169388,0,60980,0,46857,8377,0,116214,14123,0.05808223398021103,241357,122226,
29,0.0,0,3,26,32,27495,11488,391078,0.008758306422504268,119131,789,0.0364935219113182,3799,110,323,38,471,16076,0.01690738535345433,7689,0,-213,0,0.0944372338169388,0,60980,0,46857,8377,0,116214,14123,0.05808223398021103,241357,122226,
29,0.0,0,3,26,32,27495,11488,391078,0.008758306422504268,119131,789,0.0364935219113182,3799,110,323,38,471,16076,0.01690738535345433,7689,0,-213,0,0.0944372338169388,0,60980,0,46857,8377,0,116214,14123,0.05808223398021103,241357,122226,
29,0.0,0,3,26,32,27495,11488,391078,0.008758306422504268,119131,789,0.0364935219113182,3799,9,9,0,18,16076,0.01690738535345433,7689,0,0,0,0.047619047619047616,0,60980,0,46857,8377,0,116214,14123,0.05808223398021103,241357,122226,
29,0.0,0,3,26,32,27495,11488,391078,0.008758306422504268,119131,789,0.0364935219113182,3799,9,9,0,18,16076,0.01690738535345433,7689,0,0,0,0.047619047619047616,0,60980,0,46857,8377,0,116214,14123,0.05808223398021103,241357,122226,
29,0.0,0,3,26,32,27495,11488,391078,0.008758306422504268,119131,789,0.0364935219113182,3799,9,9,0,18,16076,0.01690738535345433,7689,0,0,0,0.047619047619047616,0,60980,0,46857,8377,0,116214,14123,0.05808223398021103,241357,122226,
29,0.0,0,3,26,32,27495,11488,391078,0.008758306422504268,119131,789,0.0364935219113182,3799,38125,34232,6932,79289,16076,0.01690738535345433,7689,0,3893,0,0.4406714112894209,0,60980,0,46857,8377,0,116214,14123,0.05808223398021103,241357,122226,
29,0.0,0,3,26,32,27495,11488,391078,0.008758306422504268,119131,789,0.0364935219113182,3799,38125,34232,6932,79289,16076,0.01690738535345433,7689,0,3893,0,0.4406714112894209,0,60980,0,46857,8377,0,116214,14123,0.05808223398021103,241357,122226,
29,0.0,0,3,26,32,27495,11488,391078,0.008758306422504268,119131,789,0.0364935219113182,3799,38125,34232,6932,79289,16076,0.01690738535345433,7689,0,3893,0,0.4406714112894209,0,60980,0,46857,8377,0,116214,14123,0.05808223398021103,241357,122226,
29,0.0,0,3,26,32,27495,11488,391078,0.008758306422504268,119131,789,0.0364935219113182,3799,38125,34232,6932,79289,16076,0.01690738535345433,7689,0,3893,0,0.4406714112894209,0,60980,0,46857,8377,0,116214,14123,0.05808223398021103,241357,122226,
29,0.0,0,3,26,32,27495,11488,391078,0.008758306422504268,119131,789,0.0364935219113182,3799,38125,34232,6932,79289,16076,0.01690738535345433,7689,0,3893,0,0.4406714112894209,0,60980,0,46857,8377,0,116214,14123,0.05808223398021103,241357,122226,
29,0.0,0,3,26,32,27495,11488,391078,0.008758306422504268,119131,789,0.0364935219113182,3799,38125,34232,6932,79289,16076,0.01690738535345433,7689,0,3893,0,0.4406714112894209,0,60980,0,46857,8377,0,116214,14123,0.05808223398021103,241357,122226,
29,0.0,0,3,26,32,27495,11488,391078,0.008758306422504268,119131,789,0.0364935219113182,3799,38125,34232,6932,79289,16076,0.01690738535345433,7689,0,3893,0,0.4406714112894209,0,60980,0,46857,8377,0,116214,14123,0.05808223398021103,241357,122226,
29,0.0,0,3,26,32,27495,11488,391078,0.008758306422504268,119131,789,0.0364935219113182,3799,38125,34232,6932,79289,16076,0.01690738535345433,7689,0,3893,0,0.4406714112894209,0,60980,0,46857,8377,0,116214,14123,0.05808223398021103,241357,122226,
29,0.0,0,3,26,32,27495,11488,391078,0.008758306422504268,119131,789,0.0364935219113182,3799,38125,34232,6932,79289,16076,0.01690738535345433,7689,0,3893,0,0.4406714112894209,0,60980,0,46857,8377,0,116214,14123,0.05808223398021103,241357,122226,
29,0.0,0,3,26,32,27495,11488,391078,0.008758306422504268,119131,789,0.0364935219113182,3799,38125,34232,6932,79289,16076,0.01690738535345433,7689,0,3893,0,0.4406714112894209,0,60980,0,46857,8377,0,116214,14123,0.05808223398021103,241357,122226,
29,0.0,0,3,26,32,27495,11488,391078,0.008758306422504268,119131,789,0.0364935219113182,3799,38125,34232,6932,79289,16076,0.01690738535345433,7689,0,3893,0,0.4406714112894209,0,60980,0,46857,8377,0,116214,14123,0.05808223398021103,241357,122226,
29,0.0,0,3,26,32,27495,11488,391078,0.008758306422504268,119131,789,0.0364935219113182,3799,38125,34232,6932,79289,16076,0.01690738535345433,7689,0,3893,0,0.4406714112894209,0,60980,0,46857,8377,0,116214,14123,0.05808223398021103,241357,122226,
29,0.0,0,3,26,32,27495,11488,391078,0.008758306422504268,119131,789,0.0364935219113182,3799,38125,34232,6932,79289,16076,0.01690738535345433,7689,0,3893,0,0.4406714112894209,0,60980,0,46857,8377,0,116214,14123,0.05808223398021103,241357,122226,
29,0.0,0,3,26,32,27495,11488,391078,0.008758306422504268,119131,789,0.0364935219113182,3799,38125,34232,6932,79289,16076,0.01690738535345433,7689,0,3893,0,0.4406714112894209,0,60980,0,46857,8377,0,116214,14123,0.05808223398021103,241357,122226,
29,0.0,0,3,26,32,27495,11488,391078,0.008758306422504268,119131,789,0.0364935219113182,3799,38125,34232,6932,79289,16076,0.01690738535345433,7689,0,3893,0,0.4406714112894209,0,60980,0,46857,8377,0,116214,14123,0.05808223398021103,241357,122226,
29,0.0,0,3,26,32,27495,11488,391078,0.008758306422504268,119131,789,0.0364935219113182,3799,38125,34232,6932,79289,16076,0.01690738535345433,7689,0,3893,0,0.4406714112894209,0,60980,0,46857,8377,0,116214,14123,0.05808223398021103,241357,122226,
29,0.0,0,3,26,32,27495,11488,391078,0.008758306422504268,119131,789,0.0364935219113182,3799,38125,34232,6932,79289,16076,0.01690738535345433,7689,0,3893,0,0.4406714112894209,0,60980,0,46857,8377,0,116214,14123,0.05808223398021103,241357,122226,
29,0.0,0,3,26,32,27495,11488,391078,0.008758306422504268,119131,789,0.0364935219113182,3799,38125,34232,6932,79289,16076,0.01690738535345433,7689,0,3893,0,0.4406714112894209,0,60980,0,46857,8377,0,116214,14123,0.05808223398021103,241357,122226,
29,0.0,0,3,26,32,27495,11488,391078,0.008758306422504268,119131,789,0.0364935219113182,3799,38125,34232,6932,79289,16076,0.01690738535345433,7689,0,3893,0,0.4406714112894209,0,60980,0,46857,8377,0,116214,14123,0.05808223398021103,241357,122226,
29,0.0,0,3,26,32,27495,11488,391078,0.008758306422504268,119131,789,0.0364935219113182,3799,38125,34232,6932,79289,16076,0.01690738535345433,7689,0,3893,0,0.4406714112894209,0,60980,0,46857,8377,0,116214,14123,0.05808223398021103,241357,122226,
29,0.0,0,3,26,32,27495,11488,391078,0.008758306422504268,119131,789,0.0364935219113182,3799,38125,34232,6932,79289,16076,0.01690738535345433,7689,0,3893,0,0.4406714112894209,0,60980,0,46857,8377,0,116214,14123,0.05808223398021103,241357,122226,
29,0.0,0,3,26,32,27495,11488,391078,0.008758306422504268,119131,789,0.0364935219113182,3799,38125,34232,6932,79289,16076,0.01690738535345433,7689,0,3893,0,0.4406714112894209,0,60980,0,46857,8377,0,116214,14123,0.05808223398021103,241357,122226,
29,0.0,0,3,26,32,27495,11488,391078,0.008758306422504268,119131,789,0.0364935219113182,3799,38125,34232,6932,79289,16076,0.01690738535345433,7689,0,3893,0,0.4406714112894209,0,60980,0,46857,8377,0,116214,14123,0.05808223398021103,241357,122226,
29,0.0,0,3,26,32,27495,11488,391078,0.008758306422504268,119131,789,0.0364935219113182,3799,38125,34232,6932,79289,16076,0.01690738535345433,7689,0,3893,0,0.4406714112894209,0,60980,0,46857,8377,0,116214,14123,0.05808223398021103,241357,122226,
29,0.0,0,3,26,32,27495,11488,391078,0.008758306422504268,119131,789,0.0364935219113182,3799,38125,34232,6932,79289,16076,0.01690738535345433,7689,0,3893,0,0.4406714112894209,0,60980,0,46857,8377,0,116214,14123,0.05808223398021103,241357,122226,
29,0.0,0,3,26,32,27495,11488,391078,0.008758306422504268,119131,789,0.0364935219113182,3799,38125,34232,6932,79289,16076,0.01690738535345433,7689,0,3893,0,0.4406714112894209,0,60980,0,46857,8377,0,116214,14123,0.05808223398021103,241357,122226,
29,0.0,0,3,26,32,27495,11488,391078,0.008758306422504268,119131,789,0.0364935219113182,3799,38125,34232,6932,79289,16076,0.01690738535345433,7689,0,3893,0,0.4406714112894209,0,60980,0,46857,8377,0,116214,14123,0.05808223398021103,241357,122226,
29,0.0,0,3,26,32,27495,11488,391078,0.008758306422504268,119131,789,0.0364935219113182,3799,38125,34232,6932,79289,16076,0.01690738535345433,7689,0,3893,0,0.4406714112894209,0,60980,0,46857,8377,0,116214,14123,0.05808223398021103,241357,122226,
29,0.0,0,3,26,32,27495,11488,391078,0.008758306422504268,119131,789,0.0364935219113182,3799,38125,34232,6932,79289,16076,0.01690738535345433,7689,0,3893,0,0.4406714112894209,0,60980,0,46857,8377,0,116214,14123,0.05808223398021103,241357,122226,
29,0.0,0,3,26,32,27495,11488,391078,0.008758306422504268,119131,789,0.0364935219113182,3799,38125,34232,6932,79289,16076,0.01690738535345433,7689,0,3893,0,0.4406714112894209,0,60980,0,46857,8377,0,116214,14123,0.05808223398021103,241357,122226,
29,0.0,0,3,26,32,27495,11488,391078,0.008758306422504268,119131,789,0.0364935219113182,3799,38125,34232,6932,79289,16076,0.01690738535345433,7689,0,3893,0,0.4406714112894209,0,60980,0,46857,8377,0,116214,14123,0.05808223398021103,241357,122226,
29,0.0,0,3,26,32,27495,11488,391078,0.008758306422504268,119131,789,0.0364935219113182,3799,38125,34232,6932,79289,16076,0.01690738535345433,7689,0,3893,0,0.4406714112894209,0,60980,0,46857,8377,0,116214,14123,0.05808223398021103,241357,122226,
29,0.0,0,3,26,32,27495,11488,391078,0.008758306422504268,119131,789,0.0364935219113182,3799,38125,34232,6932,79289,16076,0.01690738535345433,7689,0,3893,0,0.4406714112894209,0,60980,0,46857,8377,0,116214,14123,0.05808223398021103,241357,122226,
29,0.0,0,3,26,32,27495,11488,391078,0.008758306422504268,119131,789,0.0364935219113182,3799,38125,34232,6932,79289,16076,0.01690738535345433,7689,0,3893,0,0.4406714112894209,0,60980,0,46857,8377,0,116214,14123,0.05808223398021103,241357,122226,
29,0.0,0,3,26,32,27495,11488,391078,0.008758306422504268,119131,789,0.0364935219113182,3799,38125,34232,6932,79289,16076,0.01690738535345433,7689,0,3893,0,0.4406714112894209,0,60980,0,46857,8377,0,116214,14123,0.05808223398021103,241357,122226,
29,0.0,0,3,26,32,27495,11488,391078,0.008758306422504268,119131,789,0.0364935219113182,3799,38125,34232,6932,79289,16076,0.01690738535345433,7689,0,3893,0,0.4406714112894209,0,60980,0,46857,8377,0,116214,14123,0.05808223398021103,241357,122226,
29,0.0,0,3,26,32,27495,11488,391078,0.008758306422504268,119131,789,0.0364935219113182,3799,38125,34232,6932,79289,16076,0.01690738535345433,7689,0,3893,0,0.4406714112894209,0,60980,0,46857,8377,0,116214,14123,0.05808223398021103,241357,122226,
29,0.0,0,3,26,32,27495,11488,391078,0.008758306422504268,119131,789,0.0364935219113182,3799,38125,34232,6932,79289,16076,0.01690738535345433,7689,0,3893,0,0.4406714112894209,0,60980,0,46857,8377,0,116214,14123,0.05808223398021103,241357,122226,
29,0.0,0,3,26,32,27495,11488,391078,0.008758306422504268,119131,789,0.0364935219113182,3799,38125,34232,6932,79289,16076,0.01690738535345433,7689,0,3893,0,0.4406714112894209,0,60980,0,46857,8377,0,116214,14123,0.05808223398021103,241357,122226,
29,0.0,0,3,26,32,27495,11488,391078,0.008758306422504268,119131,789,0.0364935219113182,3799,38125,34232,6932,79289,16076,0.01690738535345433,7689,0,3893,0,0.4406714112894209,0,60980,0,46857,8377,0,116214,14123,0.05808223398021103,241357,122226,
29,0.0,0,3,26,32,27495,11488,391078,0.008758306422504268,119131,789,0.0364935219113182,3799,38125,34232,6932,79289,16076,0.01690738535345433,7689,0,3893,0,0.4406714112894209,0,60980,0,46857,8377,0,116214,14123,0.05808223398021103,241357,122226,
29,0.0,0,3,26,32,27495,11488,391078,0.008758306422504268,119131,789,0.0364935219113182,3799,38125,34232,6932,79289,16076,0.01690738535345433,7689,0,3893,0,0.4406714112894209,0,60980,0,46857,8377,0,116214,14123,0.05808223398021103,241357,122226,
29,0.0,0,3,26,32,27495,11488,391078,0.008758306422504268,119131,789,0.0364935219113182,3799,38125,34232,6932,79289,16076,0.01690738535345433,7689,0,3893,0,0.4406714112894209,0,60980,0,46857,8377,0,116214,14123,0.05808223398021103,241357,122226,
29,0.0,0,3,26,32,27495,11488,391078,0.008758306422504268,119131,789,0.0364935219113182,3799,38125,34232,6932,79289,16076,0.01690738535345433,7689,0,3893,0,0.4406714112894209,0,60980,0,46857,8377,0,116214,14123,0.05808223398021103,241357,122226,
29,0.0,0,3,26,32,27495,11488,391078,0.008758306422504268,119131,789,0.0364935219113182,3799,38125,34232,6932,79289,16076,0.01690738535345433,7689,0,3893,0,0.4406714112894209,0,60980,0,46857,8377,0,116214,14123,0.05808223398021103,241357,122226,
29,0.0,0,3,26,32,27495,11488,391078,0.008758306422504268,119131,789,0.0364935219113182,3799,38125,34232,6932,79289,16076,0.01690738535345433,7689,0,3893,0,0.4406714112894209,0,60980,0,46857,8377,0,116214,14123,0.05808223398021103,241357,122226,
29,0.0,0,3,26,32,27495,11488,391078,0.008758306422504268,119131,789,0.0364935219113182,3799,38125,34232,6932,79289,16076,0.01690738535345433,7689,0,3893,0,0.4406714112894209,0,60980,0,46857,8377,0,116214,14123,0.05808223398021103,241357,122226,
29,0.0,0,3,26,32,27495,11488,391078,0.008758306422504268,119131,789,0.0364935219113182,3799,38125,34232,6932,79289,16076,0.01690738535345433,7689,0,3893,0,0.4406714112894209,0,60980,0,46857,8377,0,116214,14123,0.05808223398021103,241357,122226,
29,0.0,0,3,26,32,27495,11488,391078,0.008758306422504268,119131,789,0.0364935219113182,3799,38125,34232,6932,79289,16076,0.01690738535345433,7689,0,3893,0,0.4406714112894209,0,60980,0,46857,8377,0,116214,14123,0.05808223398021103,241357,122226,
29,0.0,0,3,26,32,27495,11488,391078,0.008758306422504268,119131,789,0.0364935219113182,3799,38125,34232,6932,79289,16076,0.01690738535345433,7689,0,3893,0,0.4406714112894209,0,60980,0,46857,8377,0,116214,14123,0.05808223398021103,241357,122226,
29,0.0,0,3,26,32,27495,11488,391078,0.008758306422504268,119131,789,0.0364935219113182,3799,38125,34232,6932,79289,16076,0.01690738535345433,7689,0,3893,0,0.4406714112894209,0,60980,0,46857,8377,0,116214,14123,0.05808223398021103,241357,122226,
29,0.0,0,3,26,32,27495,11488,391078,0.008758306422504268,119131,789,0.0364935219113182,3799,38125,34232,6932,79289,16076,0.01690738535345433,7689,0,3893,0,0.4406714112894209,0,60980,0,46857,8377,0,116214,14123,0.05808223398021103,241357,122226,
29,0.0,0,3,26,32,27495,11488,391078,0.008758306422504268,119131,789,0.0364935219113182,3799,38125,34232,6932,79289,16076,0.01690738535345433,7689,0,3893,0,0.4406714112894209,0,60980,0,46857,8377,0,116214,14123,0.05808223398021103,241357,122226,
29,0.0,0,3,26,32,27495,11488,391078,0.008758306422504268,119131,789,0.0364935219113182,3799,38125,34232,6932,79289,16076,0.01690738535345433,7689,0,3893,0,0.4406714112894209,0,60980,0,46857,8377,0,116214,14123,0.05808223398021103,241357,122226,
29,0.0,0,3,26,32,27495,11488,391078,0.008758306422504268,119131,789,0.0364935219113182,3799,38125,34232,6932,79289,16076,0.01690738535345433,7689,0,3893,0,0.4406714112894209,0,60980,0,46857,8377,0,116214,14123,0.05808223398021103,241357,122226,
29,0.0,0,3,26,32,27495,11488,391078,0.008758306422504268,119131,789,0.0364935219113182,3799,38125,34232,6932,79289,16076,0.01690738535345433,7689,0,3893,0,0.4406714112894209,0,60980,0,46857,8377,0,116214,14123,0.05808223398021103,241357,122226,
29,0.0,0,3,26,32,27495,11488,391078,0.008758306422504268,119131,789,0.0364935219113182,3799,38125,34232,6932,79289,16076,0.01690738535345433,7689,0,3893,0,0.4406714112894209,0,60980,0,46857,8377,0,116214,14123,0.05808223398021103,241357,122226,
29,0.0,0,3,26,32,27495,11488,391078,0.008758306422504268,119131,789,0.0364935219113182,3799,38125,34232,6932,79289,16076,0.01690738535345433,7689,0,3893,0,0.4406714112894209,0,60980,0,46857,8377,0,116214,14123,0.05808223398021103,241357,122226,
29,0.0,0,3,26,32,27495,11488,391078,0.008758306422504268,119131,789,0.0364935219113182,3799,38125,34232,6932,79289,16076,0.01690738535345433,7689,0,3893,0,0.4406714112894209,0,60980,0,46857,8377,0,116214,14123,0.05808223398021103,241357,122226,
29,0.0,0,3,26,32,27495,11488,391078,0.008758306422504268,119131,789,0.0364935219113182,3799,38125,34232,6932,79289,16076,0.01690738535345433,7689,0,3893,0,0.4406714112894209,0,60980,0,46857,8377,0,116214,14123,0.05808223398021103,241357,122226,
29,0.0,0,3,26,32,27495,11488,391078,0.008758306422504268,119131,789,0.0364935219113182,3799,38125,34232,6932,79289,16076,0.01690738535345433,7689,0,3893,0,0.4406714112894209,0,60980,0,46857,8377,0,116214,14123,0.05808223398021103,241357,122226,
29,0.0,0,3,26,32,27495,11488,391078,0.008758306422504268,119131,789,0.0364935219113182,3799,38125,34232,6932,79289,16076,0.01690738535345433,7689,0,3893,0,0.4406714112894209,0,60980,0,46857,8377,0,116214,14123,0.05808223398021103,241357,122226,
29,0.0,0,3,26,32,27495,11488,391078,0.008758306422504268,119131,789,0.0364935219113182,3799,38125,34232,6932,79289,16076,0.01690738535345433,7689,0,3893,0,0.4406714112894209,0,60980,0,46857,8377,0,116214,14123,0.05808223398021103,241357,122226,
29,0.0,0,3,26,32,27495,11488,391078,0.008758306422504268,119131,789,0.0364935219113182,3799,38125,34232,6932,79289,16076,0.01690738535345433,7689,0,3893,0,0.4406714112894209,0,60980,0,46857,8377,0,116214,14123,0.05808223398021103,241357,122226,
29,0.0,0,3,26,32,27495,11488,391078,0.008758306422504268,119131,789,0.0364935219113182,3799,38125,34232,6932,79289,16076,0.01690738535345433,7689,0,3893,0,0.4406714112894209,0,60980,0,46857,8377,0,116214,14123,0.05808223398021103,241357,122226,
29,0.0,0,3,26,32,27495,11488,391078,0.008758306422504268,119131,789,0.0364935219113182,3799,38125,34232,6932,79289,16076,0.01690738535345433,7689,0,3893,0,0.4406714112894209,0,60980,0,46857,8377,0,116214,14123,0.05808223398021103,241357,122226,
29,0.0,0,3,26,32,27495,11488,391078,0.008758306422504268,119131,789,0.0364935219113182,3799,38125,34232,6932,79289,16076,0.01690738535345433,7689,0,3893,0,0.4406714112894209,0,60980,0,46857,8377,0,116214,14123,0.05808223398021103,241357,122226,
29,0.0,0,3,26,32,27495,11488,391078,0.008758306422504268,119131,789,0.0364935219113182,3799,38125,34232,6932,79289,16076,0.01690738535345433,7689,0,3893,0,0.4406714112894209,0,60980,0,46857,8377,0,116214,14123,0.05808223398021103,241357,122226,
29,0.0,0,3,26,32,27495,11488,391078,0.008758306422504268,119131,789,0.0364935219113182,3799,38125,34232,6932,79289,16076,0.01690738535345433,7689,0,3893,0,0.4406714112894209,0,60980,0,46857,8377,0,116214,14123,0.05808223398021103,241357,122226,
29,0.0,0,3,26,32,27495,11488,391078,0.008758306422504268,119131,789,0.0364935219113182,3799,38125,34232,6932,79289,16076,0.01690738535345433,7689,0,3893,0,0.4406714112894209,0,60980,0,46857,8377,0,116214,14123,0.05808223398021103,241357,122226,
29,0.0,0,3,26,32,27495,11488,391078,0.008758306422504268,119131,789,0.0364935219113182,3799,38125,34232,6932,79289,16076,0.01690738535345433,7689,0,3893,0,0.4406714112894209,0,60980,0,46857,8377,0,116214,14123,0.05808223398021103,241357,122226,
29,0.0,0,3,26,32,27495,11488,391078,0.008758306422504268,119131,789,0.0364935219113182,3799,38125,34232,6932,79289,16076,0.01690738535345433,7689,0,3893,0,0.4406714112894209,0,60980,0,46857,8377,0,116214,14123,0.05808223398021103,241357,122226,
29,0.0,0,3,26,32,27495,11488,391078,0.008758306422504268,119131,789,0.0364935219113182,3799,38125,34232,6932,79289,16076,0.01690738535345433,7689,0,3893,0,0.4406714112894209,0,60980,0,46857,8377,0,116214,14123,0.05808223398021103,241357,122226,
29,0.0,0,3,26,32,27495,11488,391078,0.008758306422504268,119131,789,0.0364935219113182,3799,38125,34232,6932,79289,16076,0.01690738535345433,7689,0,3893,0,0.4406714112894209,0,60980,0,46857,8377,0,116214,14123,0.05808223398021103,241357,122226,
29,0.0,0,3,26,32,27495,11488,391078,0.008758306422504268,119131,789,0.0364935219113182,3799,38125,34232,6932,79289,16076,0.01690738535345433,7689,0,3893,0,0.4406714112894209,0,60980,0,46857,8377,0,116214,14123,0.05808223398021103,241357,122226,
29,0.0,0,3,26,32,27495,11488,391078,0.008758306422504268,119131,789,0.0364935219113182,3799,38125,34232,6932,79289,16076,0.01690738535345433,7689,0,3893,0,0.4406714112894209,0,60980,0,46857,8377,0,116214,14123,0.05808223398021103,241357,122226,
29,0.0,0,3,26,32,27495,11488,391078,0.008758306422504268,119131,789,0.0364935219113182,3799,38125,34232,6932,79289,16076,0.01690738535345433,7689,0,3893,0,0.4406714112894209,0,60980,0,46857,8377,0,116214,14123,0.05808223398021103,241357,122226,
29,0.0,0,3,26,32,27495,11488,391078,0.008758306422504268,119131,789,0.0364935219113182,3799,38125,34232,6932,79289,16076,0.01690738535345433,7689,0,3893,0,0.4406714112894209,0,60980,0,46857,8377,0,116214,14123,0.05808223398021103,241357,122226,
29,0.0,0,3,26,32,27495,11488,391078,0.008758306422504268,119131,789,0.0364935219113182,3799,38125,34232,6932,79289,16076,0.01690738535345433,7689,0,3893,0,0.4406714112894209,0,60980,0,46857,8377,0,116214,14123,0.05808223398021103,241357,122226,
29,0.0,0,3,26,32,27495,11488,391078,0.008758306422504268,119131,789,0.0364935219113182,3799,38125,34232,6932,79289,16076,0.01690738535345433,7689,0,3893,0,0.4406714112894209,0,60980,0,46857,8377,0,116214,14123,0.05808223398021103,241357,122226,
29,0.0,0,3,26,32,27495,11488,391078,0.008758306422504268,119131,789,0.0364935219113182,3799,38125,34232,6932,79289,16076,0.01690738535345433,7689,0,3893,0,0.4406714112894209,0,60980,0,46857,8377,0,116214,14123,0.05808223398021103,241357,122226,
29,0.0,0,3,26,32,27495,11488,391078,0.008758306422504268,119131,789,0.0364935219113182,3799,38125,34232,6932,79289,16076,0.01690738535345433,7689,0,3893,0,0.4406714112894209,0,60980,0,46857,8377,0,116214,14123,0.05808223398021103,241357,122226,
29,0.0,0,3,26,32,27495,11488,391078,0.008758306422504268,119131,789,0.0364935219113182,3799,38125,34232,6932,79289,16076,0.01690738535345433,7689,0,3893,0,0.4406714112894209,0,60980,0,46857,8377,0,116214,14123,0.05808223398021103,241357,122226,
29,0.0,0,3,26,32,27495,11488,391078,0.008758306422504268,119131,789,0.0364935219113182,3799,38125,34232,6932,79289,16076,0.01690738535345433,7689,0,3893,0,0.4406714112894209,0,60980,0,46857,8377,0,116214,14123,0.05808223398021103,241357,122226,
29,0.0,0,3,26,32,27495,11488,391078,0.008758306422504268,119131,789,0.0364935219113182,3799,38125,34232,6932,79289,16076,0.01690738535345433,7689,0,3893,0,0.4406714112894209,0,60980,0,46857,8377,0,116214,14123,0.05808223398021103,241357,122226,
29,0.0,0,3,26,32,27495,11488,391078,0.008758306422504268,119131,789,0.0364935219113182,3799,38125,34232,6932,79289,16076,0.01690738535345433,7689,0,3893,0,0.4406714112894209,0,60980,0,46857,8377,0,116214,14123,0.05808223398021103,241357,122226,
29,0.0,0,3,26,32,27495,11488,391078,0.008758306422504268,119131,789,0.0364935219113182,3799,38125,34232,6932,79289,16076,0.01690738535345433,7689,0,3893,0,0.4406714112894209,0,60980,0,46857,8377,0,116214,14123,0.05808223398021103,241357,122226,
29,0.0,0,3,26,32,27495,11488,391078,0.008758306422504268,119131,789,0.0364935219113182,3799,38125,34232,6932,79289,16076,0.01690738535345433,7689,0,3893,0,0.4406714112894209,0,60980,0,46857,8377,0,116214,14123,0.05808223398021103,241357,122226,
29,0.0,0,3,26,32,27495,11488,391078,0.008758306422504268,119131,789,0.0364935219113182,3799,38125,34232,6932,79289,16076,0.01690738535345433,7689,0,3893,0,0.4406714112894209,0,60980,0,46857,8377,0,116214,14123,0.05808223398021103,241357,122226,
29,0.0,0,3,26,32,27495,11488,391078,0.008758306422504268,119131,789,0.0364935219113182,3799,38125,34232,6932,79289,16076,0.01690738535345433,7689,0,3893,0,0.4406714112894209,0,60980,0,46857,8377,0,116214,14123,0.05808223398021103,241357,122226,
29,0.0,0,3,26,32,27495,11488,391078,0.008758306422504268,119131,789,0.0364935219113182,3799,38125,34232,6932,79289,16076,0.01690738535345433,7689,0,3893,0,0.4406714112894209,0,60980,0,46857,8377,0,116214,14123,0.05808223398021103,241357,122226,
29,0.0,0,3,26,32,27495,11488,391078,0.008758306422504268,119131,789,0.0364935219113182,3799,38125,34232,6932,79289,16076,0.01690738535345433,7689,0,3893,0,0.4406714112894209,0,60980,0,46857,8377,0,116214,14123,0.05808223398021103,241357,122226,
29,0.0,0,3,26,32,27495,11488,391078,0.008758306422504268,119131,789,0.0364935219113182,3799,38125,34232,6932,79289,16076,0.01690738535345433,7689,0,3893,0,0.4406714112894209,0,60980,0,46857,8377,0,116214,14123,0.05808223398021103,241357,122226,
29,0.0,0,3,26,32,27495,11488,391078,0.008758306422504268,119131,789,0.0364935219113182,3799,38125,34232,6932,79289,16076,0.01690738535345433,7689,0,3893,0,0.4406714112894209,0,60980,0,46857,8377,0,116214,14123,0.05808223398021103,241357,122226,
29,0.0,0,3,26,32,27495,11488,391078,0.008758306422504268,119131,789,0.0364935219113182,3799,38125,34232,6932,79289,16076,0.01690738535345433,7689,0,3893,0,0.4406714112894209,0,60980,0,46857,8377,0,116214,14123,0.05808223398021103,241357,122226,
29,0.0,0,3,26,32,27495,11488,391078,0.008758306422504268,119131,789,0.0364935219113182,3799,38125,34232,6932,79289,16076,0.01690738535345433,7689,0,3893,0,0.4406714112894209,0,60980,0,46857,8377,0,116214,14123,0.05808223398021103,241357,122226,
29,0.0,0,3,26,32,27495,11488,391078,0.008758306422504268,119131,789,0.0364935219113182,3799,38125,34232,6932,79289,16076,0.01690738535345433,7689,0,3893,0,0.4406714112894209,0,60980,0,46857,8377,0,116214,14123,0.05808223398021103,241357,122226,
29,0.0,0,3,26,32,27495,11488,391078,0.008758306422504268,119131,789,0.0364935219113182,3799,38125,34232,6932,79289,16076,0.01690738535345433,7689,0,3893,0,0.4406714112894209,0,60980,0,46857,8377,0,116214,14123,0.05808223398021103,241357,122226,
29,0.0,0,3,26,32,27495,11488,391078,0.008758306422504268,119131,789,0.0364935219113182,3799,38125,34232,6932,79289,16076,0.01690738535345433,7689,0,3893,0,0.4406714112894209,0,60980,0,46857,8377,0,116214,14123,0.05808223398021103,241357,122226,
29,0.0,0,3,26,32,27495,11488,391078,0.008758306422504268,119131,789,0.0364935219113182,3799,38125,34232,6932,79289,16076,0.01690738535345433,7689,0,3893,0,0.4406714112894209,0,60980,0,46857,8377,0,116214,14123,0.05808223398021103,241357,122226,
29,0.0,0,3,26,32,27495,11488,391078,0.008758306422504268,119131,789,0.0364935219113182,3799,38125,34232,6932,79289,16076,0.01690738535345433,7689,0,3893,0,0.4406714112894209,0,60980,0,46857,8377,0,116214,14123,0.05808223398021103,241357,122226,
29,0.0,0,3,26,32,27495,11488,391078,0.008758306422504268,119131,789,0.0364935219113182,3799,38125,34232,6932,79289,16076,0.01690738535345433,7689,0,3893,0,0.4406714112894209,0,60980,0,46857,8377,0,116214,14123,0.05808223398021103,241357,122226,
29,0.0,0,3,26,32,27495,11488,391078,0.008758306422504268,119131,789,0.0364935219113182,3799,38125,34232,6932,79289,16076,0.01690738535345433,7689,0,3893,0,0.4406714112894209,0,60980,0,46857,8377,0,116214,14123,0.05808223398021103,241357,122226,
29,0.0,0,3,26,32,27495,11488,391078,0.008758306422504268,119131,789,0.0364935219113182,3799,38125,34232,6932,79289,16076,0.01690738535345433,7689,0,3893,0,0.4406714112894209,0,60980,0,46857,8377,0,116214,14123,0.05808223398021103,241357,122226,
29,0.0,0,3,26,32,27495,11488,391078,0.008758306422504268,119131,789,0.0364935219113182,3799,38125,34232,6932,79289,16076,0.01690738535345433,7689,0,3893,0,0.4406714112894209,0,60980,0,46857,8377,0,116214,14123,0.05808223398021103,241357,122226,
29,0.0,0,3,26,32,27495,11488,391078,0.008758306422504268,119131,789,0.0364935219113182,3799,38125,34232,6932,79289,16076,0.01690738535345433,7689,0,3893,0,0.4406714112894209,0,60980,0,46857,8377,0,116214,14123,0.05808223398021103,241357,122226,
29,0.0,0,3,26,32,27495,11488,391078,0.008758306422504268,119131,789,0.0364935219113182,3799,38125,34232,6932,79289,16076,0.01690738535345433,7689,0,3893,0,0.4406714112894209,0,60980,0,46857,8377,0,116214,14123,0.05808223398021103,241357,122226,
29,0.0,0,3,26,32,27495,11488,391078,0.008758306422504268,119131,789,0.0364935219113182,3799,38125,34232,6932,79289,16076,0.01690738535345433,7689,0,3893,0,0.4406714112894209,0,60980,0,46857,8377,0,116214,14123,0.05808223398021103,241357,122226,
29,0.0,0,3,26,32,27495,11488,391078,0.008758306422504268,119131,789,0.0364935219113182,3799,38125,34232,6932,79289,16076,0.01690738535345433,7689,0,3893,0,0.4406714112894209,0,60980,0,46857,8377,0,116214,14123,0.05808223398021103,241357,122226,
29,0.0,0,3,26,32,27495,11488,391078,0.008758306422504268,119131,789,0.0364935219113182,3799,38125,34232,6932,79289,16076,0.01690738535345433,7689,0,3893,0,0.4406714112894209,0,60980,0,46857,8377,0,116214,14123,0.05808223398021103,241357,122226,
29,0.0,0,3,26,32,27495,11488,391078,0.008758306422504268,119131,789,0.0364935219113182,3799,38125,34232,6932,79289,16076,0.01690738535345433,7689,0,3893,0,0.4406714112894209,0,60980,0,46857,8377,0,116214,14123,0.05808223398021103,241357,122226,
29,0.0,0,3,26,32,27495,11488,391078,0.008758306422504268,119131,789,0.0364935219113182,3799,38125,34232,6932,79289,16076,0.01690738535345433,7689,0,3893,0,0.4406714112894209,0,60980,0,46857,8377,0,116214,14123,0.05808223398021103,241357,122226,
29,0.0,0,3,26,32,27495,11488,391078,0.008758306422504268,119131,789,0.0364935219113182,3799,38125,34232,6932,79289,16076,0.01690738535345433,7689,0,3893,0,0.4406714112894209,0,60980,0,46857,8377,0,116214,14123,0.05808223398021103,241357,122226,
29,0.0,0,3,26,32,27495,11488,391078,0.008758306422504268,119131,789,0.0364935219113182,3799,38125,34232,6932,79289,16076,0.01690738535345433,7689,0,3893,0,0.4406714112894209,0,60980,0,46857,8377,0,116214,14123,0.05808223398021103,241357,122226,
29,0.0,0,3,26,32,27495,11488,391078,0.008758306422504268,119131,789,0.0364935219113182,3799,38125,34232,6932,79289,16076,0.01690738535345433,7689,0,3893,0,0.4406714112894209,0,60980,0,46857,8377,0,116214,14123,0.05808223398021103,241357,122226,
29,0.0,0,3,26,32,27495,11488,391078,0.008758306422504268,119131,789,0.0364935219113182,3799,38125,34232,6932,79289,16076,0.01690738535345433,7689,0,3893,0,0.4406714112894209,0,60980,0,46857,8377,0,116214,14123,0.05808223398021103,241357,122226,
29,0.0,0,3,26,32,27495,11488,391078,0.008758306422504268,119131,789,0.0364935219113182,3799,38125,34232,6932,79289,16076,0.01690738535345433,7689,0,3893,0,0.4406714112894209,0,60980,0,46857,8377,0,116214,14123,0.05808223398021103,241357,122226,
29,0.0,0,3,26,32,27495,11488,391078,0.008758306422504268,119131,789,0.0364935219113182,3799,38125,34232,6932,79289,16076,0.01690738535345433,7689,0,3893,0,0.4406714112894209,0,60980,0,46857,8377,0,116214,14123,0.05808223398021103,241357,122226,
29,0.0,0,3,26,32,27495,11488,391078,0.008758306422504268,119131,789,0.0364935219113182,3799,38125,34232,6932,79289,16076,0.01690738535345433,7689,0,3893,0,0.4406714112894209,0,60980,0,46857,8377,0,116214,14123,0.05808223398021103,241357,122226,
29,0.0,0,3,26,32,27495,11488,391078,0.008758306422504268,119131,789,0.0364935219113182,3799,38125,34232,6932,79289,16076,0.01690738535345433,7689,0,3893,0,0.4406714112894209,0,60980,0,46857,8377,0,116214,14123,0.05808223398021103,241357,122226,
29,0.0,0,3,26,32,27495,11488,391078,0.008758306422504268,119131,789,0.0364935219113182,3799,38125,34232,6932,79289,16076,0.01690738535345433,7689,0,3893,0,0.4406714112894209,0,60980,0,46857,8377,0,116214,14123,0.05808223398021103,241357,122226,
29,0.0,0,3,26,32,27495,11488,391078,0.008758306422504268,119131,789,0.0364935219113182,3799,38125,34232,6932,79289,16076,0.01690738535345433,7689,0,3893,0,0.4406714112894209,0,60980,0,46857,8377,0,116214,14123,0.05808223398021103,241357,122226,
29,0.0,0,3,26,32,27495,11488,391078,0.008758306422504268,119131,789,0.0364935219113182,3799,38125,34232,6932,79289,16076,0.01690738535345433,7689,0,3893,0,0.4406714112894209,0,60980,0,46857,8377,0,116214,14123,0.05808223398021103,241357,122226,
29,0.0,0,3,26,32,27495,11488,391078,0.008758306422504268,119131,789,0.0364935219113182,3799,38125,34232,6932,79289,16076,0.01690738535345433,7689,0,3893,0,0.4406714112894209,0,60980,0,46857,8377,0,116214,14123,0.05808223398021103,241357,122226,
29,0.0,0,3,26,32,27495,11488,391078,0.008758306422504268,119131,789,0.0364935219113182,3799,38125,34232,6932,79289,16076,0.01690738535345433,7689,0,3893,0,0.4406714112894209,0,60980,0,46857,8377,0,116214,14123,0.05808223398021103,241357,122226,
29,0.0,0,3,26,32,27495,11488,391078,0.008758306422504268,119131,789,0.0364935219113182,3799,38125,34232,6932,79289,16076,0.01690738535345433,7689,0,3893,0,0.4406714112894209,0,60980,0,46857,8377,0,116214,14123,0.05808223398021103,241357,122226,
29,0.0,0,3,26,32,27495,11488,391078,0.008758306422504268,119131,789,0.0364935219113182,3799,38125,34232,6932,79289,16076,0.01690738535345433,7689,0,3893,0,0.4406714112894209,0,60980,0,46857,8377,0,116214,14123,0.05808223398021103,241357,122226,
29,0.0,0,3,26,32,27495,11488,391078,0.008758306422504268,119131,789,0.0364935219113182,3799,38125,34232,6932,79289,16076,0.01690738535345433,7689,0,3893,0,0.4406714112894209,0,60980,0,46857,8377,0,116214,14123,0.05808223398021103,241357,122226,
29,0.0,0,3,26,32,27495,11488,391078,0.008758306422504268,119131,789,0.0364935219113182,3799,38125,34232,6932,79289,16076,0.01690738535345433,7689,0,3893,0,0.4406714112894209,0,60980,0,46857,8377,0,116214,14123,0.05808223398021103,241357,122226,
29,0.0,0,3,26,32,27495,11488,391078,0.008758306422504268,119131,789,0.0364935219113182,3799,38125,34232,6932,79289,16076,0.01690738535345433,7689,0,3893,0,0.4406714112894209,0,60980,0,46857,8377,0,116214,14123,0.05808223398021103,241357,122226,
29,0.0,0,3,26,32,27495,11488,391078,0.008758306422504268,119131,789,0.0364935219113182,3799,38125,34232,6932,79289,16076,0.01690738535345433,7689,0,3893,0,0.4406714112894209,0,60980,0,46857,8377,0,116214,14123,0.05808223398021103,241357,122226,
29,0.0,0,3,26,32,27495,11488,391078,0.008758306422504268,119131,789,0.0364935219113182,3799,38125,34232,6932,79289,16076,0.01690738535345433,7689,0,3893,0,0.4406714112894209,0,60980,0,46857,8377,0,116214,14123,0.05808223398021103,241357,122226,
29,0.0,0,3,26,32,27495,11488,391078,0.008758306422504268,119131,789,0.0364935219113182,3799,38125,34232,6932,79289,16076,0.01690738535345433,7689,0,3893,0,0.4406714112894209,0,60980,0,46857,8377,0,116214,14123,0.05808223398021103,241357,122226,
29,0.0,0,3,26,32,27495,11488,391078,0.008758306422504268,119131,789,0.0364935219113182,3799,38125,34232,6932,79289,16076,0.01690738535345433,7689,0,3893,0,0.4406714112894209,0,60980,0,46857,8377,0,116214,14123,0.05808223398021103,241357,122226,
29,0.0,0,3,26,32,27495,11488,391078,0.008758306422504268,119131,789,0.0364935219113182,3799,38125,34232,6932,79289,16076,0.01690738535345433,7689,0,3893,0,0.4406714112894209,0,60980,0,46857,8377,0,116214,14123,0.05808223398021103,241357,122226,
29,0.0,0,3,26,32,27495,11488,391078,0.008758306422504268,119131,789,0.0364935219113182,3799,38125,34232,6932,79289,16076,0.01690738535345433,7689,0,3893,0,0.4406714112894209,0,60980,0,46857,8377,0,116214,14123,0.05808223398021103,241357,122226,
29,0.0,0,3,26,32,27495,11488,391078,0.008758306422504268,119131,789,0.0364935219113182,3799,38125,34232,6932,79289,16076,0.01690738535345433,7689,0,3893,0,0.4406714112894209,0,60980,0,46857,8377,0,116214,14123,0.05808223398021103,241357,122226,
29,0.0,0,3,26,32,27495,11488,391078,0.008758306422504268,119131,789,0.0364935219113182,3799,38125,34232,6932,79289,16076,0.01690738535345433,7689,0,3893,0,0.4406714112894209,0,60980,0,46857,8377,0,116214,14123,0.05808223398021103,241357,122226,
29,0.0,0,3,26,32,27495,11488,391078,0.008758306422504268,119131,789,0.0364935219113182,3799,38125,34232,6932,79289,16076,0.01690738535345433,7689,0,3893,0,0.4406714112894209,0,60980,0,46857,8377,0,116214,14123,0.05808223398021103,241357,122226,
29,0.0,0,3,26,32,27495,11488,391078,0.008758306422504268,119131,789,0.0364935219113182,3799,38125,34232,6932,79289,16076,0.01690738535345433,7689,0,3893,0,0.4406714112894209,0,60980,0,46857,8377,0,116214,14123,0.05808223398021103,241357,122226,
29,0.0,0,3,26,32,27495,11488,391078,0.008758306422504268,119131,789,0.0364935219113182,3799,38125,34232,6932,79289,16076,0.01690738535345433,7689,0,3893,0,0.4406714112894209,0,60980,0,46857,8377,0,116214,14123,0.05808223398021103,241357,122226,
29,0.0,0,3,26,32,27495,11488,391078,0.008758306422504268,119131,789,0.0364935219113182,3799,38125,34232,6932,79289,16076,0.01690738535345433,7689,0,3893,0,0.4406714112894209,0,60980,0,46857,8377,0,116214,14123,0.05808223398021103,241357,122226,
29,0.0,0,3,26,32,27495,11488,391078,0.008758306422504268,119131,789,0.0364935219113182,3799,38125,34232,6932,79289,16076,0.01690738535345433,7689,0,3893,0,0.4406714112894209,0,60980,0,46857,8377,0,116214,14123,0.05808223398021103,241357,122226,
29,0.0,0,3,26,32,27495,11488,391078,0.008758306422504268,119131,789,0.0364935219113182,3799,38125,34232,6932,79289,16076,0.01690738535345433,7689,0,3893,0,0.4406714112894209,0,60980,0,46857,8377,0,116214,14123,0.05808223398021103,241357,122226,
29,0.0,0,3,26,32,27495,11488,391078,0.008758306422504268,119131,789,0.0364935219113182,3799,38125,34232,6932,79289,16076,0.01690738535345433,7689,0,3893,0,0.4406714112894209,0,60980,0,46857,8377,0,116214,14123,0.05808223398021103,241357,122226,
29,0.0,0,3,26,32,27495,11488,391078,0.008758306422504268,119131,789,0.0364935219113182,3799,38125,34232,6932,79289,16076,0.01690738535345433,7689,0,3893,0,0.4406714112894209,0,60980,0,46857,8377,0,116214,14123,0.05808223398021103,241357,122226,
29,0.0,0,3,26,32,27495,11488,391078,0.008758306422504268,119131,789,0.0364935219113182,3799,38125,34232,6932,79289,16076,0.01690738535345433,7689,0,3893,0,0.4406714112894209,0,60980,0,46857,8377,0,116214,14123,0.05808223398021103,241357,122226,
29,0.0,0,3,26,32,27495,11488,391078,0.008758306422504268,119131,789,0.0364935219113182,3799,38125,34232,6932,79289,16076,0.01690738535345433,7689,0,3893,0,0.4406714112894209,0,60980,0,46857,8377,0,116214,14123,0.05808223398021103,241357,122226,
29,0.0,0,3,26,32,27495,11488,391078,0.008758306422504268,119131,789,0.0364935219113182,3799,38125,34232,6932,79289,16076,0.01690738535345433,7689,0,3893,0,0.4406714112894209,0,60980,0,46857,8377,0,116214,14123,0.05808223398021103,241357,122226,
29,0.0,0,3,26,32,27495,11488,391078,0.008758306422504268,119131,789,0.0364935219113182,3799,38125,34232,6932,79289,16076,0.01690738535345433,7689,0,3893,0,0.4406714112894209,0,60980,0,46857,8377,0,116214,14123,0.05808223398021103,241357,122226,
29,0.0,0,3,26,32,27495,11488,391078,0.008758306422504268,119131,789,0.0364935219113182,3799,38125,34232,6932,79289,16076,0.01690738535345433,7689,0,3893,0,0.4406714112894209,0,60980,0,46857,8377,0,116214,14123,0.05808223398021103,241357,122226,
29,0.0,0,3,26,32,27495,11488,391078,0.008758306422504268,119131,789,0.0364935219113182,3799,38125,34232,6932,79289,16076,0.01690738535345433,7689,0,3893,0,0.4406714112894209,0,60980,0,46857,8377,0,116214,14123,0.05808223398021103,241357,122226,
29,0.0,0,3,26,32,27495,11488,391078,0.008758306422504268,119131,789,0.0364935219113182,3799,38125,34232,6932,79289,16076,0.01690738535345433,7689,0,3893,0,0.4406714112894209,0,60980,0,46857,8377,0,116214,14123,0.05808223398021103,241357,122226,
29,0.0,0,3,26,32,27495,11488,391078,0.008758306422504268,119131,789,0.0364935219113182,3799,38125,34232,6932,79289,16076,0.01690738535345433,7689,0,3893,0,0.4406714112894209,0,60980,0,46857,8377,0,116214,14123,0.05808223398021103,241357,122226,
29,0.0,0,3,26,32,27495,11488,391078,0.008758306422504268,119131,789,0.0364935219113182,3799,38125,34232,6932,79289,16076,0.01690738535345433,7689,0,3893,0,0.4406714112894209,0,60980,0,46857,8377,0,116214,14123,0.05808223398021103,241357,122226,
29,0.0,0,3,26,32,27495,11488,391078,0.008758306422504268,119131,789,0.0364935219113182,3799,38125,34232,6932,79289,16076,0.01690738535345433,7689,0,3893,0,0.4406714112894209,0,60980,0,46857,8377,0,116214,14123,0.05808223398021103,241357,122226,
29,0.0,0,3,26,32,27495,11488,391078,0.008758306422504268,119131,789,0.0364935219113182,3799,38125,34232,6932,79289,16076,0.01690738535345433,7689,0,3893,0,0.4406714112894209,0,60980,0,46857,8377,0,116214,14123,0.05808223398021103,241357,122226,
29,0.0,0,3,26,32,27495,11488,391078,0.008758306422504268,119131,789,0.0364935219113182,3799,38125,34232,6932,79289,16076,0.01690738535345433,7689,0,3893,0,0.4406714112894209,0,60980,0,46857,8377,0,116214,14123,0.05808223398021103,241357,122226,
29,0.0,0,3,26,32,27495,11488,391078,0.008758306422504268,119131,789,0.0364935219113182,3799,38125,34232,6932,79289,16076,0.01690738535345433,7689,0,3893,0,0.4406714112894209,0,60980,0,46857,8377,0,116214,14123,0.05808223398021103,241357,122226,
29,0.0,0,3,26,32,27495,11488,391078,0.008758306422504268,119131,789,0.0364935219113182,3799,38125,34232,6932,79289,16076,0.01690738535345433,7689,0,3893,0,0.4406714112894209,0,60980,0,46857,8377,0,116214,14123,0.05808223398021103,241357,122226,
29,0.0,0,3,26,32,27495,11488,391078,0.008758306422504268,119131,789,0.0364935219113182,3799,38125,34232,6932,79289,16076,0.01690738535345433,7689,0,3893,0,0.4406714112894209,0,60980,0,46857,8377,0,116214,14123,0.05808223398021103,241357,122226,
29,0.0,0,3,26,32,27495,11488,391078,0.008758306422504268,119131,789,0.0364935219113182,3799,38125,34232,6932,79289,16076,0.01690738535345433,7689,0,3893,0,0.4406714112894209,0,60980,0,46857,8377,0,116214,14123,0.05808223398021103,241357,122226,
29,0.0,0,3,26,32,27495,11488,391078,0.008758306422504268,119131,789,0.0364935219113182,3799,38125,34232,6932,79289,16076,0.01690738535345433,7689,0,3893,0,0.4406714112894209,0,60980,0,46857,8377,0,116214,14123,0.05808223398021103,241357,122226,
29,0.0,0,3,26,32,27495,11488,391078,0.008758306422504268,119131,789,0.0364935219113182,3799,38125,34232,6932,79289,16076,0.01690738535345433,7689,0,3893,0,0.4406714112894209,0,60980,0,46857,8377,0,116214,14123,0.05808223398021103,241357,122226,
29,0.0,0,3,26,32,27495,11488,391078,0.008758306422504268,119131,789,0.0364935219113182,3799,38125,34232,6932,79289,16076,0.01690738535345433,7689,0,3893,0,0.4406714112894209,0,60980,0,46857,8377,0,116214,14123,0.05808223398021103,241357,122226,
29,0.0,0,3,26,32,27495,11488,391078,0.008758306422504268,119131,789,0.0364935219113182,3799,38125,34232,6932,79289,16076,0.01690738535345433,7689,0,3893,0,0.4406714112894209,0,60980,0,46857,8377,0,116214,14123,0.05808223398021103,241357,122226,
29,0.0,0,3,26,32,27495,11488,391078,0.008758306422504268,119131,789,0.0364935219113182,3799,38125,34232,6932,79289,16076,0.01690738535345433,7689,0,3893,0,0.4406714112894209,0,60980,0,46857,8377,0,116214,14123,0.05808223398021103,241357,122226,
29,0.0,0,3,26,32,27495,11488,391078,0.008758306422504268,119131,789,0.0364935219113182,3799,38125,34232,6932,79289,16076,0.01690738535345433,7689,0,3893,0,0.4406714112894209,0,60980,0,46857,8377,0,116214,14123,0.05808223398021103,241357,122226,
29,0.0,0,3,26,32,27495,11488,391078,0.008758306422504268,119131,789,0.0364935219113182,3799,38125,34232,6932,79289,16076,0.01690738535345433,7689,0,3893,0,0.4406714112894209,0,60980,0,46857,8377,0,116214,14123,0.05808223398021103,241357,122226,
29,0.0,0,3,26,32,27495,11488,391078,0.008758306422504268,119131,789,0.0364935219113182,3799,38125,34232,6932,79289,16076,0.01690738535345433,7689,0,3893,0,0.4406714112894209,0,60980,0,46857,8377,0,116214,14123,0.05808223398021103,241357,122226,
29,0.0,0,3,26,32,27495,11488,391078,0.008758306422504268,119131,789,0.0364935219113182,3799,38125,34232,6932,79289,16076,0.01690738535345433,7689,0,3893,0,0.4406714112894209,0,60980,0,46857,8377,0,116214,14123,0.05808223398021103,241357,122226,
29,0.0,0,3,26,32,27495,11488,391078,0.008758306422504268,119131,789,0.0364935219113182,3799,38125,34232,6932,79289,16076,0.01690738535345433,7689,0,3893,0,0.4406714112894209,0,60980,0,46857,8377,0,116214,14123,0.05808223398021103,241357,122226,
29,0.0,0,3,26,32,27495,11488,391078,0.008758306422504268,119131,789,0.0364935219113182,3799,38125,34232,6932,79289,16076,0.01690738535345433,7689,0,3893,0,0.4406714112894209,0,60980,0,46857,8377,0,116214,14123,0.05808223398021103,241357,122226,
29,0.0,0,3,26,32,27495,11488,391078,0.008758306422504268,119131,789,0.0364935219113182,3799,38125,34232,6932,79289,16076,0.01690738535345433,7689,0,3893,0,0.4406714112894209,0,60980,0,46857,8377,0,116214,14123,0.05808223398021103,241357,122226,
29,0.0,0,3,26,32,27495,11488,391078,0.008758306422504268,119131,789,0.0364935219113182,3799,38125,34232,6932,79289,16076,0.01690738535345433,7689,0,3893,0,0.4406714112894209,0,60980,0,46857,8377,0,116214,14123,0.05808223398021103,241357,122226,
29,0.0,0,3,26,32,27495,11488,391078,0.008758306422504268,119131,789,0.0364935219113182,3799,38125,34232,6932,79289,16076,0.01690738535345433,7689,0,3893,0,0.4406714112894209,0,60980,0,46857,8377,0,116214,14123,0.05808223398021103,241357,122226,
29,0.0,0,3,26,32,27495,11488,391078,0.008758306422504268,119131,789,0.0364935219113182,3799,38125,34232,6932,79289,16076,0.01690738535345433,7689,0,3893,0,0.4406714112894209,0,60980,0,46857,8377,0,116214,14123,0.05808223398021103,241357,122226,
29,0.0,0,3,26,32,27495,11488,391078,0.008758306422504268,119131,789,0.0364935219113182,3799,38125,34232,6932,79289,16076,0.01690738535345433,7689,0,3893,0,0.4406714112894209,0,60980,0,46857,8377,0,116214,14123,0.05808223398021103,241357,122226,
29,0.0,0,3,26,32,27495,11488,391078,0.008758306422504268,119131,789,0.0364935219113182,3799,38125,34232,6932,79289,16076,0.01690738535345433,7689,0,3893,0,0.4406714112894209,0,60980,0,46857,8377,0,116214,14123,0.05808223398021103,241357,122226,
29,0.0,0,3,26,32,27495,11488,391078,0.008758306422504268,119131,789,0.0364935219113182,3799,38125,34232,6932,79289,16076,0.01690738535345433,7689,0,3893,0,0.4406714112894209,0,60980,0,46857,8377,0,116214,14123,0.05808223398021103,241357,122226,
29,0.0,0,3,26,32,27495,11488,391078,0.008758306422504268,119131,789,0.0364935219113182,3799,38125,34232,6932,79289,16076,0.01690738535345433,7689,0,3893,0,0.4406714112894209,0,60980,0,46857,8377,0,116214,14123,0.05808223398021103,241357,122226,
29,0.0,0,3,26,32,27495,11488,391078,0.008758306422504268,119131,789,0.0364935219113182,3799,38125,34232,6932,79289,16076,0.01690738535345433,7689,0,3893,0,0.4406714112894209,0,60980,0,46857,8377,0,116214,14123,0.05808223398021103,241357,122226,
29,0.0,0,3,26,32,27495,11488,391078,0.008758306422504268,119131,789,0.0364935219113182,3799,38125,34232,6932,79289,16076,0.01690738535345433,7689,0,3893,0,0.4406714112894209,0,60980,0,46857,8377,0,116214,14123,0.05808223398021103,241357,122226,
29,0.0,0,3,26,32,27495,11488,391078,0.008758306422504268,119131,789,0.0364935219113182,3799,38125,34232,6932,79289,16076,0.01690738535345433,7689,0,3893,0,0.4406714112894209,0,60980,0,46857,8377,0,116214,14123,0.05808223398021103,241357,122226,
29,0.0,0,3,26,32,27495,11488,391078,0.008758306422504268,119131,789,0.0364935219113182,3799,38125,34232,6932,79289,16076,0.01690738535345433,7689,0,3893,0,0.4406714112894209,0,60980,0,46857,8377,0,116214,14123,0.05808223398021103,241357,122226,
29,0.0,0,3,26,32,27495,11488,391078,0.008758306422504268,119131,789,0.0364935219113182,3799,38125,34232,6932,79289,16076,0.01690738535345433,7689,0,3893,0,0.4406714112894209,0,60980,0,46857,8377,0,116214,14123,0.05808223398021103,241357,122226,
29,0.0,0,3,26,32,27495,11488,391078,0.008758306422504268,119131,789,0.0364935219113182,3799,38125,34232,6932,79289,16076,0.01690738535345433,7689,0,3893,0,0.4406714112894209,0,60980,0,46857,8377,0,116214,14123,0.05808223398021103,241357,122226,
29,0.0,0,3,26,32,27495,11488,391078,0.008758306422504268,119131,789,0.0364935219113182,3799,38125,34232,6932,79289,16076,0.01690738535345433,7689,0,3893,0,0.4406714112894209,0,60980,0,46857,8377,0,116214,14123,0.05808223398021103,241357,122226,
29,0.0,0,3,26,32,27495,11488,391078,0.008758306422504268,119131,789,0.0364935219113182,3799,38125,34232,6932,79289,16076,0.01690738535345433,7689,0,3893,0,0.4406714112894209,0,60980,0,46857,8377,0,116214,14123,0.05808223398021103,241357,122226,
29,0.0,0,3,26,32,27495,11488,391078,0.008758306422504268,119131,789,0.0364935219113182,3799,38125,34232,6932,79289,16076,0.01690738535345433,7689,0,3893,0,0.4406714112894209,0,60980,0,46857,8377,0,116214,14123,0.05808223398021103,241357,122226,
29,0.0,0,3,26,32,27495,11488,391078,0.008758306422504268,119131,789,0.0364935219113182,3799,38125,34232,6932,79289,16076,0.01690738535345433,7689,0,3893,0,0.4406714112894209,0,60980,0,46857,8377,0,116214,14123,0.05808223398021103,241357,122226,
29,0.0,0,3,26,32,27495,11488,391078,0.008758306422504268,119131,789,0.0364935219113182,3799,38125,34232,6932,79289,16076,0.01690738535345433,7689,0,3893,0,0.4406714112894209,0,60980,0,46857,8377,0,116214,14123,0.05808223398021103,241357,122226,
29,0.0,0,3,26,32,27495,11488,391078,0.008758306422504268,119131,789,0.0364935219113182,3799,38125,34232,6932,79289,16076,0.01690738535345433,7689,0,3893,0,0.4406714112894209,0,60980,0,46857,8377,0,116214,14123,0.05808223398021103,241357,122226,
29,0.0,0,3,26,32,27495,11488,391078,0.008758306422504268,119131,789,0.0364935219113182,3799,38125,34232,6932,79289,16076,0.01690738535345433,7689,0,3893,0,0.4406714112894209,0,60980,0,46857,8377,0,116214,14123,0.05808223398021103,241357,122226,
29,0.0,0,3,26,32,27495,11488,391078,0.008758306422504268,119131,789,0.0364935219113182,3799,38125,34232,6932,79289,16076,0.01690738535345433,7689,0,3893,0,0.4406714112894209,0,60980,0,46857,8377,0,116214,14123,0.05808223398021103,241357,122226,
29,0.0,0,3,26,32,27495,11488,391078,0.008758306422504268,119131,789,0.0364935219113182,3799,38125,34232,6932,79289,16076,0.01690738535345433,7689,0,3893,0,0.4406714112894209,0,60980,0,46857,8377,0,116214,14123,0.05808223398021103,241357,122226,
29,0.0,0,3,26,32,27495,11488,391078,0.008758306422504268,119131,789,0.0364935219113182,3799,38125,34232,6932,79289,16076,0.01690738535345433,7689,0,3893,0,0.4406714112894209,0,60980,0,46857,8377,0,116214,14123,0.05808223398021103,241357,122226,
29,0.0,0,3,26,32,27495,11488,391078,0.008758306422504268,119131,789,0.0364935219113182,3799,38125,34232,6932,79289,16076,0.01690738535345433,7689,0,3893,0,0.4406714112894209,0,60980,0,46857,8377,0,116214,14123,0.05808223398021103,241357,122226,
29,0.0,0,3,26,32,27495,11488,391078,0.008758306422504268,119131,789,0.0364935219113182,3799,38125,34232,6932,79289,16076,0.01690738535345433,7689,0,3893,0,0.4406714112894209,0,60980,0,46857,8377,0,116214,14123,0.05808223398021103,241357,122226,
29,0.0,0,3,26,32,27495,11488,391078,0.008758306422504268,119131,789,0.0364935219113182,3799,38125,34232,6932,79289,16076,0.01690738535345433,7689,0,3893,0,0.4406714112894209,0,60980,0,46857,8377,0,116214,14123,0.05808223398021103,241357,122226,
29,0.0,0,3,26,32,27495,11488,391078,0.008758306422504268,119131,789,0.0364935219113182,3799,38125,34232,6932,79289,16076,0.01690738535345433,7689,0,3893,0,0.4406714112894209,0,60980,0,46857,8377,0,116214,14123,0.05808223398021103,241357,122226,
29,0.0,0,3,26,32,27495,11488,391078,0.008758306422504268,119131,789,0.0364935219113182,3799,38125,34232,6932,79289,16076,0.01690738535345433,7689,0,3893,0,0.4406714112894209,0,60980,0,46857,8377,0,116214,14123,0.05808223398021103,241357,122226,
29,0.0,0,3,26,32,27495,11488,391078,0.008758306422504268,119131,789,0.0364935219113182,3799,38125,34232,6932,79289,16076,0.01690738535345433,7689,0,3893,0,0.4406714112894209,0,60980,0,46857,8377,0,116214,14123,0.05808223398021103,241357,122226,
29,0.0,0,3,26,32,27495,11488,391078,0.008758306422504268,119131,789,0.0364935219113182,3799,38125,34232,6932,79289,16076,0.01690738535345433,7689,0,3893,0,0.4406714112894209,0,60980,0,46857,8377,0,116214,14123,0.05808223398021103,241357,122226,
29,0.0,0,3,26,32,27495,11488,391078,0.008758306422504268,119131,789,0.0364935219113182,3799,38125,34232,6932,79289,16076,0.01690738535345433,7689,0,3893,0,0.4406714112894209,0,60980,0,46857,8377,0,116214,14123,0.05808223398021103,241357,122226,
29,0.0,0,3,26,32,27495,11488,391078,0.008758306422504268,119131,789,0.0364935219113182,3799,38125,34232,6932,79289,16076,0.01690738535345433,7689,0,3893,0,0.4406714112894209,0,60980,0,46857,8377,0,116214,14123,0.05808223398021103,241357,122226,
29,0.0,0,3,26,32,27495,11488,391078,0.008758306422504268,119131,789,0.0364935219113182,3799,38125,34232,6932,79289,16076,0.01690738535345433,7689,0,3893,0,0.4406714112894209,0,60980,0,46857,8377,0,116214,14123,0.05808223398021103,241357,122226,
29,0.0,0,3,26,32,27495,11488,391078,0.008758306422504268,119131,789,0.0364935219113182,3799,38125,34232,6932,79289,16076,0.01690738535345433,7689,0,3893,0,0.4406714112894209,0,60980,0,46857,8377,0,116214,14123,0.05808223398021103,241357,122226,
29,0.0,0,3,26,32,27495,11488,391078,0.008758306422504268,119131,789,0.0364935219113182,3799,38125,34232,6932,79289,16076,0.01690738535345433,7689,0,3893,0,0.4406714112894209,0,60980,0,46857,8377,0,116214,14123,0.05808223398021103,241357,122226,
29,0.0,0,3,26,32,27495,11488,391078,0.008758306422504268,119131,789,0.0364935219113182,3799,38125,34232,6932,79289,16076,0.01690738535345433,7689,0,3893,0,0.4406714112894209,0,60980,0,46857,8377,0,116214,14123,0.05808223398021103,241357,122226,
29,0.0,0,3,26,32,27495,11488,391078,0.008758306422504268,119131,789,0.0364935219113182,3799,38125,34232,6932,79289,16076,0.01690738535345433,7689,0,3893,0,0.4406714112894209,0,60980,0,46857,8377,0,116214,14123,0.05808223398021103,241357,122226,
29,0.0,0,3,26,32,27495,11488,391078,0.008758306422504268,119131,789,0.0364935219113182,3799,38125,34232,6932,79289,16076,0.01690738535345433,7689,0,3893,0,0.4406714112894209,0,60980,0,46857,8377,0,116214,14123,0.05808223398021103,241357,122226,
29,0.0,0,3,26,32,27495,11488,391078,0.008758306422504268,119131,789,0.0364935219113182,3799,38125,34232,6932,79289,16076,0.01690738535345433,7689,0,3893,0,0.4406714112894209,0,60980,0,46857,8377,0,116214,14123,0.05808223398021103,241357,122226,
29,0.0,0,3,26,32,27495,11488,391078,0.008758306422504268,119131,789,0.0364935219113182,3799,38125,34232,6932,79289,16076,0.01690738535345433,7689,0,3893,0,0.4406714112894209,0,60980,0,46857,8377,0,116214,14123,0.05808223398021103,241357,122226,
29,0.0,0,3,26,32,27495,11488,391078,0.008758306422504268,119131,789,0.0364935219113182,3799,38125,34232,6932,79289,16076,0.01690738535345433,7689,0,3893,0,0.4406714112894209,0,60980,0,46857,8377,0,116214,14123,0.05808223398021103,241357,122226,
29,0.0,0,3,26,32,27495,11488,391078,0.008758306422504268,119131,789,0.0364935219113182,3799,38125,34232,6932,79289,16076,0.01690738535345433,7689,0,3893,0,0.4406714112894209,0,60980,0,46857,8377,0,116214,14123,0.05808223398021103,241357,122226,
29,0.0,0,3,26,32,27495,11488,391078,0.008758306422504268,119131,789,0.0364935219113182,3799,38125,34232,6932,79289,16076,0.01690738535345433,7689,0,3893,0,0.4406714112894209,0,60980,0,46857,8377,0,116214,14123,0.05808223398021103,241357,122226,
29,0.0,0,3,26,32,27495,11488,391078,0.008758306422504268,119131,789,0.0364935219113182,3799,38125,34232,6932,79289,16076,0.01690738535345433,7689,0,3893,0,0.4406714112894209,0,60980,0,46857,8377,0,116214,14123,0.05808223398021103,241357,122226,
29,0.0,0,3,26,32,27495,11488,391078,0.008758306422504268,119131,789,0.0364935219113182,3799,38125,34232,6932,79289,16076,0.01690738535345433,7689,0,3893,0,0.4406714112894209,0,60980,0,46857,8377,0,116214,14123,0.05808223398021103,241357,122226,
29,0.0,0,3,26,32,27495,11488,391078,0.008758306422504268,119131,789,0.0364935219113182,3799,38125,34232,6932,79289,16076,0.01690738535345433,7689,0,3893,0,0.4406714112894209,0,60980,0,46857,8377,0,116214,14123,0.05808223398021103,241357,122226,
29,0.0,0,3,26,32,27495,11488,391078,0.008758306422504268,119131,789,0.0364935219113182,3799,38125,34232,6932,79289,16076,0.01690738535345433,7689,0,3893,0,0.4406714112894209,0,60980,0,46857,8377,0,116214,14123,0.05808223398021103,241357,122226,
29,0.0,0,3,26,32,27495,11488,391078,0.008758306422504268,119131,789,0.0364935219113182,3799,38125,34232,6932,79289,16076,0.01690738535345433,7689,0,3893,0,0.4406714112894209,0,60980,0,46857,8377,0,116214,14123,0.05808223398021103,241357,122226,
29,0.0,0,3,26,32,27495,11488,391078,0.008758306422504268,119131,789,0.0364935219113182,3799,38125,34232,6932,79289,16076,0.01690738535345433,7689,0,3893,0,0.4406714112894209,0,60980,0,46857,8377,0,116214,14123,0.05808223398021103,241357,122226,
29,0.0,0,3,26,32,27495,11488,391078,0.008758306422504268,119131,789,0.0364935219113182,3799,38125,34232,6932,79289,16076,0.01690738535345433,7689,0,3893,0,0.4406714112894209,0,60980,0,46857,8377,0,116214,14123,0.05808223398021103,241357,122226,
29,0.0,0,3,26,32,27495,11488,391078,0.008758306422504268,119131,789,0.0364935219113182,3799,38125,34232,6932,79289,16076,0.01690738535345433,7689,0,3893,0,0.4406714112894209,0,60980,0,46857,8377,0,116214,14123,0.05808223398021103,241357,122226,
29,0.0,0,3,26,32,27495,11488,391078,0.008758306422504268,119131,789,0.0364935219113182,3799,38125,34232,6932,79289,16076,0.01690738535345433,7689,0,3893,0,0.4406714112894209,0,60980,0,46857,8377,0,116214,14123,0.05808223398021103,241357,122226,
29,0.0,0,3,26,32,27495,11488,391078,0.008758306422504268,119131,789,0.0364935219113182,3799,38125,34232,6932,79289,16076,0.01690738535345433,7689,0,3893,0,0.4406714112894209,0,60980,0,46857,8377,0,116214,14123,0.05808223398021103,241357,122226,
29,0.0,0,3,26,32,27495,11488,391078,0.008758306422504268,119131,789,0.0364935219113182,3799,38125,34232,6932,79289,16076,0.01690738535345433,7689,0,3893,0,0.4406714112894209,0,60980,0,46857,8377,0,116214,14123,0.05808223398021103,241357,122226,
29,0.0,0,3,26,32,27495,11488,391078,0.008758306422504268,119131,789,0.0364935219113182,3799,38125,34232,6932,79289,16076,0.01690738535345433,7689,0,3893,0,0.4406714112894209,0,60980,0,46857,8377,0,116214,14123,0.05808223398021103,241357,122226,
29,0.0,0,3,26,32,27495,11488,391078,0.008758306422504268,119131,789,0.0364935219113182,3799,38125,34232,6932,79289,16076,0.01690738535345433,7689,0,3893,0,0.4406714112894209,0,60980,0,46857,8377,0,116214,14123,0.05808223398021103,241357,122226,
29,0.0,0,3,26,32,27495,11488,391078,0.008758306422504268,119131,789,0.0364935219113182,3799,38125,34232,6932,79289,16076,0.01690738535345433,7689,0,3893,0,0.4406714112894209,0,60980,0,46857,8377,0,116214,14123,0.05808223398021103,241357,122226,
29,0.0,0,3,26,32,27495,11488,391078,0.008758306422504268,119131,789,0.0364935219113182,3799,38125,34232,6932,79289,16076,0.01690738535345433,7689,0,3893,0,0.4406714112894209,0,60980,0,46857,8377,0,116214,14123,0.05808223398021103,241357,122226,
29,0.0,0,3,26,32,27495,11488,391078,0.008758306422504268,119131,789,0.0364935219113182,3799,38125,34232,6932,79289,16076,0.01690738535345433,7689,0,3893,0,0.4406714112894209,0,60980,0,46857,8377,0,116214,14123,0.05808223398021103,241357,122226,
29,0.0,0,3,26,32,27495,11488,391078,0.008758306422504268,119131,789,0.0364935219113182,3799,38125,34232,6932,79289,16076,0.01690738535345433,7689,0,3893,0,0.4406714112894209,0,60980,0,46857,8377,0,116214,14123,0.05808223398021103,241357,122226,
29,0.0,0,3,26,32,27495,11488,391078,0.008758306422504268,119131,789,0.0364935219113182,3799,38125,34232,6932,79289,16076,0.01690738535345433,7689,0,3893,0,0.4406714112894209,0,60980,0,46857,8377,0,116214,14123,0.05808223398021103,241357,122226,
29,0.0,0,3,26,32,27495,11488,391078,0.008758306422504268,119131,789,0.0364935219113182,3799,38125,34232,6932,79289,16076,0.01690738535345433,7689,0,3893,0,0.4406714112894209,0,60980,0,46857,8377,0,116214,14123,0.05808223398021103,241357,122226,
29,0.0,0,3,26,32,27495,11488,391078,0.008758306422504268,119131,789,0.0364935219113182,3799,38125,34232,6932,79289,16076,0.01690738535345433,7689,0,3893,0,0.4406714112894209,0,60980,0,46857,8377,0,116214,14123,0.05808223398021103,241357,122226,
29,0.0,0,3,26,32,27495,11488,391078,0.008758306422504268,119131,789,0.0364935219113182,3799,38125,34232,6932,79289,16076,0.01690738535345433,7689,0,3893,0,0.4406714112894209,0,60980,0,46857,8377,0,116214,14123,0.05808223398021103,241357,122226,
29,0.0,0,3,26,32,27495,11488,391078,0.008758306422504268,119131,789,0.0364935219113182,3799,38125,34232,6932,79289,16076,0.01690738535345433,7689,0,3893,0,0.4406714112894209,0,60980,0,46857,8377,0,116214,14123,0.05808223398021103,241357,122226,
29,0.0,0,3,26,32,27495,11488,391078,0.008758306422504268,119131,789,0.0364935219113182,3799,38125,34232,6932,79289,16076,0.01690738535345433,7689,0,3893,0,0.4406714112894209,0,60980,0,46857,8377,0,116214,14123,0.05808223398021103,241357,122226,
29,0.0,0,3,26,32,27495,11488,391078,0.008758306422504268,119131,789,0.0364935219113182,3799,38125,34232,6932,79289,16076,0.01690738535345433,7689,0,3893,0,0.4406714112894209,0,60980,0,46857,8377,0,116214,14123,0.05808223398021103,241357,122226,
29,0.0,0,3,26,32,27495,11488,391078,0.008758306422504268,119131,789,0.0364935219113182,3799,38125,34232,6932,79289,16076,0.01690738535345433,7689,0,3893,0,0.4406714112894209,0,60980,0,46857,8377,0,116214,14123,0.05808223398021103,241357,122226,
29,0.0,0,3,26,32,27495,11488,391078,0.008758306422504268,119131,789,0.0364935219113182,3799,38125,34232,6932,79289,16076,0.01690738535345433,7689,0,3893,0,0.4406714112894209,0,60980,0,46857,8377,0,116214,14123,0.05808223398021103,241357,122226,
29,0.0,0,3,26,32,27495,11488,391078,0.008758306422504268,119131,789,0.0364935219113182,3799,38125,34232,6932,79289,16076,0.01690738535345433,7689,0,3893,0,0.4406714112894209,0,60980,0,46857,8377,0,116214,14123,0.05808223398021103,241357,122226,
29,0.0,0,3,26,32,27495,11488,391078,0.008758306422504268,119131,789,0.0364935219113182,3799,38125,34232,6932,79289,16076,0.01690738535345433,7689,0,3893,0,0.4406714112894209,0,60980,0,46857,8377,0,116214,14123,0.05808223398021103,241357,122226,
29,0.0,0,3,26,32,27495,11488,391078,0.008758306422504268,119131,789,0.0364935219113182,3799,38125,34232,6932,79289,16076,0.01690738535345433,7689,0,3893,0,0.4406714112894209,0,60980,0,46857,8377,0,116214,14123,0.05808223398021103,241357,122226,
29,0.0,0,3,26,32,27495,11488,391078,0.008758306422504268,119131,789,0.0364935219113182,3799,38125,34232,6932,79289,16076,0.01690738535345433,7689,0,3893,0,0.4406714112894209,0,60980,0,46857,8377,0,116214,14123,0.05808223398021103,241357,122226,
29,0.0,0,3,26,32,27495,11488,391078,0.008758306422504268,119131,789,0.0364935219113182,3799,38125,34232,6932,79289,16076,0.01690738535345433,7689,0,3893,0,0.4406714112894209,0,60980,0,46857,8377,0,116214,14123,0.05808223398021103,241357,122226,
29,0.0,0,3,26,32,27495,11488,391078,0.008758306422504268,119131,789,0.0364935219113182,3799,38125,34232,6932,79289,16076,0.01690738535345433,7689,0,3893,0,0.4406714112894209,0,60980,0,46857,8377,0,116214,14123,0.05808223398021103,241357,122226,
29,0.0,0,3,26,32,27495,11488,391078,0.008758306422504268,119131,789,0.0364935219113182,3799,38125,34232,6932,79289,16076,0.01690738535345433,7689,0,3893,0,0.4406714112894209,0,60980,0,46857,8377,0,116214,14123,0.05808223398021103,241357,122226,
29,0.0,0,3,26,32,27495,11488,391078,0.008758306422504268,119131,789,0.0364935219113182,3799,38125,34232,6932,79289,16076,0.01690738535345433,7689,0,3893,0,0.4406714112894209,0,60980,0,46857,8377,0,116214,14123,0.05808223398021103,241357,122226,
29,0.0,0,3,26,32,27495,11488,391078,0.008758306422504268,119131,789,0.0364935219113182,3799,38125,34232,6932,79289,16076,0.01690738535345433,7689,0,3893,0,0.4406714112894209,0,60980,0,46857,8377,0,116214,14123,0.05808223398021103,241357,122226,
29,0.0,0,3,26,32,27495,11488,391078,0.008758306422504268,119131,789,0.0364935219113182,3799,38125,34232,6932,79289,16076,0.01690738535345433,7689,0,3893,0,0.4406714112894209,0,60980,0,46857,8377,0,116214,14123,0.05808223398021103,241357,122226,
29,0.0,0,3,26,32,27495,11488,391078,0.008758306422504268,119131,789,0.0364935219113182,3799,38125,34232,6932,79289,16076,0.01690738535345433,7689,0,3893,0,0.4406714112894209,0,60980,0,46857,8377,0,116214,14123,0.05808223398021103,241357,122226,
29,0.0,0,3,26,32,27495,11488,391078,0.008758306422504268,119131,789,0.0364935219113182,3799,38125,34232,6932,79289,16076,0.01690738535345433,7689,0,3893,0,0.4406714112894209,0,60980,0,46857,8377,0,116214,14123,0.05808223398021103,241357,122226,
29,0.0,0,3,26,32,27495,11488,391078,0.008758306422504268,119131,789,0.0364935219113182,3799,38125,34232,6932,79289,16076,0.01690738535345433,7689,0,3893,0,0.4406714112894209,0,60980,0,46857,8377,0,116214,14123,0.05808223398021103,241357,122226,
29,0.0,0,3,26,32,27495,11488,391078,0.008758306422504268,119131,789,0.0364935219113182,3799,38125,34232,6932,79289,16076,0.01690738535345433,7689,0,3893,0,0.4406714112894209,0,60980,0,46857,8377,0,116214,14123,0.05808223398021103,241357,122226,
29,0.0,0,3,26,32,27495,11488,391078,0.008758306422504268,119131,789,0.0364935219113182,3799,38125,34232,6932,79289,16076,0.01690738535345433,7689,0,3893,0,0.4406714112894209,0,60980,0,46857,8377,0,116214,14123,0.05808223398021103,241357,122226,
29,0.0,0,3,26,32,27495,11488,391078,0.008758306422504268,119131,789,0.0364935219113182,3799,38125,34232,6932,79289,16076,0.01690738535345433,7689,0,3893,0,0.4406714112894209,0,60980,0,46857,8377,0,116214,14123,0.05808223398021103,241357,122226,
29,0.0,0,3,26,32,27495,11488,391078,0.008758306422504268,119131,789,0.0364935219113182,3799,38125,34232,6932,79289,16076,0.01690738535345433,7689,0,3893,0,0.4406714112894209,0,60980,0,46857,8377,0,116214,14123,0.05808223398021103,241357,122226,
29,0.0,0,3,26,32,27495,11488,391078,0.008758306422504268,119131,789,0.0364935219113182,3799,38125,34232,6932,79289,16076,0.01690738535345433,7689,0,3893,0,0.4406714112894209,0,60980,0,46857,8377,0,116214,14123,0.05808223398021103,241357,122226,
29,0.0,0,3,26,32,27495,11488,391078,0.008758306422504268,119131,789,0.0364935219113182,3799,38125,34232,6932,79289,16076,0.01690738535345433,7689,0,3893,0,0.4406714112894209,0,60980,0,46857,8377,0,116214,14123,0.05808223398021103,241357,122226,
29,0.0,0,3,26,32,27495,11488,391078,0.008758306422504268,119131,789,0.0364935219113182,3799,38125,34232,6932,79289,16076,0.01690738535345433,7689,0,3893,0,0.4406714112894209,0,60980,0,46857,8377,0,116214,14123,0.05808223398021103,241357,122226,
29,0.0,0,3,26,32,27495,11488,391078,0.008758306422504268,119131,789,0.0364935219113182,3799,38125,34232,6932,79289,16076,0.01690738535345433,7689,0,3893,0,0.4406714112894209,0,60980,0,46857,8377,0,116214,14123,0.05808223398021103,241357,122226,
29,0.0,0,3,26,32,27495,11488,391078,0.008758306422504268,119131,789,0.0364935219113182,3799,38125,34232,6932,79289,16076,0.01690738535345433,7689,0,3893,0,0.4406714112894209,0,60980,0,46857,8377,0,116214,14123,0.05808223398021103,241357,122226,
29,0.0,0,3,26,32,27495,11488,391078,0.008758306422504268,119131,789,0.0364935219113182,3799,38125,34232,6932,79289,16076,0.01690738535345433,7689,0,3893,0,0.4406714112894209,0,60980,0,46857,8377,0,116214,14123,0.05808223398021103,241357,122226,
29,0.0,0,3,26,32,27495,11488,391078,0.008758306422504268,119131,789,0.0364935219113182,3799,38125,34232,6932,79289,16076,0.01690738535345433,7689,0,3893,0,0.4406714112894209,0,60980,0,46857,8377,0,116214,14123,0.05808223398021103,241357,122226,
29,0.0,0,3,26,32,27495,11488,391078,0.008758306422504268,119131,789,0.0364935219113182,3799,38125,34232,6932,79289,16076,0.01690738535345433,7689,0,3893,0,0.4406714112894209,0,60980,0,46857,8377,0,116214,14123,0.05808223398021103,241357,122226,
29,0.0,0,3,26,32,27495,11488,391078,0.008758306422504268,119131,789,0.0364935219113182,3799,38125,34232,6932,79289,16076,0.01690738535345433,7689,0,3893,0,0.4406714112894209,0,60980,0,46857,8377,0,116214,14123,0.05808223398021103,241357,122226,
29,0.0,0,3,26,32,27495,11488,391078,0.008758306422504268,119131,789,0.0364935219113182,3799,38125,34232,6932,79289,16076,0.01690738535345433,7689,0,3893,0,0.4406714112894209,0,60980,0,46857,8377,0,116214,14123,0.05808223398021103,241357,122226,
29,0.0,0,3,26,32,27495,11488,391078,0.008758306422504268,119131,789,0.0364935219113182,3799,38125,34232,6932,79289,16076,0.01690738535345433,7689,0,3893,0,0.4406714112894209,0,60980,0,46857,8377,0,116214,14123,0.05808223398021103,241357,122226,
29,0.0,0,3,26,32,27495,11488,391078,0.008758306422504268,119131,789,0.0364935219113182,3799,38125,34232,6932,79289,16076,0.01690738535345433,7689,0,3893,0,0.4406714112894209,0,60980,0,46857,8377,0,116214,14123,0.05808223398021103,241357,122226,
29,0.0,0,3,26,32,27495,11488,391078,0.008758306422504268,119131,789,0.0364935219113182,3799,38125,34232,6932,79289,16076,0.01690738535345433,7689,0,3893,0,0.4406714112894209,0,60980,0,46857,8377,0,116214,14123,0.05808223398021103,241357,122226,
29,0.0,0,3,26,32,27495,11488,391078,0.008758306422504268,119131,789,0.0364935219113182,3799,38125,34232,6932,79289,16076,0.01690738535345433,7689,0,3893,0,0.4406714112894209,0,60980,0,46857,8377,0,116214,14123,0.05808223398021103,241357,122226,
29,0.0,0,3,26,32,27495,11488,391078,0.008758306422504268,119131,789,0.0364935219113182,3799,38125,34232,6932,79289,16076,0.01690738535345433,7689,0,3893,0,0.4406714112894209,0,60980,0,46857,8377,0,116214,14123,0.05808223398021103,241357,122226,
29,0.0,0,3,26,32,27495,11488,391078,0.008758306422504268,119131,789,0.0364935219113182,3799,38125,34232,6932,79289,16076,0.01690738535345433,7689,0,3893,0,0.4406714112894209,0,60980,0,46857,8377,0,116214,14123,0.05808223398021103,241357,122226,
29,0.0,0,3,26,32,27495,11488,391078,0.008758306422504268,119131,789,0.0364935219113182,3799,38125,34232,6932,79289,16076,0.01690738535345433,7689,0,3893,0,0.4406714112894209,0,60980,0,46857,8377,0,116214,14123,0.05808223398021103,241357,122226,
29,0.0,0,3,26,32,27495,11488,391078,0.008758306422504268,119131,789,0.0364935219113182,3799,38125,34232,6932,79289,16076,0.01690738535345433,7689,0,3893,0,0.4406714112894209,0,60980,0,46857,8377,0,116214,14123,0.05808223398021103,241357,122226,
29,0.0,0,3,26,32,27495,11488,391078,0.008758306422504268,119131,789,0.0364935219113182,3799,38125,34232,6932,79289,16076,0.01690738535345433,7689,0,3893,0,0.4406714112894209,0,60980,0,46857,8377,0,116214,14123,0.05808223398021103,241357,122226,
29,0.0,0,3,26,32,27495,11488,391078,0.008758306422504268,119131,789,0.0364935219113182,3799,38125,34232,6932,79289,16076,0.01690738535345433,7689,0,3893,0,0.4406714112894209,0,60980,0,46857,8377,0,116214,14123,0.05808223398021103,241357,122226,
29,0.0,0,3,26,32,27495,11488,391078,0.008758306422504268,119131,789,0.0364935219113182,3799,38125,34232,6932,79289,16076,0.01690738535345433,7689,0,3893,0,0.4406714112894209,0,60980,0,46857,8377,0,116214,14123,0.05808223398021103,241357,122226,
29,0.0,0,3,26,32,27495,11488,391078,0.008758306422504268,119131,789,0.0364935219113182,3799,38125,34232,6932,79289,16076,0.01690738535345433,7689,0,3893,0,0.4406714112894209,0,60980,0,46857,8377,0,116214,14123,0.05808223398021103,241357,122226,
29,0.0,0,3,26,32,27495,11488,391078,0.008758306422504268,119131,789,0.0364935219113182,3799,38125,34232,6932,79289,16076,0.01690738535345433,7689,0,3893,0,0.4406714112894209,0,60980,0,46857,8377,0,116214,14123,0.05808223398021103,241357,122226,
29,0.0,0,3,26,32,27495,11488,391078,0.008758306422504268,119131,789,0.0364935219113182,3799,38125,34232,6932,79289,16076,0.01690738535345433,7689,0,3893,0,0.4406714112894209,0,60980,0,46857,8377,0,116214,14123,0.05808223398021103,241357,122226,
29,0.0,0,3,26,32,27495,11488,391078,0.008758306422504268,119131,789,0.0364935219113182,3799,38125,34232,6932,79289,16076,0.01690738535345433,7689,0,3893,0,0.4406714112894209,0,60980,0,46857,8377,0,116214,14123,0.05808223398021103,241357,122226,
29,0.0,0,3,26,32,27495,11488,391078,0.008758306422504268,119131,789,0.0364935219113182,3799,38125,34232,6932,79289,16076,0.01690738535345433,7689,0,3893,0,0.4406714112894209,0,60980,0,46857,8377,0,116214,14123,0.05808223398021103,241357,122226,
29,0.0,0,3,26,32,27495,11488,391078,0.008758306422504268,119131,789,0.0364935219113182,3799,38125,34232,6932,79289,16076,0.01690738535345433,7689,0,3893,0,0.4406714112894209,0,60980,0,46857,8377,0,116214,14123,0.05808223398021103,241357,122226,
29,0.0,0,3,26,32,27495,11488,391078,0.008758306422504268,119131,789,0.0364935219113182,3799,38125,34232,6932,79289,16076,0.01690738535345433,7689,0,3893,0,0.4406714112894209,0,60980,0,46857,8377,0,116214,14123,0.05808223398021103,241357,122226,
29,0.0,0,3,26,32,27495,11488,391078,0.008758306422504268,119131,789,0.0364935219113182,3799,38125,34232,6932,79289,16076,0.01690738535345433,7689,0,3893,0,0.4406714112894209,0,60980,0,46857,8377,0,116214,14123,0.05808223398021103,241357,122226,
29,0.0,0,3,26,32,27495,11488,391078,0.008758306422504268,119131,789,0.0364935219113182,3799,38125,34232,6932,79289,16076,0.01690738535345433,7689,0,3893,0,0.4406714112894209,0,60980,0,46857,8377,0,116214,14123,0.05808223398021103,241357,122226,
29,0.0,0,3,26,32,27495,11488,391078,0.008758306422504268,119131,789,0.0364935219113182,3799,38125,34232,6932,79289,16076,0.01690738535345433,7689,0,3893,0,0.4406714112894209,0,60980,0,46857,8377,0,116214,14123,0.05808223398021103,241357,122226,
29,0.0,0,3,26,32,27495,11488,391078,0.008758306422504268,119131,789,0.0364935219113182,3799,38125,34232,6932,79289,16076,0.01690738535345433,7689,0,3893,0,0.4406714112894209,0,60980,0,46857,8377,0,116214,14123,0.05808223398021103,241357,122226,
29,0.0,0,3,26,32,27495,11488,391078,0.008758306422504268,119131,789,0.0364935219113182,3799,38125,34232,6932,79289,16076,0.01690738535345433,7689,0,3893,0,0.4406714112894209,0,60980,0,46857,8377,0,116214,14123,0.05808223398021103,241357,122226,
29,0.0,0,3,26,32,27495,11488,391078,0.008758306422504268,119131,789,0.0364935219113182,3799,38125,34232,6932,79289,16076,0.01690738535345433,7689,0,3893,0,0.4406714112894209,0,60980,0,46857,8377,0,116214,14123,0.05808223398021103,241357,122226,
29,0.0,0,3,26,32,27495,11488,391078,0.008758306422504268,119131,789,0.0364935219113182,3799,38125,34232,6932,79289,16076,0.01690738535345433,7689,0,3893,0,0.4406714112894209,0,60980,0,46857,8377,0,116214,14123,0.05808223398021103,241357,122226,
29,0.0,0,3,26,32,27495,11488,391078,0.008758306422504268,119131,789,0.0364935219113182,3799,38125,34232,6932,79289,16076,0.01690738535345433,7689,0,3893,0,0.4406714112894209,0,60980,0,46857,8377,0,116214,14123,0.05808223398021103,241357,122226,
29,0.0,0,3,26,32,27495,11488,391078,0.008758306422504268,119131,789,0.0364935219113182,3799,38125,34232,6932,79289,16076,0.01690738535345433,7689,0,3893,0,0.4406714112894209,0,60980,0,46857,8377,0,116214,14123,0.05808223398021103,241357,122226,
29,0.0,0,3,26,32,27495,11488,391078,0.008758306422504268,119131,789,0.0364935219113182,3799,38125,34232,6932,79289,16076,0.01690738535345433,7689,0,3893,0,0.4406714112894209,0,60980,0,46857,8377,0,116214,14123,0.05808223398021103,241357,122226,
29,0.0,0,3,26,32,27495,11488,391078,0.008758306422504268,119131,789,0.0364935219113182,3799,38125,34232,6932,79289,16076,0.01690738535345433,7689,0,3893,0,0.4406714112894209,0,60980,0,46857,8377,0,116214,14123,0.05808223398021103,241357,122226,
29,0.0,0,3,26,32,27495,11488,391078,0.008758306422504268,119131,789,0.0364935219113182,3799,38125,34232,6932,79289,16076,0.01690738535345433,7689,0,3893,0,0.4406714112894209,0,60980,0,46857,8377,0,116214,14123,0.05808223398021103,241357,122226,
29,0.0,0,3,26,32,27495,11488,391078,0.008758306422504268,119131,789,0.0364935219113182,3799,38125,34232,6932,79289,16076,0.01690738535345433,7689,0,3893,0,0.4406714112894209,0,60980,0,46857,8377,0,116214,14123,0.05808223398021103,241357,122226,
29,0.0,0,3,26,32,27495,11488,391078,0.008758306422504268,119131,789,0.0364935219113182,3799,38125,34232,6932,79289,16076,0.01690738535345433,7689,0,3893,0,0.4406714112894209,0,60980,0,46857,8377,0,116214,14123,0.05808223398021103,241357,122226,
29,0.0,0,3,26,32,27495,11488,391078,0.008758306422504268,119131,789,0.0364935219113182,3799,38125,34232,6932,79289,16076,0.01690738535345433,7689,0,3893,0,0.4406714112894209,0,60980,0,46857,8377,0,116214,14123,0.05808223398021103,241357,122226,
29,0.0,0,3,26,32,27495,11488,391078,0.008758306422504268,119131,789,0.0364935219113182,3799,38125,34232,6932,79289,16076,0.01690738535345433,7689,0,3893,0,0.4406714112894209,0,60980,0,46857,8377,0,116214,14123,0.05808223398021103,241357,122226,
29,0.0,0,3,26,32,27495,11488,391078,0.008758306422504268,119131,789,0.0364935219113182,3799,38125,34232,6932,79289,16076,0.01690738535345433,7689,0,3893,0,0.4406714112894209,0,60980,0,46857,8377,0,116214,14123,0.05808223398021103,241357,122226,
29,0.0,0,3,26,32,27495,11488,391078,0.008758306422504268,119131,789,0.0364935219113182,3799,38125,34232,6932,79289,16076,0.01690738535345433,7689,0,3893,0,0.4406714112894209,0,60980,0,46857,8377,0,116214,14123,0.05808223398021103,241357,122226,
29,0.0,0,3,26,32,27495,11488,391078,0.008758306422504268,119131,789,0.0364935219113182,3799,38125,34232,6932,79289,16076,0.01690738535345433,7689,0,3893,0,0.4406714112894209,0,60980,0,46857,8377,0,116214,14123,0.05808223398021103,241357,122226,
29,0.0,0,3,26,32,27495,11488,391078,0.008758306422504268,119131,789,0.0364935219113182,3799,38125,34232,6932,79289,16076,0.01690738535345433,7689,0,3893,0,0.4406714112894209,0,60980,0,46857,8377,0,116214,14123,0.05808223398021103,241357,122226,
29,0.0,0,3,26,32,27495,11488,391078,0.008758306422504268,119131,789,0.0364935219113182,3799,38125,34232,6932,79289,16076,0.01690738535345433,7689,0,3893,0,0.4406714112894209,0,60980,0,46857,8377,0,116214,14123,0.05808223398021103,241357,122226,
29,0.0,0,3,26,32,27495,11488,391078,0.008758306422504268,119131,789,0.0364935219113182,3799,38125,34232,6932,79289,16076,0.01690738535345433,7689,0,3893,0,0.4406714112894209,0,60980,0,46857,8377,0,116214,14123,0.05808223398021103,241357,122226,
29,0.0,0,3,26,32,27495,11488,391078,0.008758306422504268,119131,789,0.0364935219113182,3799,38125,34232,6932,79289,16076,0.01690738535345433,7689,0,3893,0,0.4406714112894209,0,60980,0,46857,8377,0,116214,14123,0.05808223398021103,241357,122226,
29,0.0,0,3,26,32,27495,11488,391078,0.008758306422504268,119131,789,0.0364935219113182,3799,38125,34232,6932,79289,16076,0.01690738535345433,7689,0,3893,0,0.4406714112894209,0,60980,0,46857,8377,0,116214,14123,0.05808223398021103,241357,122226,
29,0.0,0,3,26,32,27495,11488,391078,0.008758306422504268,119131,789,0.0364935219113182,3799,38125,34232,6932,79289,16076,0.01690738535345433,7689,0,3893,0,0.4406714112894209,0,60980,0,46857,8377,0,116214,14123,0.05808223398021103,241357,122226,
29,0.0,0,3,26,32,27495,11488,391078,0.008758306422504268,119131,789,0.0364935219113182,3799,38125,34232,6932,79289,16076,0.01690738535345433,7689,0,3893,0,0.4406714112894209,0,60980,0,46857,8377,0,116214,14123,0.05808223398021103,241357,122226,
29,0.0,0,3,26,32,27495,11488,391078,0.008758306422504268,119131,789,0.0364935219113182,3799,38125,34232,6932,79289,16076,0.01690738535345433,7689,0,3893,0,0.4406714112894209,0,60980,0,46857,8377,0,116214,14123,0.05808223398021103,241357,122226,
29,0.0,0,3,26,32,27495,11488,391078,0.008758306422504268,119131,789,0.0364935219113182,3799,38125,34232,6932,79289,16076,0.01690738535345433,7689,0,3893,0,0.4406714112894209,0,60980,0,46857,8377,0,116214,14123,0.05808223398021103,241357,122226,
29,0.0,0,3,26,32,27495,11488,391078,0.008758306422504268,119131,789,0.0364935219113182,3799,38125,34232,6932,79289,16076,0.01690738535345433,7689,0,3893,0,0.4406714112894209,0,60980,0,46857,8377,0,116214,14123,0.05808223398021103,241357,122226,
29,0.0,0,3,26,32,27495,11488,391078,0.008758306422504268,119131,789,0.0364935219113182,3799,38125,34232,6932,79289,16076,0.01690738535345433,7689,0,3893,0,0.4406714112894209,0,60980,0,46857,8377,0,116214,14123,0.05808223398021103,241357,122226,
29,0.0,0,3,26,32,27495,11488,391078,0.008758306422504268,119131,789,0.0364935219113182,3799,38125,34232,6932,79289,16076,0.01690738535345433,7689,0,3893,0,0.4406714112894209,0,60980,0,46857,8377,0,116214,14123,0.05808223398021103,241357,122226,
29,0.0,0,3,26,32,27495,11488,391078,0.008758306422504268,119131,789,0.0364935219113182,3799,38125,34232,6932,79289,16076,0.01690738535345433,7689,0,3893,0,0.4406714112894209,0,60980,0,46857,8377,0,116214,14123,0.05808223398021103,241357,122226,
29,0.0,0,3,26,32,27495,11488,391078,0.008758306422504268,119131,789,0.0364935219113182,3799,38125,34232,6932,79289,16076,0.01690738535345433,7689,0,3893,0,0.4406714112894209,0,60980,0,46857,8377,0,116214,14123,0.05808223398021103,241357,122226,
29,0.0,0,3,26,32,27495,11488,391078,0.008758306422504268,119131,789,0.0364935219113182,3799,38125,34232,6932,79289,16076,0.01690738535345433,7689,0,3893,0,0.4406714112894209,0,60980,0,46857,8377,0,116214,14123,0.05808223398021103,241357,122226,
29,0.0,0,3,26,32,27495,11488,391078,0.008758306422504268,119131,789,0.0364935219113182,3799,38125,34232,6932,79289,16076,0.01690738535345433,7689,0,3893,0,0.4406714112894209,0,60980,0,46857,8377,0,116214,14123,0.05808223398021103,241357,122226,
29,0.0,0,3,26,32,27495,11488,391078,0.008758306422504268,119131,789,0.0364935219113182,3799,38125,34232,6932,79289,16076,0.01690738535345433,7689,0,3893,0,0.4406714112894209,0,60980,0,46857,8377,0,116214,14123,0.05808223398021103,241357,122226,
29,0.0,0,3,26,32,27495,11488,391078,0.008758306422504268,119131,789,0.0364935219113182,3799,38125,34232,6932,79289,16076,0.01690738535345433,7689,0,3893,0,0.4406714112894209,0,60980,0,46857,8377,0,116214,14123,0.05808223398021103,241357,122226,
29,0.0,0,3,26,32,27495,11488,391078,0.008758306422504268,119131,789,0.0364935219113182,3799,38125,34232,6932,79289,16076,0.01690738535345433,7689,0,3893,0,0.4406714112894209,0,60980,0,46857,8377,0,116214,14123,0.05808223398021103,241357,122226,
29,0.0,0,3,26,32,27495,11488,391078,0.008758306422504268,119131,789,0.0364935219113182,3799,38125,34232,6932,79289,16076,0.01690738535345433,7689,0,3893,0,0.4406714112894209,0,60980,0,46857,8377,0,116214,14123,0.05808223398021103,241357,122226,
29,0.0,0,3,26,32,27495,11488,391078,0.008758306422504268,119131,789,0.0364935219113182,3799,38125,34232,6932,79289,16076,0.01690738535345433,7689,0,3893,0,0.4406714112894209,0,60980,0,46857,8377,0,116214,14123,0.05808223398021103,241357,122226,
29,0.0,0,3,26,32,27495,11488,391078,0.008758306422504268,119131,789,0.0364935219113182,3799,38125,34232,6932,79289,16076,0.01690738535345433,7689,0,3893,0,0.4406714112894209,0,60980,0,46857,8377,0,116214,14123,0.05808223398021103,241357,122226,
29,0.0,0,3,26,32,27495,11488,391078,0.008758306422504268,119131,789,0.0364935219113182,3799,38125,34232,6932,79289,16076,0.01690738535345433,7689,0,3893,0,0.4406714112894209,0,60980,0,46857,8377,0,116214,14123,0.05808223398021103,241357,122226,
29,0.0,0,3,26,32,27495,11488,391078,0.008758306422504268,119131,789,0.0364935219113182,3799,38125,34232,6932,79289,16076,0.01690738535345433,7689,0,3893,0,0.4406714112894209,0,60980,0,46857,8377,0,116214,14123,0.05808223398021103,241357,122226,
29,0.0,0,3,26,32,27495,11488,391078,0.008758306422504268,119131,789,0.0364935219113182,3799,38125,34232,6932,79289,16076,0.01690738535345433,7689,0,3893,0,0.4406714112894209,0,60980,0,46857,8377,0,116214,14123,0.05808223398021103,241357,122226,
29,0.0,0,3,26,32,27495,11488,391078,0.008758306422504268,119131,789,0.0364935219113182,3799,38125,34232,6932,79289,16076,0.01690738535345433,7689,0,3893,0,0.4406714112894209,0,60980,0,46857,8377,0,116214,14123,0.05808223398021103,241357,122226,
29,0.0,0,3,26,32,27495,11488,391078,0.008758306422504268,119131,789,0.0364935219113182,3799,38125,34232,6932,79289,16076,0.01690738535345433,7689,0,3893,0,0.4406714112894209,0,60980,0,46857,8377,0,116214,14123,0.05808223398021103,241357,122226,
29,0.0,0,3,26,32,27495,11488,391078,0.008758306422504268,119131,789,0.0364935219113182,3799,38125,34232,6932,79289,16076,0.01690738535345433,7689,0,3893,0,0.4406714112894209,0,60980,0,46857,8377,0,116214,14123,0.05808223398021103,241357,122226,
29,0.0,0,3,26,32,27495,11488,391078,0.008758306422504268,119131,789,0.0364935219113182,3799,38125,34232,6932,79289,16076,0.01690738535345433,7689,0,3893,0,0.4406714112894209,0,60980,0,46857,8377,0,116214,14123,0.05808223398021103,241357,122226,
29,0.0,0,3,26,32,27495,11488,391078,0.008758306422504268,119131,789,0.0364935219113182,3799,38125,34232,6932,79289,16076,0.01690738535345433,7689,0,3893,0,0.4406714112894209,0,60980,0,46857,8377,0,116214,14123,0.05808223398021103,241357,122226,
29,0.0,0,3,26,32,27495,11488,391078,0.008758306422504268,119131,789,0.0364935219113182,3799,38125,34232,6932,79289,16076,0.01690738535345433,7689,0,3893,0,0.4406714112894209,0,60980,0,46857,8377,0,116214,14123,0.05808223398021103,241357,122226,
29,0.0,0,3,26,32,27495,11488,391078,0.008758306422504268,119131,789,0.0364935219113182,3799,38125,34232,6932,79289,16076,0.01690738535345433,7689,0,3893,0,0.4406714112894209,0,60980,0,46857,8377,0,116214,14123,0.05808223398021103,241357,122226,
29,0.0,0,3,26,32,27495,11488,391078,0.008758306422504268,119131,789,0.0364935219113182,3799,38125,34232,6932,79289,16076,0.01690738535345433,7689,0,3893,0,0.4406714112894209,0,60980,0,46857,8377,0,116214,14123,0.05808223398021103,241357,122226,
29,0.0,0,3,26,32,27495,11488,391078,0.008758306422504268,119131,789,0.0364935219113182,3799,38125,34232,6932,79289,16076,0.01690738535345433,7689,0,3893,0,0.4406714112894209,0,60980,0,46857,8377,0,116214,14123,0.05808223398021103,241357,122226,
29,0.0,0,3,26,32,27495,11488,391078,0.008758306422504268,119131,789,0.0364935219113182,3799,38125,34232,6932,79289,16076,0.01690738535345433,7689,0,3893,0,0.4406714112894209,0,60980,0,46857,8377,0,116214,14123,0.05808223398021103,241357,122226,
29,0.0,0,3,26,32,27495,11488,391078,0.008758306422504268,119131,789,0.0364935219113182,3799,38125,34232,6932,79289,16076,0.01690738535345433,7689,0,3893,0,0.4406714112894209,0,60980,0,46857,8377,0,116214,14123,0.05808223398021103,241357,122226,
29,0.0,0,3,26,32,27495,11488,391078,0.008758306422504268,119131,789,0.0364935219113182,3799,38125,34232,6932,79289,16076,0.01690738535345433,7689,0,3893,0,0.4406714112894209,0,60980,0,46857,8377,0,116214,14123,0.05808223398021103,241357,122226,
29,0.0,0,3,26,32,27495,11488,391078,0.008758306422504268,119131,789,0.0364935219113182,3799,38125,34232,6932,79289,16076,0.01690738535345433,7689,0,3893,0,0.4406714112894209,0,60980,0,46857,8377,0,116214,14123,0.05808223398021103,241357,122226,
29,0.0,0,3,26,32,27495,11488,391078,0.008758306422504268,119131,789,0.0364935219113182,3799,38125,34232,6932,79289,16076,0.01690738535345433,7689,0,3893,0,0.4406714112894209,0,60980,0,46857,8377,0,116214,14123,0.05808223398021103,241357,122226,
29,0.0,0,3,26,32,27495,11488,391078,0.008758306422504268,119131,789,0.0364935219113182,3799,38125,34232,6932,79289,16076,0.01690738535345433,7689,0,3893,0,0.4406714112894209,0,60980,0,46857,8377,0,116214,14123,0.05808223398021103,241357,122226,
29,0.0,0,3,26,32,27495,11488,391078,0.008758306422504268,119131,789,0.0364935219113182,3799,38125,34232,6932,79289,16076,0.01690738535345433,7689,0,3893,0,0.4406714112894209,0,60980,0,46857,8377,0,116214,14123,0.05808223398021103,241357,122226,
29,0.0,0,3,26,32,27495,11488,391078,0.008758306422504268,119131,789,0.0364935219113182,3799,38125,34232,6932,79289,16076,0.01690738535345433,7689,0,3893,0,0.4406714112894209,0,60980,0,46857,8377,0,116214,14123,0.05808223398021103,241357,122226,
29,0.0,0,3,26,32,27495,11488,391078,0.008758306422504268,119131,789,0.0364935219113182,3799,38125,34232,6932,79289,16076,0.01690738535345433,7689,0,3893,0,0.4406714112894209,0,60980,0,46857,8377,0,116214,14123,0.05808223398021103,241357,122226,
29,0.0,0,3,26,32,27495,11488,391078,0.008758306422504268,119131,789,0.0364935219113182,3799,38125,34232,6932,79289,16076,0.01690738535345433,7689,0,3893,0,0.4406714112894209,0,60980,0,46857,8377,0,116214,14123,0.05808223398021103,241357,122226,
29,0.0,0,3,26,32,27495,11488,391078,0.008758306422504268,119131,789,0.0364935219113182,3799,38125,34232,6932,79289,16076,0.01690738535345433,7689,0,3893,0,0.4406714112894209,0,60980,0,46857,8377,0,116214,14123,0.05808223398021103,241357,122226,
29,0.0,0,3,26,32,27495,11488,391078,0.008758306422504268,119131,789,0.0364935219113182,3799,38125,34232,6932,79289,16076,0.01690738535345433,7689,0,3893,0,0.4406714112894209,0,60980,0,46857,8377,0,116214,14123,0.05808223398021103,241357,122226,
29,0.037037037037037035,0,3,26,32,27495,11488,391078,0.008758306422504268,119131,789,0.0364935219113182,3799,2073,1315,267,3655,16076,0.01690738535345433,7689,1,758,1,0.06570848357850959,2,60980,0,46857,8377,0,116214,14123,0.05808223398021103,241357,122226,
29,0.037037037037037035,0,3,26,32,27495,11488,391078,0.008758306422504268,119131,789,0.0364935219113182,3799,2073,1315,267,3655,16076,0.01690738535345433,7689,1,758,1,0.06570848357850959,2,60980,0,46857,8377,0,116214,14123,0.05808223398021103,241357,122226,
29,0.037037037037037035,0,3,26,32,27495,11488,391078,0.008758306422504268,119131,789,0.0364935219113182,3799,2073,1315,267,3655,16076,0.01690738535345433,7689,1,758,1,0.06570848357850959,2,60980,0,46857,8377,0,116214,14123,0.05808223398021103,241357,122226,
29,0.037037037037037035,0,3,26,32,27495,11488,391078,0.008758306422504268,119131,789,0.0364935219113182,3799,2073,1315,267,3655,16076,0.01690738535345433,7689,1,758,1,0.06570848357850959,2,60980,0,46857,8377,0,116214,14123,0.05808223398021103,241357,122226,
29,0.0,0,3,26,32,27495,11488,391078,0.008758306422504268,119131,789,0.0364935219113182,3799,4153,1290,332,5775,16076,0.01690738535345433,7689,0,2863,0,0.20506535231927892,0,60980,0,46857,8377,0,116214,14123,0.05808223398021103,241357,122226,
29,0.0,0,3,26,32,27495,11488,391078,0.008758306422504268,119131,789,0.0364935219113182,3799,4153,1290,332,5775,16076,0.01690738535345433,7689,0,2863,0,0.20506535231927892,0,60980,0,46857,8377,0,116214,14123,0.05808223398021103,241357,122226,
29,0.0,0,3,26,32,27495,11488,391078,0.008758306422504268,119131,789,0.0364935219113182,3799,4153,1290,332,5775,16076,0.01690738535345433,7689,0,2863,0,0.20506535231927892,0,60980,0,46857,8377,0,116214,14123,0.05808223398021103,241357,122226,
29,0.0,0,3,26,32,27495,11488,391078,0.008758306422504268,119131,789,0.0364935219113182,3799,4153,1290,332,5775,16076,0.01690738535345433,7689,0,2863,0,0.20506535231927892,0,60980,0,46857,8377,0,116214,14123,0.05808223398021103,241357,122226,
29,0.0,0,3,26,32,27495,11488,391078,0.008758306422504268,119131,789,0.0364935219113182,3799,464,9,0,473,16076,0.01690738535345433,7689,0,455,0,0.05992142661692834,0,60980,0,46857,8377,0,116214,14123,0.05808223398021103,241357,122226,
29,0.0,0,3,26,32,27495,11488,391078,0.008758306422504268,119131,789,0.0364935219113182,3799,464,9,0,473,16076,0.01690738535345433,7689,0,455,0,0.05992142661692834,0,60980,0,46857,8377,0,116214,14123,0.05808223398021103,241357,122226,
29,0.0,0,3,26,32,27495,11488,391078,0.008758306422504268,119131,789,0.0364935219113182,3799,464,9,0,473,16076,0.01690738535345433,7689,0,455,0,0.05992142661692834,0,60980,0,46857,8377,0,116214,14123,0.05808223398021103,241357,122226,
29,0.0,0,3,26,32,27495,11488,391078,0.008758306422504268,119131,789,0.0364935219113182,3799,726,630,50,1406,16076,0.01690738535345433,7689,0,96,0,0.07979886127609757,0,60980,0,46857,8377,0,116214,14123,0.05808223398021103,241357,122226,
29,0.0,0,3,26,32,27495,11488,391078,0.008758306422504268,119131,789,0.0364935219113182,3799,726,630,50,1406,16076,0.01690738535345433,7689,0,96,0,0.07979886127609757,0,60980,0,46857,8377,0,116214,14123,0.05808223398021103,241357,122226,
29,0.0,0,3,26,32,27495,11488,391078,0.008758306422504268,119131,789,0.0364935219113182,3799,726,630,50,1406,16076,0.01690738535345433,7689,0,96,0,0.07979886127609757,0,60980,0,46857,8377,0,116214,14123,0.05808223398021103,241357,122226,
29,0.0,0,3,26,32,27495,11488,391078,0.008758306422504268,119131,789,0.0364935219113182,3799,726,630,50,1406,16076,0.01690738535345433,7689,0,96,0,0.07979886127609757,0,60980,0,46857,8377,0,116214,14123,0.05808223398021103,241357,122226,
29,0.0,0,3,26,32,27495,11488,391078,0.008758306422504268,119131,789,0.0364935219113182,3799,879,161,71,1111,16076,0.01690738535345433,7689,0,718,0,0.04294791074333831,0,60980,0,46857,8377,0,116214,14123,0.05808223398021103,241357,122226,
29,0.0,0,3,26,32,27495,11488,391078,0.008758306422504268,119131,789,0.0364935219113182,3799,879,161,71,1111,16076,0.01690738535345433,7689,0,718,0,0.04294791074333831,0,60980,0,46857,8377,0,116214,14123,0.05808223398021103,241357,122226,
29,0.0,0,3,26,32,27495,11488,391078,0.008758306422504268,119131,789,0.0364935219113182,3799,879,161,71,1111,16076,0.01690738535345433,7689,0,718,0,0.04294791074333831,0,60980,0,46857,8377,0,116214,14123,0.05808223398021103,241357,122226,
29,0.0,0,3,26,32,27495,11488,391078,0.008758306422504268,119131,789,0.0364935219113182,3799,272,379,3,654,16076,0.01690738535345433,7689,0,-107,0,0.01653289190303147,0,60980,0,46857,8377,0,116214,14123,0.05808223398021103,241357,122226,
29,0.0,0,3,26,32,27495,11488,391078,0.008758306422504268,119131,789,0.0364935219113182,3799,272,379,3,654,16076,0.01690738535345433,7689,0,-107,0,0.01653289190303147,0,60980,0,46857,8377,0,116214,14123,0.05808223398021103,241357,122226,
29,0.0,0,3,26,32,27495,11488,391078,0.008758306422504268,119131,789,0.0364935219113182,3799,272,379,3,654,16076,0.01690738535345433,7689,0,-107,0,0.01653289190303147,0,60980,0,46857,8377,0,116214,14123,0.05808223398021103,241357,122226,
29,0.0,0,3,26,32,27495,11488,391078,0.008758306422504268,119131,789,0.0364935219113182,3799,450,381,19,850,16076,0.01690738535345433,7689,0,69,0,0.006601586156609657,0,60980,0,46857,8377,0,116214,14123,0.05808223398021103,241357,122226,
29,0.0,0,3,26,32,27495,11488,391078,0.008758306422504268,119131,789,0.0364935219113182,3799,450,381,19,850,16076,0.01690738535345433,7689,0,69,0,0.006601586156609657,0,60980,0,46857,8377,0,116214,14123,0.05808223398021103,241357,122226,
29,0.0,0,3,26,32,27495,11488,391078,0.008758306422504268,119131,789,0.0364935219113182,3799,450,381,19,850,16076,0.01690738535345433,7689,0,69,0,0.006601586156609657,0,60980,0,46857,8377,0,116214,14123,0.05808223398021103,241357,122226,
29,0.0,0,3,26,32,27495,11488,391078,0.008758306422504268,119131,789,0.0364935219113182,3799,562,488,27,1077,16076,0.01690738535345433,7689,0,74,0,0.007670647314184903,0,60980,0,46857,8377,0,116214,14123,0.05808223398021103,241357,122226,
29,0.0,0,3,26,32,27495,11488,391078,0.008758306422504268,119131,789,0.0364935219113182,3799,562,488,27,1077,16076,0.01690738535345433,7689,0,74,0,0.007670647314184903,0,60980,0,46857,8377,0,116214,14123,0.05808223398021103,241357,122226,
29,0.0,0,3,26,32,27495,11488,391078,0.008758306422504268,119131,789,0.0364935219113182,3799,562,488,27,1077,16076,0.01690738535345433,7689,0,74,0,0.007670647314184903,0,60980,0,46857,8377,0,116214,14123,0.05808223398021103,241357,122226,
29,0.0,0,3,26,32,27495,11488,391078,0.008758306422504268,119131,789,0.0364935219113182,3799,441,0,0,441,16076,0.01690738535345433,7689,0,441,0,0.07356130108423686,0,60980,0,46857,8377,0,116214,14123,0.05808223398021103,241357,122226,
29,0.0,0,3,26,32,27495,11488,391078,0.008758306422504268,119131,789,0.0364935219113182,3799,441,0,0,441,16076,0.01690738535345433,7689,0,441,0,0.07356130108423686,0,60980,0,46857,8377,0,116214,14123,0.05808223398021103,241357,122226,
29,0.0,0,3,26,32,27495,11488,391078,0.008758306422504268,119131,789,0.0364935219113182,3799,441,0,0,441,16076,0.01690738535345433,7689,0,441,0,0.07356130108423686,0,60980,0,46857,8377,0,116214,14123,0.05808223398021103,241357,122226,
29,0.0,0,3,26,32,27495,11488,391078,0.008758306422504268,119131,789,0.0364935219113182,3799,93,45,0,138,16076,0.01690738535345433,7689,0,48,0,0.004153629953178826,0,60980,0,46857,8377,0,116214,14123,0.05808223398021103,241357,122226,
29,0.0,0,3,26,32,27495,11488,391078,0.008758306422504268,119131,789,0.0364935219113182,3799,93,45,0,138,16076,0.01690738535345433,7689,0,48,0,0.004153629953178826,0,60980,0,46857,8377,0,116214,14123,0.05808223398021103,241357,122226,
29,0.0,0,3,26,32,27495,11488,391078,0.008758306422504268,119131,789,0.0364935219113182,3799,93,45,0,138,16076,0.01690738535345433,7689,0,48,0,0.004153629953178826,0,60980,0,46857,8377,0,116214,14123,0.05808223398021103,241357,122226,
29,0.0,0,3,26,32,27495,11488,391078,0.008758306422504268,119131,789,0.0364935219113182,3799,95,53,0,148,16076,0.01690738535345433,7689,0,42,0,0.0035965281181097384,0,60980,0,46857,8377,0,116214,14123,0.05808223398021103,241357,122226,
29,0.0,0,3,26,32,27495,11488,391078,0.008758306422504268,119131,789,0.0364935219113182,3799,95,53,0,148,16076,0.01690738535345433,7689,0,42,0,0.0035965281181097384,0,60980,0,46857,8377,0,116214,14123,0.05808223398021103,241357,122226,
29,0.0,0,3,26,32,27495,11488,391078,0.008758306422504268,119131,789,0.0364935219113182,3799,95,53,0,148,16076,0.01690738535345433,7689,0,42,0,0.0035965281181097384,0,60980,0,46857,8377,0,116214,14123,0.05808223398021103,241357,122226,
29,0.0,0,3,26,32,27495,11488,391078,0.008758306422504268,119131,789,0.0364935219113182,3799,281,208,100,589,16076,0.01690738535345433,7689,0,73,0,0.024351084093805396,0,60980,0,46857,8377,0,116214,14123,0.05808223398021103,241357,122226,
29,0.0,0,3,26,32,27495,11488,391078,0.008758306422504268,119131,789,0.0364935219113182,3799,281,208,100,589,16076,0.01690738535345433,7689,0,73,0,0.024351084093805396,0,60980,0,46857,8377,0,116214,14123,0.05808223398021103,241357,122226,
29,0.0,0,3,26,32,27495,11488,391078,0.008758306422504268,119131,789,0.0364935219113182,3799,281,208,100,589,16076,0.01690738535345433,7689,0,73,0,0.024351084093805396,0,60980,0,46857,8377,0,116214,14123,0.05808223398021103,241357,122226,
29,0.0,0,3,26,32,27495,11488,391078,0.008758306422504268,119131,789,0.0364935219113182,3799,726,154,66,946,16076,0.01690738535345433,7689,0,572,0,0.045051629519949205,0,60980,0,46857,8377,0,116214,14123,0.05808223398021103,241357,122226,
29,0.0,0,3,26,32,27495,11488,391078,0.008758306422504268,119131,789,0.0364935219113182,3799,726,154,66,946,16076,0.01690738535345433,7689,0,572,0,0.045051629519949205,0,60980,0,46857,8377,0,116214,14123,0.05808223398021103,241357,122226,
29,0.0,0,3,26,32,27495,11488,391078,0.008758306422504268,119131,789,0.0364935219113182,3799,726,154,66,946,16076,0.01690738535345433,7689,0,572,0,0.045051629519949205,0,60980,0,46857,8377,0,116214,14123,0.05808223398021103,241357,122226,
29,0.0,0,3,26,32,27495,11488,391078,0.008758306422504268,119131,789,0.0364935219113182,3799,397,215,54,666,16076,0.01690738535345433,7689,0,182,0,0.013857628563040894,0,60980,0,46857,8377,0,116214,14123,0.05808223398021103,241357,122226,
29,0.0,0,3,26,32,27495,11488,391078,0.008758306422504268,119131,789,0.0364935219113182,3799,397,215,54,666,16076,0.01690738535345433,7689,0,182,0,0.013857628563040894,0,60980,0,46857,8377,0,116214,14123,0.05808223398021103,241357,122226,
29,0.0,0,3,26,32,27495,11488,391078,0.008758306422504268,119131,789,0.0364935219113182,3799,397,215,54,666,16076,0.01690738535345433,7689,0,182,0,0.013857628563040894,0,60980,0,46857,8377,0,116214,14123,0.05808223398021103,241357,122226,
29,0.0,0,3,26,32,27495,11488,391078,0.008758306422504268,119131,789,0.0364935219113182,3799,173,154,0,327,16076,0.01690738535345433,7689,0,19,0,0.010206567631251152,0,60980,0,46857,8377,0,116214,14123,0.05808223398021103,241357,122226,
29,0.0,0,3,26,32,27495,11488,391078,0.008758306422504268,119131,789,0.0364935219113182,3799,173,154,0,327,16076,0.01690738535345433,7689,0,19,0,0.010206567631251152,0,60980,0,46857,8377,0,116214,14123,0.05808223398021103,241357,122226,
29,0.0,0,3,26,32,27495,11488,391078,0.008758306422504268,119131,789,0.0364935219113182,3799,173,154,0,327,16076,0.01690738535345433,7689,0,19,0,0.010206567631251152,0,60980,0,46857,8377,0,116214,14123,0.05808223398021103,241357,122226,
29,0.0,0,3,26,32,27495,11488,391078,0.008758306422504268,119131,789,0.0364935219113182,3799,167,505,5,677,16076,0.01690738535345433,7689,0,-338,0,0.011773656997188676,0,60980,0,46857,8377,0,116214,14123,0.05808223398021103,241357,122226,
29,0.0,0,3,26,32,27495,11488,391078,0.008758306422504268,119131,789,0.0364935219113182,3799,167,505,5,677,16076,0.01690738535345433,7689,0,-338,0,0.011773656997188676,0,60980,0,46857,8377,0,116214,14123,0.05808223398021103,241357,122226,
29,0.0,0,3,26,32,27495,11488,391078,0.008758306422504268,119131,789,0.0364935219113182,3799,167,505,5,677,16076,0.01690738535345433,7689,0,-338,0,0.011773656997188676,0,60980,0,46857,8377,0,116214,14123,0.05808223398021103,241357,122226,
29,0.0,0,3,26,32,27495,11488,391078,0.008758306422504268,119131,789,0.0364935219113182,3799,460,102,0,562,16076,0.01690738535345433,7689,0,358,0,0.13233934518142446,0,60980,0,46857,8377,0,116214,14123,0.05808223398021103,241357,122226,
29,0.0,0,3,26,32,27495,11488,391078,0.008758306422504268,119131,789,0.0364935219113182,3799,460,102,0,562,16076,0.01690738535345433,7689,0,358,0,0.13233934518142446,0,60980,0,46857,8377,0,116214,14123,0.05808223398021103,241357,122226,
29,0.0,0,3,26,32,27495,11488,391078,0.008758306422504268,119131,789,0.0364935219113182,3799,460,102,0,562,16076,0.01690738535345433,7689,0,358,0,0.13233934518142446,0,60980,0,46857,8377,0,116214,14123,0.05808223398021103,241357,122226,
29,0.0,0,3,26,32,27495,11488,391078,0.008758306422504268,119131,789,0.0364935219113182,3799,460,102,0,562,16076,0.01690738535345433,7689,0,358,0,0.13233934518142446,0,60980,0,46857,8377,0,116214,14123,0.05808223398021103,241357,122226,
29,0.0,0,3,26,32,27495,11488,391078,0.008758306422504268,119131,789,0.0364935219113182,3799,171,108,73,352,16076,0.01690738535345433,7689,0,63,0,0.0049341438318201555,0,60980,0,46857,8377,0,116214,14123,0.05808223398021103,241357,122226,
29,0.0,0,3,26,32,27495,11488,391078,0.008758306422504268,119131,789,0.0364935219113182,3799,171,108,73,352,16076,0.01690738535345433,7689,0,63,0,0.0049341438318201555,0,60980,0,46857,8377,0,116214,14123,0.05808223398021103,241357,122226,
29,0.0,0,3,26,32,27495,11488,391078,0.008758306422504268,119131,789,0.0364935219113182,3799,171,108,73,352,16076,0.01690738535345433,7689,0,63,0,0.0049341438318201555,0,60980,0,46857,8377,0,116214,14123,0.05808223398021103,241357,122226,
29,0.0,0,3,26,32,27495,11488,391078,0.008758306422504268,119131,789,0.0364935219113182,3799,560,62,0,622,16076,0.01690738535345433,7689,0,498,0,0.016022896130518775,0,60980,0,46857,8377,0,116214,14123,0.05808223398021103,241357,122226,
29,0.0,0,3,26,32,27495,11488,391078,0.008758306422504268,119131,789,0.0364935219113182,3799,560,62,0,622,16076,0.01690738535345433,7689,0,498,0,0.016022896130518775,0,60980,0,46857,8377,0,116214,14123,0.05808223398021103,241357,122226,
29,0.0,0,3,26,32,27495,11488,391078,0.008758306422504268,119131,789,0.0364935219113182,3799,560,62,0,622,16076,0.01690738535345433,7689,0,498,0,0.016022896130518775,0,60980,0,46857,8377,0,116214,14123,0.05808223398021103,241357,122226,
29,0.0,0,3,26,32,27495,11488,391078,0.008758306422504268,119131,789,0.0364935219113182,3799,359,276,11,646,16076,0.01690738535345433,7689,0,83,0,0.028342474560881226,0,60980,0,46857,8377,0,116214,14123,0.05808223398021103,241357,122226,
29,0.0,0,3,26,32,27495,11488,391078,0.008758306422504268,119131,789,0.0364935219113182,3799,359,276,11,646,16076,0.01690738535345433,7689,0,83,0,0.028342474560881226,0,60980,0,46857,8377,0,116214,14123,0.05808223398021103,241357,122226,
29,0.0,0,3,26,32,27495,11488,391078,0.008758306422504268,119131,789,0.0364935219113182,3799,359,276,11,646,16076,0.01690738535345433,7689,0,83,0,0.028342474560881226,0,60980,0,46857,8377,0,116214,14123,0.05808223398021103,241357,122226,
29,0.0,0,3,26,32,27495,11488,391078,0.008758306422504268,119131,789,0.0364935219113182,3799,442,46,0,488,16076,0.01690738535345433,7689,0,396,0,0.011875825244738345,0,60980,0,46857,8377,0,116214,14123,0.05808223398021103,241357,122226,
29,0.0,0,3,26,32,27495,11488,391078,0.008758306422504268,119131,789,0.0364935219113182,3799,442,46,0,488,16076,0.01690738535345433,7689,0,396,0,0.011875825244738345,0,60980,0,46857,8377,0,116214,14123,0.05808223398021103,241357,122226,
29,0.0,0,3,26,32,27495,11488,391078,0.008758306422504268,119131,789,0.0364935219113182,3799,442,46,0,488,16076,0.01690738535345433,7689,0,396,0,0.011875825244738345,0,60980,0,46857,8377,0,116214,14123,0.05808223398021103,241357,122226,
29,0.0,0,3,26,32,27495,11488,391078,0.008758306422504268,119131,789,0.0364935219113182,3799,695,150,50,895,16076,0.01690738535345433,7689,0,545,0,0.023132821742193308,0,60980,0,46857,8377,0,116214,14123,0.05808223398021103,241357,122226,
29,0.0,0,3,26,32,27495,11488,391078,0.008758306422504268,119131,789,0.0364935219113182,3799,695,150,50,895,16076,0.01690738535345433,7689,0,545,0,0.023132821742193308,0,60980,0,46857,8377,0,116214,14123,0.05808223398021103,241357,122226,
29,0.0,0,3,26,32,27495,11488,391078,0.008758306422504268,119131,789,0.0364935219113182,3799,695,150,50,895,16076,0.01690738535345433,7689,0,545,0,0.023132821742193308,0,60980,0,46857,8377,0,116214,14123,0.05808223398021103,241357,122226,
29,0.0,0,3,26,32,27495,11488,391078,0.008758306422504268,119131,789,0.0364935219113182,3799,95,458,0,553,16076,0.01690738535345433,7689,0,-363,0,0.010416468806001094,0,60980,0,46857,8377,0,116214,14123,0.05808223398021103,241357,122226,
29,0.0,0,3,26,32,27495,11488,391078,0.008758306422504268,119131,789,0.0364935219113182,3799,95,458,0,553,16076,0.01690738535345433,7689,0,-363,0,0.010416468806001094,0,60980,0,46857,8377,0,116214,14123,0.05808223398021103,241357,122226,
29,0.0,0,3,26,32,27495,11488,391078,0.008758306422504268,119131,789,0.0364935219113182,3799,95,458,0,553,16076,0.01690738535345433,7689,0,-363,0,0.010416468806001094,0,60980,0,46857,8377,0,116214,14123,0.05808223398021103,241357,122226,
29,0.0,0,3,26,32,27495,11488,391078,0.008758306422504268,119131,789,0.0364935219113182,3799,1188,763,2,1953,16076,0.01690738535345433,7689,0,425,0,0.06737963370378139,0,60980,0,46857,8377,0,116214,14123,0.05808223398021103,241357,122226,
29,0.0,0,3,26,32,27495,11488,391078,0.008758306422504268,119131,789,0.0364935219113182,3799,1188,763,2,1953,16076,0.01690738535345433,7689,0,425,0,0.06737963370378139,0,60980,0,46857,8377,0,116214,14123,0.05808223398021103,241357,122226,
29,0.0,0,3,26,32,27495,11488,391078,0.008758306422504268,119131,789,0.0364935219113182,3799,1188,763,2,1953,16076,0.01690738535345433,7689,0,425,0,0.06737963370378139,0,60980,0,46857,8377,0,116214,14123,0.05808223398021103,241357,122226,
29,0.0,0,3,26,32,27495,11488,391078,0.008758306422504268,119131,789,0.0364935219113182,3799,890,0,0,890,16076,0.01690738535345433,7689,0,890,0,0.12604446962186658,0,60980,0,46857,8377,0,116214,14123,0.05808223398021103,241357,122226,
29,0.0,0,3,26,32,27495,11488,391078,0.008758306422504268,119131,789,0.0364935219113182,3799,890,0,0,890,16076,0.01690738535345433,7689,0,890,0,0.12604446962186658,0,60980,0,46857,8377,0,116214,14123,0.05808223398021103,241357,122226,
29,0.0,0,3,26,32,27495,11488,391078,0.008758306422504268,119131,789,0.0364935219113182,3799,890,0,0,890,16076,0.01690738535345433,7689,0,890,0,0.12604446962186658,0,60980,0,46857,8377,0,116214,14123,0.05808223398021103,241357,122226,
29,0.0,0,3,26,32,27495,11488,391078,0.008758306422504268,119131,789,0.0364935219113182,3799,136,5,1,142,16076,0.01690738535345433,7689,0,131,0,0.01861021179650107,0,60980,0,46857,8377,0,116214,14123,0.05808223398021103,241357,122226,
29,0.0,0,3,26,32,27495,11488,391078,0.008758306422504268,119131,789,0.0364935219113182,3799,136,5,1,142,16076,0.01690738535345433,7689,0,131,0,0.01861021179650107,0,60980,0,46857,8377,0,116214,14123,0.05808223398021103,241357,122226,
29,0.0,0,3,26,32,27495,11488,391078,0.008758306422504268,119131,789,0.0364935219113182,3799,136,5,1,142,16076,0.01690738535345433,7689,0,131,0,0.01861021179650107,0,60980,0,46857,8377,0,116214,14123,0.05808223398021103,241357,122226,
29,0.0,0,3,26,32,27495,11488,391078,0.008758306422504268,119131,789,0.0364935219113182,3799,136,5,1,142,16076,0.01690738535345433,7689,0,131,0,0.01861021179650107,0,60980,0,46857,8377,0,116214,14123,0.05808223398021103,241357,122226,
29,0.0,0,3,26,32,27495,11488,391078,0.008758306422504268,119131,789,0.0364935219113182,3799,136,5,1,142,16076,0.01690738535345433,7689,0,131,0,0.01861021179650107,0,60980,0,46857,8377,0,116214,14123,0.05808223398021103,241357,122226,
29,0.0,0,3,26,32,27495,11488,391078,0.008758306422504268,119131,789,0.0364935219113182,3799,136,5,1,142,16076,0.01690738535345433,7689,0,131,0,0.01861021179650107,0,60980,0,46857,8377,0,116214,14123,0.05808223398021103,241357,122226,
29,0.0,0,3,26,32,27495,11488,391078,0.008758306422504268,119131,789,0.0364935219113182,3799,136,5,1,142,16076,0.01690738535345433,7689,0,131,0,0.01861021179650107,0,60980,0,46857,8377,0,116214,14123,0.05808223398021103,241357,122226,
29,0.0,0,3,26,32,27495,11488,391078,0.008758306422504268,119131,789,0.0364935219113182,3799,136,5,1,142,16076,0.01690738535345433,7689,0,131,0,0.01861021179650107,0,60980,0,46857,8377,0,116214,14123,0.05808223398021103,241357,122226,
29,0.0,0,3,26,32,27495,11488,391078,0.008758306422504268,119131,789,0.0364935219113182,3799,487,432,21,940,16076,0.01690738535345433,7689,0,55,0,0.008419601116209178,0,60980,0,46857,8377,0,116214,14123,0.05808223398021103,241357,122226,
29,0.0,0,3,26,32,27495,11488,391078,0.008758306422504268,119131,789,0.0364935219113182,3799,487,432,21,940,16076,0.01690738535345433,7689,0,55,0,0.008419601116209178,0,60980,0,46857,8377,0,116214,14123,0.05808223398021103,241357,122226,
29,0.0,0,3,26,32,27495,11488,391078,0.008758306422504268,119131,789,0.0364935219113182,3799,487,432,21,940,16076,0.01690738535345433,7689,0,55,0,0.008419601116209178,0,60980,0,46857,8377,0,116214,14123,0.05808223398021103,241357,122226,
29,0.0,0,3,26,32,27495,11488,391078,0.008758306422504268,119131,789,0.0364935219113182,3799,257,179,2,438,16076,0.01690738535345433,7689,0,78,0,0.019334316607573444,0,60980,0,46857,8377,0,116214,14123,0.05808223398021103,241357,122226,
29,0.0,0,3,26,32,27495,11488,391078,0.008758306422504268,119131,789,0.0364935219113182,3799,257,179,2,438,16076,0.01690738535345433,7689,0,78,0,0.019334316607573444,0,60980,0,46857,8377,0,116214,14123,0.05808223398021103,241357,122226,
29,0.0,0,3,26,32,27495,11488,391078,0.008758306422504268,119131,789,0.0364935219113182,3799,257,179,2,438,16076,0.01690738535345433,7689,0,78,0,0.019334316607573444,0,60980,0,46857,8377,0,116214,14123,0.05808223398021103,241357,122226,
29,0.0,0,3,26,32,27495,11488,391078,0.008758306422504268,119131,789,0.0364935219113182,3799,257,179,2,438,16076,0.01690738535345433,7689,0,78,0,0.019334316607573444,0,60980,0,46857,8377,0,116214,14123,0.05808223398021103,241357,122226,
29,0.0,0,3,26,32,27495,11488,391078,0.008758306422504268,119131,789,0.0364935219113182,3799,257,179,2,438,16076,0.01690738535345433,7689,0,78,0,0.019334316607573444,0,60980,0,46857,8377,0,116214,14123,0.05808223398021103,241357,122226,
29,0.0,0,3,26,32,27495,11488,391078,0.008758306422504268,119131,789,0.0364935219113182,3799,257,179,2,438,16076,0.01690738535345433,7689,0,78,0,0.019334316607573444,0,60980,0,46857,8377,0,116214,14123,0.05808223398021103,241357,122226,
29,0.0,0,3,26,32,27495,11488,391078,0.008758306422504268,119131,789,0.0364935219113182,3799,257,179,2,438,16076,0.01690738535345433,7689,0,78,0,0.019334316607573444,0,60980,0,46857,8377,0,116214,14123,0.05808223398021103,241357,122226,
29,0.0,0,3,26,32,27495,11488,391078,0.008758306422504268,119131,789,0.0364935219113182,3799,192,31,0,223,16076,0.01690738535345433,7689,0,161,0,0.01694210022151688,0,60980,0,46857,8377,0,116214,14123,0.05808223398021103,241357,122226,
29,0.0,0,3,26,32,27495,11488,391078,0.008758306422504268,119131,789,0.0364935219113182,3799,192,31,0,223,16076,0.01690738535345433,7689,0,161,0,0.01694210022151688,0,60980,0,46857,8377,0,116214,14123,0.05808223398021103,241357,122226,
29,0.0,0,3,26,32,27495,11488,391078,0.008758306422504268,119131,789,0.0364935219113182,3799,192,31,0,223,16076,0.01690738535345433,7689,0,161,0,0.01694210022151688,0,60980,0,46857,8377,0,116214,14123,0.05808223398021103,241357,122226,
29,0.0,0,3,26,32,27495,11488,391078,0.008758306422504268,119131,789,0.0364935219113182,3799,192,31,0,223,16076,0.01690738535345433,7689,0,161,0,0.01694210022151688,0,60980,0,46857,8377,0,116214,14123,0.05808223398021103,241357,122226,
29,0.0,0,3,26,32,27495,11488,391078,0.008758306422504268,119131,789,0.0364935219113182,3799,192,31,0,223,16076,0.01690738535345433,7689,0,161,0,0.01694210022151688,0,60980,0,46857,8377,0,116214,14123,0.05808223398021103,241357,122226,
29,0.0,0,3,26,32,27495,11488,391078,0.008758306422504268,119131,789,0.0364935219113182,3799,192,31,0,223,16076,0.01690738535345433,7689,0,161,0,0.01694210022151688,0,60980,0,46857,8377,0,116214,14123,0.05808223398021103,241357,122226,
29,0.0,0,3,26,32,27495,11488,391078,0.008758306422504268,119131,789,0.0364935219113182,3799,192,31,0,223,16076,0.01690738535345433,7689,0,161,0,0.01694210022151688,0,60980,0,46857,8377,0,116214,14123,0.05808223398021103,241357,122226,
29,0.0,0,3,26,32,27495,11488,391078,0.008758306422504268,119131,789,0.0364935219113182,3799,167,451,2,620,16076,0.01690738535345433,7689,0,-284,0,0.009422920735794841,0,60980,0,46857,8377,0,116214,14123,0.05808223398021103,241357,122226,
29,0.0,0,3,26,32,27495,11488,391078,0.008758306422504268,119131,789,0.0364935219113182,3799,167,451,2,620,16076,0.01690738535345433,7689,0,-284,0,0.009422920735794841,0,60980,0,46857,8377,0,116214,14123,0.05808223398021103,241357,122226,
29,0.0,0,3,26,32,27495,11488,391078,0.008758306422504268,119131,789,0.0364935219113182,3799,167,451,2,620,16076,0.01690738535345433,7689,0,-284,0,0.009422920735794841,0,60980,0,46857,8377,0,116214,14123,0.05808223398021103,241357,122226,
29,0.0,0,3,26,32,27495,11488,391078,0.008758306422504268,119131,789,0.0364935219113182,3799,303,607,1,911,16076,0.01690738535345433,7689,0,-304,0,0.018446022513876704,0,60980,0,46857,8377,0,116214,14123,0.05808223398021103,241357,122226,
29,0.0,0,3,26,32,27495,11488,391078,0.008758306422504268,119131,789,0.0364935219113182,3799,303,607,1,911,16076,0.01690738535345433,7689,0,-304,0,0.018446022513876704,0,60980,0,46857,8377,0,116214,14123,0.05808223398021103,241357,122226,
29,0.0,0,3,26,32,27495,11488,391078,0.008758306422504268,119131,789,0.0364935219113182,3799,303,607,1,911,16076,0.01690738535345433,7689,0,-304,0,0.018446022513876704,0,60980,0,46857,8377,0,116214,14123,0.05808223398021103,241357,122226,
29,0.0,0,3,26,32,27495,11488,391078,0.008758306422504268,119131,789,0.0364935219113182,3799,515,427,27,969,16076,0.01690738535345433,7689,0,88,0,0.01616129167672354,0,60980,0,46857,8377,0,116214,14123,0.05808223398021103,241357,122226,
29,0.0,0,3,26,32,27495,11488,391078,0.008758306422504268,119131,789,0.0364935219113182,3799,515,427,27,969,16076,0.01690738535345433,7689,0,88,0,0.01616129167672354,0,60980,0,46857,8377,0,116214,14123,0.05808223398021103,241357,122226,
29,0.0,0,3,26,32,27495,11488,391078,0.008758306422504268,119131,789,0.0364935219113182,3799,515,427,27,969,16076,0.01690738535345433,7689,0,88,0,0.01616129167672354,0,60980,0,46857,8377,0,116214,14123,0.05808223398021103,241357,122226,
29,0.0,0,3,26,32,27495,11488,391078,0.008758306422504268,119131,789,0.0364935219113182,3799,251,262,30,543,16076,0.01690738535345433,7689,0,-11,0,0.03429005382400407,0,60980,0,46857,8377,0,116214,14123,0.05808223398021103,241357,122226,
29,0.0,0,3,26,32,27495,11488,391078,0.008758306422504268,119131,789,0.0364935219113182,3799,251,262,30,543,16076,0.01690738535345433,7689,0,-11,0,0.03429005382400407,0,60980,0,46857,8377,0,116214,14123,0.05808223398021103,241357,122226,
29,0.0,0,3,26,32,27495,11488,391078,0.008758306422504268,119131,789,0.0364935219113182,3799,251,262,30,543,16076,0.01690738535345433,7689,0,-11,0,0.03429005382400407,0,60980,0,46857,8377,0,116214,14123,0.05808223398021103,241357,122226,
29,0.0,0,3,26,32,27495,11488,391078,0.008758306422504268,119131,789,0.0364935219113182,3799,512,178,3,693,16076,0.01690738535345433,7689,0,334,0,0.018677541495202874,0,60980,0,46857,8377,0,116214,14123,0.05808223398021103,241357,122226,
29,0.0,0,3,26,32,27495,11488,391078,0.008758306422504268,119131,789,0.0364935219113182,3799,512,178,3,693,16076,0.01690738535345433,7689,0,334,0,0.018677541495202874,0,60980,0,46857,8377,0,116214,14123,0.05808223398021103,241357,122226,
29,0.0,0,3,26,32,27495,11488,391078,0.008758306422504268,119131,789,0.0364935219113182,3799,512,178,3,693,16076,0.01690738535345433,7689,0,334,0,0.018677541495202874,0,60980,0,46857,8377,0,116214,14123,0.05808223398021103,241357,122226,
29,0.0,0,3,26,32,27495,11488,391078,0.008758306422504268,119131,789,0.0364935219113182,3799,479,18,0,497,16076,0.01690738535345433,7689,0,461,0,0.07077446117342194,0,60980,0,46857,8377,0,116214,14123,0.05808223398021103,241357,122226,
29,0.0,0,3,26,32,27495,11488,391078,0.008758306422504268,119131,789,0.0364935219113182,3799,479,18,0,497,16076,0.01690738535345433,7689,0,461,0,0.07077446117342194,0,60980,0,46857,8377,0,116214,14123,0.05808223398021103,241357,122226,
29,0.0,0,3,26,32,27495,11488,391078,0.008758306422504268,119131,789,0.0364935219113182,3799,479,18,0,497,16076,0.01690738535345433,7689,0,461,0,0.07077446117342194,0,60980,0,46857,8377,0,116214,14123,0.05808223398021103,241357,122226,
29,0.0,0,3,26,32,27495,11488,391078,0.008758306422504268,119131,789,0.0364935219113182,3799,92,230,16,338,16076,0.01690738535345433,7689,0,-138,0,0.006643917948547717,0,60980,0,46857,8377,0,116214,14123,0.05808223398021103,241357,122226,
29,0.0,0,3,26,32,27495,11488,391078,0.008758306422504268,119131,789,0.0364935219113182,3799,92,230,16,338,16076,0.01690738535345433,7689,0,-138,0,0.006643917948547717,0,60980,0,46857,8377,0,116214,14123,0.05808223398021103,241357,122226,
29,0.0,0,3,26,32,27495,11488,391078,0.008758306422504268,119131,789,0.0364935219113182,3799,92,230,16,338,16076,0.01690738535345433,7689,0,-138,0,0.006643917948547717,0,60980,0,46857,8377,0,116214,14123,0.05808223398021103,241357,122226,
29,0.0,0,3,26,32,27495,11488,391078,0.008758306422504268,119131,789,0.0364935219113182,3799,92,230,16,338,16076,0.01690738535345433,7689,0,-138,0,0.006643917948547717,0,60980,0,46857,8377,0,116214,14123,0.05808223398021103,241357,122226,
29,0.0,0,3,26,32,27495,11488,391078,0.008758306422504268,119131,789,0.0364935219113182,3799,92,230,16,338,16076,0.01690738535345433,7689,0,-138,0,0.006643917948547717,0,60980,0,46857,8377,0,116214,14123,0.05808223398021103,241357,122226,
29,0.0,0,3,26,32,27495,11488,391078,0.008758306422504268,119131,789,0.0364935219113182,3799,92,230,16,338,16076,0.01690738535345433,7689,0,-138,0,0.006643917948547717,0,60980,0,46857,8377,0,116214,14123,0.05808223398021103,241357,122226,
29,0.0,0,3,26,32,27495,11488,391078,0.008758306422504268,119131,789,0.0364935219113182,3799,92,230,16,338,16076,0.01690738535345433,7689,0,-138,0,0.006643917948547717,0,60980,0,46857,8377,0,116214,14123,0.05808223398021103,241357,122226,
29,0.0,0,3,26,32,27495,11488,391078,0.008758306422504268,119131,789,0.0364935219113182,3799,5,5,0,10,16076,0.01690738535345433,7689,0,0,0,0.0036116869447006873,0,60980,0,46857,8377,0,116214,14123,0.05808223398021103,241357,122226,
341,0.0,77,122,219,540,27495,11488,391078,0.04197225723519737,119131,789,0.0364935219113182,3799,109,4,0,113,16076,0.01690738535345433,7689,0,105,0,0.31547619047619047,0,4335,0,2668,318,0,7321,1667,0.03754726974055076,241357,122226,
341,0.0,77,122,219,540,27495,11488,391078,0.04197225723519737,119131,789,0.0364935219113182,3799,109,4,0,113,16076,0.01690738535345433,7689,0,105,0,0.31547619047619047,0,4335,0,2668,318,0,7321,1667,0.03754726974055076,241357,122226,
341,0.08317279907532267,77,122,219,540,27495,11488,391078,0.04197225723519737,119131,789,0.0364935219113182,3799,618,143,13,774,16076,0.01690738535345433,7689,35,475,91,0.10674925557749931,128,4335,2,2668,318,56,7321,1667,0.03754726974055076,241357,122226,
341,0.08317279907532267,77,122,219,540,27495,11488,391078,0.04197225723519737,119131,789,0.0364935219113182,3799,618,143,13,774,16076,0.01690738535345433,7689,35,475,91,0.10674925557749931,128,4335,2,2668,318,56,7321,1667,0.03754726974055076,241357,122226,
341,0.08317279907532267,77,122,219,540,27495,11488,391078,0.04197225723519737,119131,789,0.0364935219113182,3799,618,143,13,774,16076,0.01690738535345433,7689,35,475,91,0.10674925557749931,128,4335,2,2668,318,56,7321,1667,0.03754726974055076,241357,122226,
341,0.08317279907532267,77,122,219,540,27495,11488,391078,0.04197225723519737,119131,789,0.0364935219113182,3799,618,143,13,774,16076,0.01690738535345433,7689,35,475,91,0.10674925557749931,128,4335,2,2668,318,56,7321,1667,0.03754726974055076,241357,122226,
341,0.08317279907532267,77,122,219,540,27495,11488,391078,0.04197225723519737,119131,789,0.0364935219113182,3799,618,143,13,774,16076,0.01690738535345433,7689,35,475,91,0.10674925557749931,128,4335,2,2668,318,56,7321,1667,0.03754726974055076,241357,122226,
341,0.08317279907532267,77,122,219,540,27495,11488,391078,0.04197225723519737,119131,789,0.0364935219113182,3799,618,143,13,774,16076,0.01690738535345433,7689,35,475,91,0.10674925557749931,128,4335,2,2668,318,56,7321,1667,0.03754726974055076,241357,122226,
341,0.08317279907532267,77,122,219,540,27495,11488,391078,0.04197225723519737,119131,789,0.0364935219113182,3799,618,143,13,774,16076,0.01690738535345433,7689,35,475,91,0.10674925557749931,128,4335,2,2668,318,56,7321,1667,0.03754726974055076,241357,122226,
341,0.08317279907532267,77,122,219,540,27495,11488,391078,0.04197225723519737,119131,789,0.0364935219113182,3799,618,143,13,774,16076,0.01690738535345433,7689,35,475,91,0.10674925557749931,128,4335,2,2668,318,56,7321,1667,0.03754726974055076,241357,122226,
341,0.08317279907532267,77,122,219,540,27495,11488,391078,0.04197225723519737,119131,789,0.0364935219113182,3799,618,143,13,774,16076,0.01690738535345433,7689,35,475,91,0.10674925557749931,128,4335,2,2668,318,56,7321,1667,0.03754726974055076,241357,122226,
341,0.060048851718367144,77,122,219,540,27495,11488,391078,0.04197225723519737,119131,789,0.0364935219113182,3799,1367,584,32,1983,16076,0.01690738535345433,7689,16,783,17,0.08076487342780163,39,4335,6,2668,318,1,7321,1667,0.03754726974055076,241357,122226,
341,0.060048851718367144,77,122,219,540,27495,11488,391078,0.04197225723519737,119131,789,0.0364935219113182,3799,1367,584,32,1983,16076,0.01690738535345433,7689,16,783,17,0.08076487342780163,39,4335,6,2668,318,1,7321,1667,0.03754726974055076,241357,122226,
341,0.060048851718367144,77,122,219,540,27495,11488,391078,0.04197225723519737,119131,789,0.0364935219113182,3799,1367,584,32,1983,16076,0.01690738535345433,7689,16,783,17,0.08076487342780163,39,4335,6,2668,318,1,7321,1667,0.03754726974055076,241357,122226,
341,0.15420103089650447,77,122,219,540,27495,11488,391078,0.04197225723519737,119131,789,0.0364935219113182,3799,200,116,29,345,16076,0.01690738535345433,7689,45,84,92,0.1622581095553191,142,4335,5,2668,318,47,7321,1667,0.03754726974055076,241357,122226,
341,0.15420103089650447,77,122,219,540,27495,11488,391078,0.04197225723519737,119131,789,0.0364935219113182,3799,200,116,29,345,16076,0.01690738535345433,7689,45,84,92,0.1622581095553191,142,4335,5,2668,318,47,7321,1667,0.03754726974055076,241357,122226,
341,0.15420103089650447,77,122,219,540,27495,11488,391078,0.04197225723519737,119131,789,0.0364935219113182,3799,200,116,29,345,16076,0.01690738535345433,7689,45,84,92,0.1622581095553191,142,4335,5,2668,318,47,7321,1667,0.03754726974055076,241357,122226,
341,0.15420103089650447,77,122,219,540,27495,11488,391078,0.04197225723519737,119131,789,0.0364935219113182,3799,200,116,29,345,16076,0.01690738535345433,7689,45,84,92,0.1622581095553191,142,4335,5,2668,318,47,7321,1667,0.03754726974055076,241357,122226,
341,0.15420103089650447,77,122,219,540,27495,11488,391078,0.04197225723519737,119131,789,0.0364935219113182,3799,200,116,29,345,16076,0.01690738535345433,7689,45,84,92,0.1622581095553191,142,4335,5,2668,318,47,7321,1667,0.03754726974055076,241357,122226,
341,0.15420103089650447,77,122,219,540,27495,11488,391078,0.04197225723519737,119131,789,0.0364935219113182,3799,200,116,29,345,16076,0.01690738535345433,7689,45,84,92,0.1622581095553191,142,4335,5,2668,318,47,7321,1667,0.03754726974055076,241357,122226,
341,0.060048851718367144,77,122,219,540,27495,11488,391078,0.04197225723519737,119131,789,0.0364935219113182,3799,1367,584,32,1983,16076,0.01690738535345433,7689,16,783,17,0.08076487342780163,39,4335,6,2668,318,1,7321,1667,0.03754726974055076,241357,122226,
341,0.1810344827586207,77,122,219,540,27495,11488,391078,0.04197225723519737,119131,789,0.0364935219113182,3799,317,211,1,529,16076,0.01690738535345433,7689,10,106,11,0.06044491248677326,21,4335,0,2668,318,1,7321,1667,0.03754726974055076,241357,122226,
341,0.1810344827586207,77,122,219,540,27495,11488,391078,0.04197225723519737,119131,789,0.0364935219113182,3799,317,211,1,529,16076,0.01690738535345433,7689,10,106,11,0.06044491248677326,21,4335,0,2668,318,1,7321,1667,0.03754726974055076,241357,122226,
341,0.1810344827586207,77,122,219,540,27495,11488,391078,0.04197225723519737,119131,789,0.0364935219113182,3799,317,211,1,529,16076,0.01690738535345433,7689,10,106,11,0.06044491248677326,21,4335,0,2668,318,1,7321,1667,0.03754726974055076,241357,122226,
341,0.1810344827586207,77,122,219,540,27495,11488,391078,0.04197225723519737,119131,789,0.0364935219113182,3799,317,211,1,529,16076,0.01690738535345433,7689,10,106,11,0.06044491248677326,21,4335,0,2668,318,1,7321,1667,0.03754726974055076,241357,122226,
341,0.1810344827586207,77,122,219,540,27495,11488,391078,0.04197225723519737,119131,789,0.0364935219113182,3799,317,211,1,529,16076,0.01690738535345433,7689,10,106,11,0.06044491248677326,21,4335,0,2668,318,1,7321,1667,0.03754726974055076,241357,122226,
341,0.1810344827586207,77,122,219,540,27495,11488,391078,0.04197225723519737,119131,789,0.0364935219113182,3799,317,211,1,529,16076,0.01690738535345433,7689,10,106,11,0.06044491248677326,21,4335,0,2668,318,1,7321,1667,0.03754726974055076,241357,122226,
341,0.1810344827586207,77,122,219,540,27495,11488,391078,0.04197225723519737,119131,789,0.0364935219113182,3799,317,211,1,529,16076,0.01690738535345433,7689,10,106,11,0.06044491248677326,21,4335,0,2668,318,1,7321,1667,0.03754726974055076,241357,122226,
341,0.1810344827586207,77,122,219,540,27495,11488,391078,0.04197225723519737,119131,789,0.0364935219113182,3799,317,211,1,529,16076,0.01690738535345433,7689,10,106,11,0.06044491248677326,21,4335,0,2668,318,1,7321,1667,0.03754726974055076,241357,122226,
341,0.1810344827586207,77,122,219,540,27495,11488,391078,0.04197225723519737,119131,789,0.0364935219113182,3799,317,211,1,529,16076,0.01690738535345433,7689,10,106,11,0.06044491248677326,21,4335,0,2668,318,1,7321,1667,0.03754726974055076,241357,122226,
341,0.1810344827586207,77,122,219,540,27495,11488,391078,0.04197225723519737,119131,789,0.0364935219113182,3799,317,211,1,529,16076,0.01690738535345433,7689,10,106,11,0.06044491248677326,21,4335,0,2668,318,1,7321,1667,0.03754726974055076,241357,122226,
341,0.1810344827586207,77,122,219,540,27495,11488,391078,0.04197225723519737,119131,789,0.0364935219113182,3799,317,211,1,529,16076,0.01690738535345433,7689,10,106,11,0.06044491248677326,21,4335,0,2668,318,1,7321,1667,0.03754726974055076,241357,122226,
341,0.1810344827586207,77,122,219,540,27495,11488,391078,0.04197225723519737,119131,789,0.0364935219113182,3799,317,211,1,529,16076,0.01690738535345433,7689,10,106,11,0.06044491248677326,21,4335,0,2668,318,1,7321,1667,0.03754726974055076,241357,122226,
341,0.1810344827586207,77,122,219,540,27495,11488,391078,0.04197225723519737,119131,789,0.0364935219113182,3799,317,211,1,529,16076,0.01690738535345433,7689,10,106,11,0.06044491248677326,21,4335,0,2668,318,1,7321,1667,0.03754726974055076,241357,122226,
341,0.1810344827586207,77,122,219,540,27495,11488,391078,0.04197225723519737,119131,789,0.0364935219113182,3799,317,211,1,529,16076,0.01690738535345433,7689,10,106,11,0.06044491248677326,21,4335,0,2668,318,1,7321,1667,0.03754726974055076,241357,122226,
341,0.1810344827586207,77,122,219,540,27495,11488,391078,0.04197225723519737,119131,789,0.0364935219113182,3799,317,211,1,529,16076,0.01690738535345433,7689,10,106,11,0.06044491248677326,21,4335,0,2668,318,1,7321,1667,0.03754726974055076,241357,122226,
341,0.1810344827586207,77,122,219,540,27495,11488,391078,0.04197225723519737,119131,789,0.0364935219113182,3799,317,211,1,529,16076,0.01690738535345433,7689,10,106,11,0.06044491248677326,21,4335,0,2668,318,1,7321,1667,0.03754726974055076,241357,122226,
341,0.23809523809523808,77,122,219,540,27495,11488,391078,0.04197225723519737,119131,789,0.0364935219113182,3799,482,706,74,1262,16076,0.01690738535345433,7689,2,-224,8,0.0738177904146188,10,4335,0,2668,318,6,7321,1667,0.03754726974055076,241357,122226,
341,0.23809523809523808,77,122,219,540,27495,11488,391078,0.04197225723519737,119131,789,0.0364935219113182,3799,482,706,74,1262,16076,0.01690738535345433,7689,2,-224,8,0.0738177904146188,10,4335,0,2668,318,6,7321,1667,0.03754726974055076,241357,122226,
341,0.23809523809523808,77,122,219,540,27495,11488,391078,0.04197225723519737,119131,789,0.0364935219113182,3799,482,706,74,1262,16076,0.01690738535345433,7689,2,-224,8,0.0738177904146188,10,4335,0,2668,318,6,7321,1667,0.03754726974055076,241357,122226,
341,0.23809523809523808,77,122,219,540,27495,11488,391078,0.04197225723519737,119131,789,0.0364935219113182,3799,482,706,74,1262,16076,0.01690738535345433,7689,2,-224,8,0.0738177904146188,10,4335,0,2668,318,6,7321,1667,0.03754726974055076,241357,122226,
341,0.0,77,122,219,540,27495,11488,391078,0.04197225723519737,119131,789,0.0364935219113182,3799,30,13,4,47,16076,0.01690738535345433,7689,0,17,0,0.04546533444983639,0,4335,0,2668,318,0,7321,1667,0.03754726974055076,241357,122226,
341,0.0,77,122,219,540,27495,11488,391078,0.04197225723519737,119131,789,0.0364935219113182,3799,30,13,4,47,16076,0.01690738535345433,7689,0,17,0,0.04546533444983639,0,4335,0,2668,318,0,7321,1667,0.03754726974055076,241357,122226,
341,0.0,77,122,219,540,27495,11488,391078,0.04197225723519737,119131,789,0.0364935219113182,3799,30,13,4,47,16076,0.01690738535345433,7689,0,17,0,0.04546533444983639,0,4335,0,2668,318,0,7321,1667,0.03754726974055076,241357,122226,
341,0.0,77,122,219,540,27495,11488,391078,0.04197225723519737,119131,789,0.0364935219113182,3799,30,13,4,47,16076,0.01690738535345433,7689,0,17,0,0.04546533444983639,0,4335,0,2668,318,0,7321,1667,0.03754726974055076,241357,122226,
341,0.019734019734019732,77,122,219,540,27495,11488,391078,0.04197225723519737,119131,789,0.0364935219113182,3799,206,5,0,211,16076,0.01690738535345433,7689,2,201,2,0.10194989924660147,4,4335,0,2668,318,0,7321,1667,0.03754726974055076,241357,122226,
341,0.019734019734019732,77,122,219,540,27495,11488,391078,0.04197225723519737,119131,789,0.0364935219113182,3799,206,5,0,211,16076,0.01690738535345433,7689,2,201,2,0.10194989924660147,4,4335,0,2668,318,0,7321,1667,0.03754726974055076,241357,122226,
341,0.019734019734019732,77,122,219,540,27495,11488,391078,0.04197225723519737,119131,789,0.0364935219113182,3799,206,5,0,211,16076,0.01690738535345433,7689,2,201,2,0.10194989924660147,4,4335,0,2668,318,0,7321,1667,0.03754726974055076,241357,122226,
341,0.019734019734019732,77,122,219,540,27495,11488,391078,0.04197225723519737,119131,789,0.0364935219113182,3799,206,5,0,211,16076,0.01690738535345433,7689,2,201,2,0.10194989924660147,4,4335,0,2668,318,0,7321,1667,0.03754726974055076,241357,122226,
341,0.0,77,122,219,540,27495,11488,391078,0.04197225723519737,119131,789,0.0364935219113182,3799,2,6,0,8,16076,0.01690738535345433,7689,0,-4,0,0.028091403317737813,0,4335,0,2668,318,0,7321,1667,0.03754726974055076,241357,122226,
341,0.0,77,122,219,540,27495,11488,391078,0.04197225723519737,119131,789,0.0364935219113182,3799,2,6,0,8,16076,0.01690738535345433,7689,0,-4,0,0.028091403317737813,0,4335,0,2668,318,0,7321,1667,0.03754726974055076,241357,122226,
341,0.0,77,122,219,540,27495,11488,391078,0.04197225723519737,119131,789,0.0364935219113182,3799,2,6,0,8,16076,0.01690738535345433,7689,0,-4,0,0.028091403317737813,0,4335,0,2668,318,0,7321,1667,0.03754726974055076,241357,122226,
21,0.061224489795918366,1,2,19,24,27495,11488,391078,0.04446064139941691,119131,789,0.0364935219113182,3799,126,94,4,224,16076,0.01690738535345433,7689,2,32,3,0.08182353673125019,6,202,1,111,8,1,321,91,0.02959019962747669,241357,122226,
102,0.018433179723502304,22,36,66,160,27495,11488,391078,0.016631493566222587,119131,789,0.0364935219113182,3799,347,75,34,456,16076,0.01690738535345433,7689,11,272,0,0.07405082252548678,12,2232,1,445,97,-11,2774,1787,0.039830295752584295,241357,122226,
102,0.018433179723502304,22,36,66,160,27495,11488,391078,0.016631493566222587,119131,789,0.0364935219113182,3799,347,75,34,456,16076,0.01690738535345433,7689,11,272,0,0.07405082252548678,12,2232,1,445,97,-11,2774,1787,0.039830295752584295,241357,122226,
102,0.0,22,36,66,160,27495,11488,391078,0.016631493566222587,119131,789,0.0364935219113182,3799,162,13,0,175,16076,0.01690738535345433,7689,0,149,0,0.027772459166939906,0,2232,0,445,97,0,2774,1787,0.039830295752584295,241357,122226,
102,0.0,22,36,66,160,27495,11488,391078,0.016631493566222587,119131,789,0.0364935219113182,3799,162,13,0,175,16076,0.01690738535345433,7689,0,149,0,0.027772459166939906,0,2232,0,445,97,0,2774,1787,0.039830295752584295,241357,122226,
102,0.0,22,36,66,160,27495,11488,391078,0.016631493566222587,119131,789,0.0364935219113182,3799,162,13,0,175,16076,0.01690738535345433,7689,0,149,0,0.027772459166939906,0,2232,0,445,97,0,2774,1787,0.039830295752584295,241357,122226,
102,0.06666666666666667,22,36,66,160,27495,11488,391078,0.016631493566222587,119131,789,0.0364935219113182,3799,161,30,3,194,16076,0.01690738535345433,7689,1,131,1,0.07425806586425963,2,2232,0,445,97,0,2774,1787,0.039830295752584295,241357,122226,
102,0.06666666666666667,22,36,66,160,27495,11488,391078,0.016631493566222587,119131,789,0.0364935219113182,3799,161,30,3,194,16076,0.01690738535345433,7689,1,131,1,0.07425806586425963,2,2232,0,445,97,0,2774,1787,0.039830295752584295,241357,122226,
102,0.06666666666666667,22,36,66,160,27495,11488,391078,0.016631493566222587,119131,789,0.0364935219113182,3799,161,30,3,194,16076,0.01690738535345433,7689,1,131,1,0.07425806586425963,2,2232,0,445,97,0,2774,1787,0.039830295752584295,241357,122226,
102,0.2237350884409708,22,36,66,160,27495,11488,391078,0.016631493566222587,119131,789,0.0364935219113182,3799,258,74,47,379,16076,0.01690738535345433,7689,3,184,68,0.15696161472199766,92,2232,21,445,97,65,2774,1787,0.039830295752584295,241357,122226,
102,0.2237350884409708,22,36,66,160,27495,11488,391078,0.016631493566222587,119131,789,0.0364935219113182,3799,258,74,47,379,16076,0.01690738535345433,7689,3,184,68,0.15696161472199766,92,2232,21,445,97,65,2774,1787,0.039830295752584295,241357,122226,
102,0.2237350884409708,22,36,66,160,27495,11488,391078,0.016631493566222587,119131,789,0.0364935219113182,3799,258,74,47,379,16076,0.01690738535345433,7689,3,184,68,0.15696161472199766,92,2232,21,445,97,65,2774,1787,0.039830295752584295,241357,122226,
15,0.0,2,5,10,22,27495,11488,391078,0.020029955141342724,119131,789,0.0364935219113182,3799,53,5,0,58,16076,0.01690738535345433,7689,0,48,0,0.12642857271047,0,1268,0,406,73,0,1747,862,0.03294781368954812,241357,122226,
15,0.0,2,5,10,22,27495,11488,391078,0.020029955141342724,119131,789,0.0364935219113182,3799,53,5,0,58,16076,0.01690738535345433,7689,0,48,0,0.12642857271047,0,1268,0,406,73,0,1747,862,0.03294781368954812,241357,122226,
15,0.0,2,5,10,22,27495,11488,391078,0.020029955141342724,119131,789,0.0364935219113182,3799,77,5,0,82,16076,0.01690738535345433,7689,0,72,0,0.10619897533775412,0,1268,0,406,73,0,1747,862,0.03294781368954812,241357,122226,
15,0.0,2,5,10,22,27495,11488,391078,0.020029955141342724,119131,789,0.0364935219113182,3799,77,5,0,82,16076,0.01690738535345433,7689,0,72,0,0.10619897533775412,0,1268,0,406,73,0,1747,862,0.03294781368954812,241357,122226,
15,0.0,2,5,10,22,27495,11488,391078,0.020029955141342724,119131,789,0.0364935219113182,3799,8,6,0,14,16076,0.01690738535345433,7689,0,2,0,0.010557128427404805,0,1268,0,406,73,0,1747,862,0.03294781368954812,241357,122226,
15,0.0,2,5,10,22,27495,11488,391078,0.020029955141342724,119131,789,0.0364935219113182,3799,8,6,0,14,16076,0.01690738535345433,7689,0,2,0,0.010557128427404805,0,1268,0,406,73,0,1747,862,0.03294781368954812,241357,122226,
15,0.19047619047619047,2,5,10,22,27495,11488,391078,0.020029955141342724,119131,789,0.0364935219113182,3799,217,21,0,238,16076,0.01690738535345433,7689,4,196,4,0.0844211821362357,8,1268,0,406,73,0,1747,862,0.03294781368954812,241357,122226,
15,0.06179775280898876,2,5,10,22,27495,11488,391078,0.020029955141342724,119131,789,0.0364935219113182,3799,238,54,6,298,16076,0.01690738535345433,7689,0,184,10,0.0204589482446571,11,1268,1,406,73,10,1747,862,0.03294781368954812,241357,122226,
15,0.06179775280898876,2,5,10,22,27495,11488,391078,0.020029955141342724,119131,789,0.0364935219113182,3799,238,54,6,298,16076,0.01690738535345433,7689,0,184,10,0.0204589482446571,11,1268,1,406,73,10,1747,862,0.03294781368954812,241357,122226,
15,0.06179775280898876,2,5,10,22,27495,11488,391078,0.020029955141342724,119131,789,0.0364935219113182,3799,238,54,6,298,16076,0.01690738535345433,7689,0,184,10,0.0204589482446571,11,1268,1,406,73,10,1747,862,0.03294781368954812,241357,122226,
15,0.06179775280898876,2,5,10,22,27495,11488,391078,0.020029955141342724,119131,789,0.0364935219113182,3799,238,54,6,298,16076,0.01690738535345433,7689,0,184,10,0.0204589482446571,11,1268,1,406,73,10,1747,862,0.03294781368954812,241357,122226,
15,0.06179775280898876,2,5,10,22,27495,11488,391078,0.020029955141342724,119131,789,0.0364935219113182,3799,238,54,6,298,16076,0.01690738535345433,7689,0,184,10,0.0204589482446571,11,1268,1,406,73,10,1747,862,0.03294781368954812,241357,122226,
15,0.08823529411764706,2,5,10,22,27495,11488,391078,0.020029955141342724,119131,789,0.0364935219113182,3799,138,32,2,172,16076,0.01690738535345433,7689,1,106,1,0.03314081964139085,3,1268,1,406,73,0,1747,862,0.03294781368954812,241357,122226,
15,0.08823529411764706,2,5,10,22,27495,11488,391078,0.020029955141342724,119131,789,0.0364935219113182,3799,138,32,2,172,16076,0.01690738535345433,7689,1,106,1,0.03314081964139085,3,1268,1,406,73,0,1747,862,0.03294781368954812,241357,122226,
15,0.0,2,5,10,22,27495,11488,391078,0.020029955141342724,119131,789,0.0364935219113182,3799,81,9,0,90,16076,0.01690738535345433,7689,0,72,0,0.004816764118266682,0,1268,0,406,73,0,1747,862,0.03294781368954812,241357,122226,
15,0.0,2,5,10,22,27495,11488,391078,0.020029955141342724,119131,789,0.0364935219113182,3799,106,35,12,153,16076,0.01690738535345433,7689,0,71,0,0.026044227564440265,0,1268,0,406,73,0,1747,862,0.03294781368954812,241357,122226,
15,0.0,2,5,10,22,27495,11488,391078,0.020029955141342724,119131,789,0.0364935219113182,3799,27,68,27,122,16076,0.01690738535345433,7689,0,-41,0,0.03640407811879098,0,1268,0,406,73,0,1747,862,0.03294781368954812,241357,122226,
15,0.0,2,5,10,22,27495,11488,391078,0.020029955141342724,119131,789,0.0364935219113182,3799,27,68,27,122,16076,0.01690738535345433,7689,0,-41,0,0.03640407811879098,0,1268,0,406,73,0,1747,862,0.03294781368954812,241357,122226,
1,0.0,0,1,0,2,27495,11488,391078,0.0010070493454179255,119131,789,0.0364935219113182,3799,20,1,0,21,16076,0.01690738535345433,7689,0,19,0,0.0863762102351314,0,768,0,31,0,0,799,737,0.17020646503483708,241357,122226,
1,0.0,0,1,0,2,27495,11488,391078,0.0010070493454179255,119131,789,0.0364935219113182,3799,20,1,0,21,16076,0.01690738535345433,7689,0,19,0,0.0863762102351314,0,768,0,31,0,0,799,737,0.17020646503483708,241357,122226,
1,0.0,0,1,0,2,27495,11488,391078,0.0010070493454179255,119131,789,0.0364935219113182,3799,20,1,0,21,16076,0.01690738535345433,7689,0,19,0,0.0863762102351314,0,768,0,31,0,0,799,737,0.17020646503483708,241357,122226,
1,0.0,0,1,0,2,27495,11488,391078,0.0010070493454179255,119131,789,0.0364935219113182,3799,70,25,0,95,16076,0.01690738535345433,7689,0,45,0,0.09490439960388462,0,768,0,31,0,0,799,737,0.17020646503483708,241357,122226,
1,0.006042296072507553,0,1,0,2,27495,11488,391078,0.0010070493454179255,119131,789,0.0364935219113182,3799,264,1,0,265,16076,0.01690738535345433,7689,1,263,1,0.25302114803625375,2,768,0,31,0,0,799,737,0.17020646503483708,241357,122226,
1,0.006042296072507553,0,1,0,2,27495,11488,391078,0.0010070493454179255,119131,789,0.0364935219113182,3799,264,1,0,265,16076,0.01690738535345433,7689,1,263,1,0.25302114803625375,2,768,0,31,0,0,799,737,0.17020646503483708,241357,122226,
1,0.0,0,1,0,2,27495,11488,391078,0.0010070493454179255,119131,789,0.0364935219113182,3799,297,3,0,300,16076,0.01690738535345433,7689,0,294,0,0.25883365521125345,0,768,0,31,0,0,799,737,0.17020646503483708,241357,122226,
1,0.0,0,1,0,2,27495,11488,391078,0.0010070493454179255,119131,789,0.0364935219113182,3799,297,3,0,300,16076,0.01690738535345433,7689,0,294,0,0.25883365521125345,0,768,0,31,0,0,799,737,0.17020646503483708,241357,122226,
1,0.0,0,1,0,2,27495,11488,391078,0.0010070493454179255,119131,789,0.0364935219113182,3799,297,3,0,300,16076,0.01690738535345433,7689,0,294,0,0.25883365521125345,0,768,0,31,0,0,799,737,0.17020646503483708,241357,122226,
10,0.0,0,33,-23,43,27495,11488,391078,0.005510181824195358,119131,789,0.0364935219113182,3799,148,1,0,149,16076,0.01690738535345433,7689,0,147,0,0.2443927304964539,0,9142,0,3346,564,0,13052,5796,0.03989226963543097,241357,122226,
10,0.0,0,33,-23,43,27495,11488,391078,0.005510181824195358,119131,789,0.0364935219113182,3799,148,1,0,149,16076,0.01690738535345433,7689,0,147,0,0.2443927304964539,0,9142,0,3346,564,0,13052,5796,0.03989226963543097,241357,122226,
10,0.0,0,33,-23,43,27495,11488,391078,0.005510181824195358,119131,789,0.0364935219113182,3799,105,19,0,124,16076,0.01690738535345433,7689,0,86,0,0.1088979474872186,0,9142,0,3346,564,0,13052,5796,0.03989226963543097,241357,122226,
10,0.0,0,33,-23,43,27495,11488,391078,0.005510181824195358,119131,789,0.0364935219113182,3799,29,0,0,29,16076,0.01690738535345433,7689,0,29,0,7.37350622934147E-4,0,9142,0,3346,564,0,13052,5796,0.03989226963543097,241357,122226,
10,0.0,0,33,-23,43,27495,11488,391078,0.005510181824195358,119131,789,0.0364935219113182,3799,20,6,0,26,16076,0.01690738535345433,7689,0,14,0,0.02242816167223642,0,9142,0,3346,564,0,13052,5796,0.03989226963543097,241357,122226,
10,0.0,0,33,-23,43,27495,11488,391078,0.005510181824195358,119131,789,0.0364935219113182,3799,20,6,0,26,16076,0.01690738535345433,7689,0,14,0,0.02242816167223642,0,9142,0,3346,564,0,13052,5796,0.03989226963543097,241357,122226,
10,0.0,0,33,-23,43,27495,11488,391078,0.005510181824195358,119131,789,0.0364935219113182,3799,20,6,0,26,16076,0.01690738535345433,7689,0,14,0,0.02242816167223642,0,9142,0,3346,564,0,13052,5796,0.03989226963543097,241357,122226,
10,0.0,0,33,-23,43,27495,11488,391078,0.005510181824195358,119131,789,0.0364935219113182,3799,20,6,0,26,16076,0.01690738535345433,7689,0,14,0,0.02242816167223642,0,9142,0,3346,564,0,13052,5796,0.03989226963543097,241357,122226,
10,0.0,0,33,-23,43,27495,11488,391078,0.005510181824195358,119131,789,0.0364935219113182,3799,36,35,0,71,16076,0.01690738535345433,7689,0,1,0,0.0555729344405263,0,9142,0,3346,564,0,13052,5796,0.03989226963543097,241357,122226,
10,0.0,0,33,-23,43,27495,11488,391078,0.005510181824195358,119131,789,0.0364935219113182,3799,36,35,0,71,16076,0.01690738535345433,7689,0,1,0,0.0555729344405263,0,9142,0,3346,564,0,13052,5796,0.03989226963543097,241357,122226,
10,0.0,0,33,-23,43,27495,11488,391078,0.005510181824195358,119131,789,0.0364935219113182,3799,36,35,0,71,16076,0.01690738535345433,7689,0,1,0,0.0555729344405263,0,9142,0,3346,564,0,13052,5796,0.03989226963543097,241357,122226,
10,0.0,0,33,-23,43,27495,11488,391078,0.005510181824195358,119131,789,0.0364935219113182,3799,36,35,0,71,16076,0.01690738535345433,7689,0,1,0,0.0555729344405263,0,9142,0,3346,564,0,13052,5796,0.03989226963543097,241357,122226,
10,0.0,0,33,-23,43,27495,11488,391078,0.005510181824195358,119131,789,0.0364935219113182,3799,275,65,11,351,16076,0.01690738535345433,7689,0,210,0,0.09460501420040407,0,9142,0,3346,564,0,13052,5796,0.03989226963543097,241357,122226,
10,0.0,0,33,-23,43,27495,11488,391078,0.005510181824195358,119131,789,0.0364935219113182,3799,275,65,11,351,16076,0.01690738535345433,7689,0,210,0,0.09460501420040407,0,9142,0,3346,564,0,13052,5796,0.03989226963543097,241357,122226,
10,0.0,0,33,-23,43,27495,11488,391078,0.005510181824195358,119131,789,0.0364935219113182,3799,275,65,11,351,16076,0.01690738535345433,7689,0,210,0,0.09460501420040407,0,9142,0,3346,564,0,13052,5796,0.03989226963543097,241357,122226,
10,0.0,0,33,-23,43,27495,11488,391078,0.005510181824195358,119131,789,0.0364935219113182,3799,275,65,11,351,16076,0.01690738535345433,7689,0,210,0,0.09460501420040407,0,9142,0,3346,564,0,13052,5796,0.03989226963543097,241357,122226,
10,0.0,0,33,-23,43,27495,11488,391078,0.005510181824195358,119131,789,0.0364935219113182,3799,271,19,1,291,16076,0.01690738535345433,7689,0,252,0,0.06049162252013149,0,9142,0,3346,564,0,13052,5796,0.03989226963543097,241357,122226,
10,0.0,0,33,-23,43,27495,11488,391078,0.005510181824195358,119131,789,0.0364935219113182,3799,271,19,1,291,16076,0.01690738535345433,7689,0,252,0,0.06049162252013149,0,9142,0,3346,564,0,13052,5796,0.03989226963543097,241357,122226,
10,0.03572706668257187,0,33,-23,43,27495,11488,391078,0.005510181824195358,119131,789,0.0364935219113182,3799,1068,686,56,1810,16076,0.01690738535345433,7689,12,382,1,0.07042280349080722,13,9142,0,3346,564,-11,13052,5796,0.03989226963543097,241357,122226,
10,0.03572706668257187,0,33,-23,43,27495,11488,391078,0.005510181824195358,119131,789,0.0364935219113182,3799,1068,686,56,1810,16076,0.01690738535345433,7689,12,382,1,0.07042280349080722,13,9142,0,3346,564,-11,13052,5796,0.03989226963543097,241357,122226,
10,0.03572706668257187,0,33,-23,43,27495,11488,391078,0.005510181824195358,119131,789,0.0364935219113182,3799,1068,686,56,1810,16076,0.01690738535345433,7689,12,382,1,0.07042280349080722,13,9142,0,3346,564,-11,13052,5796,0.03989226963543097,241357,122226,
10,0.03572706668257187,0,33,-23,43,27495,11488,391078,0.005510181824195358,119131,789,0.0364935219113182,3799,1068,686,56,1810,16076,0.01690738535345433,7689,12,382,1,0.07042280349080722,13,9142,0,3346,564,-11,13052,5796,0.03989226963543097,241357,122226,
10,0.03572706668257187,0,33,-23,43,27495,11488,391078,0.005510181824195358,119131,789,0.0364935219113182,3799,1068,686,56,1810,16076,0.01690738535345433,7689,12,382,1,0.07042280349080722,13,9142,0,3346,564,-11,13052,5796,0.03989226963543097,241357,122226,
10,0.0625,0,33,-23,43,27495,11488,391078,0.005510181824195358,119131,789,0.0364935219113182,3799,397,9,0,406,16076,0.01690738535345433,7689,9,388,0,0.07645610339330448,9,9142,0,3346,564,-9,13052,5796,0.03989226963543097,241357,122226,
10,0.0,0,33,-23,43,27495,11488,391078,0.005510181824195358,119131,789,0.0364935219113182,3799,27,29,0,56,16076,0.01690738535345433,7689,0,-2,0,0.023138867541496945,0,9142,0,3346,564,0,13052,5796,0.03989226963543097,241357,122226,
10,0.0,0,33,-23,43,27495,11488,391078,0.005510181824195358,119131,789,0.0364935219113182,3799,127,49,102,278,16076,0.01690738535345433,7689,0,78,0,0.019106233604599947,0,9142,0,3346,564,0,13052,5796,0.03989226963543097,241357,122226,
10,0.0,0,33,-23,43,27495,11488,391078,0.005510181824195358,119131,789,0.0364935219113182,3799,127,49,102,278,16076,0.01690738535345433,7689,0,78,0,0.019106233604599947,0,9142,0,3346,564,0,13052,5796,0.03989226963543097,241357,122226,
10,0.1,0,33,-23,43,27495,11488,391078,0.005510181824195358,119131,789,0.0364935219113182,3799,108,2,0,110,16076,0.01690738535345433,7689,2,106,2,0.07941478439425051,4,9142,0,3346,564,0,13052,5796,0.03989226963543097,241357,122226,
10,0.1,0,33,-23,43,27495,11488,391078,0.005510181824195358,119131,789,0.0364935219113182,3799,108,2,0,110,16076,0.01690738535345433,7689,2,106,2,0.07941478439425051,4,9142,0,3346,564,0,13052,5796,0.03989226963543097,241357,122226,
10,0.1,0,33,-23,43,27495,11488,391078,0.005510181824195358,119131,789,0.0364935219113182,3799,108,2,0,110,16076,0.01690738535345433,7689,2,106,2,0.07941478439425051,4,9142,0,3346,564,0,13052,5796,0.03989226963543097,241357,122226,
10,0.1,0,33,-23,43,27495,11488,391078,0.005510181824195358,119131,789,0.0364935219113182,3799,108,2,0,110,16076,0.01690738535345433,7689,2,106,2,0.07941478439425051,4,9142,0,3346,564,0,13052,5796,0.03989226963543097,241357,122226,
10,0.0,0,33,-23,43,27495,11488,391078,0.005510181824195358,119131,789,0.0364935219113182,3799,4,4,0,8,16076,0.01690738535345433,7689,0,0,0,0.0891883124984405,0,9142,0,3346,564,0,13052,5796,0.03989226963543097,241357,122226,
10,0.0,0,33,-23,43,27495,11488,391078,0.005510181824195358,119131,789,0.0364935219113182,3799,4,4,0,8,16076,0.01690738535345433,7689,0,0,0,0.0891883124984405,0,9142,0,3346,564,0,13052,5796,0.03989226963543097,241357,122226,
10,0.0,0,33,-23,43,27495,11488,391078,0.005510181824195358,119131,789,0.0364935219113182,3799,190,38,4,232,16076,0.01690738535345433,7689,0,152,0,0.010674518218673495,0,9142,0,3346,564,0,13052,5796,0.03989226963543097,241357,122226,
10,0.0,0,33,-23,43,27495,11488,391078,0.005510181824195358,119131,789,0.0364935219113182,3799,190,38,4,232,16076,0.01690738535345433,7689,0,152,0,0.010674518218673495,0,9142,0,3346,564,0,13052,5796,0.03989226963543097,241357,122226,
10,0.0,0,33,-23,43,27495,11488,391078,0.005510181824195358,119131,789,0.0364935219113182,3799,13,247,0,260,16076,0.01690738535345433,7689,0,-234,0,0.037231813113504715,0,9142,0,3346,564,0,13052,5796,0.03989226963543097,241357,122226,
10,0.0,0,33,-23,43,27495,11488,391078,0.005510181824195358,119131,789,0.0364935219113182,3799,13,247,0,260,16076,0.01690738535345433,7689,0,-234,0,0.037231813113504715,0,9142,0,3346,564,0,13052,5796,0.03989226963543097,241357,122226,
10,0.0,0,33,-23,43,27495,11488,391078,0.005510181824195358,119131,789,0.0364935219113182,3799,13,247,0,260,16076,0.01690738535345433,7689,0,-234,0,0.037231813113504715,0,9142,0,3346,564,0,13052,5796,0.03989226963543097,241357,122226,
10,0.0,0,33,-23,43,27495,11488,391078,0.005510181824195358,119131,789,0.0364935219113182,3799,13,247,0,260,16076,0.01690738535345433,7689,0,-234,0,0.037231813113504715,0,9142,0,3346,564,0,13052,5796,0.03989226963543097,241357,122226,
10,0.0,0,33,-23,43,27495,11488,391078,0.005510181824195358,119131,789,0.0364935219113182,3799,13,247,0,260,16076,0.01690738535345433,7689,0,-234,0,0.037231813113504715,0,9142,0,3346,564,0,13052,5796,0.03989226963543097,241357,122226,
10,0.0,0,33,-23,43,27495,11488,391078,0.005510181824195358,119131,789,0.0364935219113182,3799,13,247,0,260,16076,0.01690738535345433,7689,0,-234,0,0.037231813113504715,0,9142,0,3346,564,0,13052,5796,0.03989226963543097,241357,122226,
10,0.0,0,33,-23,43,27495,11488,391078,0.005510181824195358,119131,789,0.0364935219113182,3799,13,247,0,260,16076,0.01690738535345433,7689,0,-234,0,0.037231813113504715,0,9142,0,3346,564,0,13052,5796,0.03989226963543097,241357,122226,
10,0.0,0,33,-23,43,27495,11488,391078,0.005510181824195358,119131,789,0.0364935219113182,3799,13,247,0,260,16076,0.01690738535345433,7689,0,-234,0,0.037231813113504715,0,9142,0,3346,564,0,13052,5796,0.03989226963543097,241357,122226,
10,0.0,0,33,-23,43,27495,11488,391078,0.005510181824195358,119131,789,0.0364935219113182,3799,13,247,0,260,16076,0.01690738535345433,7689,0,-234,0,0.037231813113504715,0,9142,0,3346,564,0,13052,5796,0.03989226963543097,241357,122226,
10,0.0,0,33,-23,43,27495,11488,391078,0.005510181824195358,119131,789,0.0364935219113182,3799,323,15,3,341,16076,0.01690738535345433,7689,0,308,0,0.07011773364447284,0,9142,0,3346,564,0,13052,5796,0.03989226963543097,241357,122226,
10,0.0,0,33,-23,43,27495,11488,391078,0.005510181824195358,119131,789,0.0364935219113182,3799,323,15,3,341,16076,0.01690738535345433,7689,0,308,0,0.07011773364447284,0,9142,0,3346,564,0,13052,5796,0.03989226963543097,241357,122226,
10,0.0,0,33,-23,43,27495,11488,391078,0.005510181824195358,119131,789,0.0364935219113182,3799,323,15,3,341,16076,0.01690738535345433,7689,0,308,0,0.07011773364447284,0,9142,0,3346,564,0,13052,5796,0.03989226963543097,241357,122226,
10,0.0,0,33,-23,43,27495,11488,391078,0.005510181824195358,119131,789,0.0364935219113182,3799,323,15,3,341,16076,0.01690738535345433,7689,0,308,0,0.07011773364447284,0,9142,0,3346,564,0,13052,5796,0.03989226963543097,241357,122226,
10,0.0,0,33,-23,43,27495,11488,391078,0.005510181824195358,119131,789,0.0364935219113182,3799,323,15,3,341,16076,0.01690738535345433,7689,0,308,0,0.07011773364447284,0,9142,0,3346,564,0,13052,5796,0.03989226963543097,241357,122226,
10,0.0,0,33,-23,43,27495,11488,391078,0.005510181824195358,119131,789,0.0364935219113182,3799,323,15,3,341,16076,0.01690738535345433,7689,0,308,0,0.07011773364447284,0,9142,0,3346,564,0,13052,5796,0.03989226963543097,241357,122226,
10,0.0,0,33,-23,43,27495,11488,391078,0.005510181824195358,119131,789,0.0364935219113182,3799,323,15,3,341,16076,0.01690738535345433,7689,0,308,0,0.07011773364447284,0,9142,0,3346,564,0,13052,5796,0.03989226963543097,241357,122226,
10,0.0,0,33,-23,43,27495,11488,391078,0.005510181824195358,119131,789,0.0364935219113182,3799,323,15,3,341,16076,0.01690738535345433,7689,0,308,0,0.07011773364447284,0,9142,0,3346,564,0,13052,5796,0.03989226963543097,241357,122226,
10,0.0,0,33,-23,43,27495,11488,391078,0.005510181824195358,119131,789,0.0364935219113182,3799,323,15,3,341,16076,0.01690738535345433,7689,0,308,0,0.07011773364447284,0,9142,0,3346,564,0,13052,5796,0.03989226963543097,241357,122226,
10,0.0,0,33,-23,43,27495,11488,391078,0.005510181824195358,119131,789,0.0364935219113182,3799,323,15,3,341,16076,0.01690738535345433,7689,0,308,0,0.07011773364447284,0,9142,0,3346,564,0,13052,5796,0.03989226963543097,241357,122226,
10,0.0,0,33,-23,43,27495,11488,391078,0.005510181824195358,119131,789,0.0364935219113182,3799,323,15,3,341,16076,0.01690738535345433,7689,0,308,0,0.07011773364447284,0,9142,0,3346,564,0,13052,5796,0.03989226963543097,241357,122226,
10,0.0,0,33,-23,43,27495,11488,391078,0.005510181824195358,119131,789,0.0364935219113182,3799,103,0,0,103,16076,0.01690738535345433,7689,0,103,0,0.05438225976768744,0,9142,0,3346,564,0,13052,5796,0.03989226963543097,241357,122226,
10,0.0,0,33,-23,43,27495,11488,391078,0.005510181824195358,119131,789,0.0364935219113182,3799,48,51,12,111,16076,0.01690738535345433,7689,0,-3,0,0.0092331242097747,0,9142,0,3346,564,0,13052,5796,0.03989226963543097,241357,122226,
10,0.0,0,33,-23,43,27495,11488,391078,0.005510181824195358,119131,789,0.0364935219113182,3799,48,51,12,111,16076,0.01690738535345433,7689,0,-3,0,0.0092331242097747,0,9142,0,3346,564,0,13052,5796,0.03989226963543097,241357,122226,
10,0.0,0,33,-23,43,27495,11488,391078,0.005510181824195358,119131,789,0.0364935219113182,3799,59,0,0,59,16076,0.01690738535345433,7689,0,59,0,0.10068259385665529,0,9142,0,3346,564,0,13052,5796,0.03989226963543097,241357,122226,
10,0.0,0,33,-23,43,27495,11488,391078,0.005510181824195358,119131,789,0.0364935219113182,3799,52,55,28,135,16076,0.01690738535345433,7689,0,-3,0,0.06656716665431771,0,9142,0,3346,564,0,13052,5796,0.03989226963543097,241357,122226,
10,0.0,0,33,-23,43,27495,11488,391078,0.005510181824195358,119131,789,0.0364935219113182,3799,0,0,0,0,16076,0.01690738535345433,7689,0,0,0,0.0,0,9142,0,3346,564,0,13052,5796,0.03989226963543097,241357,122226,
10,0.0,0,33,-23,43,27495,11488,391078,0.005510181824195358,119131,789,0.0364935219113182,3799,985,105,28,1118,16076,0.01690738535345433,7689,0,880,0,0.10116224464501115,0,9142,0,3346,564,0,13052,5796,0.03989226963543097,241357,122226,
10,0.0,0,33,-23,43,27495,11488,391078,0.005510181824195358,119131,789,0.0364935219113182,3799,985,105,28,1118,16076,0.01690738535345433,7689,0,880,0,0.10116224464501115,0,9142,0,3346,564,0,13052,5796,0.03989226963543097,241357,122226,
10,0.0,0,33,-23,43,27495,11488,391078,0.005510181824195358,119131,789,0.0364935219113182,3799,985,105,28,1118,16076,0.01690738535345433,7689,0,880,0,0.10116224464501115,0,9142,0,3346,564,0,13052,5796,0.03989226963543097,241357,122226,
4,0.0,0,4,0,8,27495,11488,391078,0.0031478706851841183,119131,789,0.0364935219113182,3799,628,269,39,936,16076,0.01690738535345433,7689,0,359,0,0.13295065572201564,0,4084,0,1757,402,0,6243,2327,0.04752618952964013,241357,122226,
4,0.0,0,4,0,8,27495,11488,391078,0.0031478706851841183,119131,789,0.0364935219113182,3799,628,269,39,936,16076,0.01690738535345433,7689,0,359,0,0.13295065572201564,0,4084,0,1757,402,0,6243,2327,0.04752618952964013,241357,122226,
10,0.0,0,33,-23,43,27495,11488,391078,0.005510181824195358,119131,789,0.0364935219113182,3799,152,240,4,396,16076,0.01690738535345433,7689,0,-88,0,0.06002989680800239,0,9142,0,3346,564,0,13052,5796,0.03989226963543097,241357,122226,
10,0.0,0,33,-23,43,27495,11488,391078,0.005510181824195358,119131,789,0.0364935219113182,3799,152,240,4,396,16076,0.01690738535345433,7689,0,-88,0,0.06002989680800239,0,9142,0,3346,564,0,13052,5796,0.03989226963543097,241357,122226,
10,0.0,0,33,-23,43,27495,11488,391078,0.005510181824195358,119131,789,0.0364935219113182,3799,152,240,4,396,16076,0.01690738535345433,7689,0,-88,0,0.06002989680800239,0,9142,0,3346,564,0,13052,5796,0.03989226963543097,241357,122226,
10,0.0,0,33,-23,43,27495,11488,391078,0.005510181824195358,119131,789,0.0364935219113182,3799,152,240,4,396,16076,0.01690738535345433,7689,0,-88,0,0.06002989680800239,0,9142,0,3346,564,0,13052,5796,0.03989226963543097,241357,122226,
10,0.0,0,33,-23,43,27495,11488,391078,0.005510181824195358,119131,789,0.0364935219113182,3799,152,240,4,396,16076,0.01690738535345433,7689,0,-88,0,0.06002989680800239,0,9142,0,3346,564,0,13052,5796,0.03989226963543097,241357,122226,
10,0.0,0,33,-23,43,27495,11488,391078,0.005510181824195358,119131,789,0.0364935219113182,3799,152,240,4,396,16076,0.01690738535345433,7689,0,-88,0,0.06002989680800239,0,9142,0,3346,564,0,13052,5796,0.03989226963543097,241357,122226,
10,0.0,0,33,-23,43,27495,11488,391078,0.005510181824195358,119131,789,0.0364935219113182,3799,152,240,4,396,16076,0.01690738535345433,7689,0,-88,0,0.06002989680800239,0,9142,0,3346,564,0,13052,5796,0.03989226963543097,241357,122226,
10,0.0,0,33,-23,43,27495,11488,391078,0.005510181824195358,119131,789,0.0364935219113182,3799,152,240,4,396,16076,0.01690738535345433,7689,0,-88,0,0.06002989680800239,0,9142,0,3346,564,0,13052,5796,0.03989226963543097,241357,122226,
10,0.00641025641025641,0,33,-23,43,27495,11488,391078,0.005510181824195358,119131,789,0.0364935219113182,3799,278,21,34,333,16076,0.01690738535345433,7689,1,257,0,0.04434108013248992,1,9142,0,3346,564,-1,13052,5796,0.03989226963543097,241357,122226,
10,0.00641025641025641,0,33,-23,43,27495,11488,391078,0.005510181824195358,119131,789,0.0364935219113182,3799,278,21,34,333,16076,0.01690738535345433,7689,1,257,0,0.04434108013248992,1,9142,0,3346,564,-1,13052,5796,0.03989226963543097,241357,122226,
10,0.00641025641025641,0,33,-23,43,27495,11488,391078,0.005510181824195358,119131,789,0.0364935219113182,3799,278,21,34,333,16076,0.01690738535345433,7689,1,257,0,0.04434108013248992,1,9142,0,3346,564,-1,13052,5796,0.03989226963543097,241357,122226,
10,0.00641025641025641,0,33,-23,43,27495,11488,391078,0.005510181824195358,119131,789,0.0364935219113182,3799,278,21,34,333,16076,0.01690738535345433,7689,1,257,0,0.04434108013248992,1,9142,0,3346,564,-1,13052,5796,0.03989226963543097,241357,122226,
10,0.0,0,33,-23,43,27495,11488,391078,0.005510181824195358,119131,789,0.0364935219113182,3799,653,2,2,657,16076,0.01690738535345433,7689,0,651,0,0.12899726647318796,0,9142,0,3346,564,0,13052,5796,0.03989226963543097,241357,122226,
10,0.0,0,33,-23,43,27495,11488,391078,0.005510181824195358,119131,789,0.0364935219113182,3799,653,2,2,657,16076,0.01690738535345433,7689,0,651,0,0.12899726647318796,0,9142,0,3346,564,0,13052,5796,0.03989226963543097,241357,122226,
10,0.0,0,33,-23,43,27495,11488,391078,0.005510181824195358,119131,789,0.0364935219113182,3799,653,2,2,657,16076,0.01690738535345433,7689,0,651,0,0.12899726647318796,0,9142,0,3346,564,0,13052,5796,0.03989226963543097,241357,122226,
10,0.0,0,33,-23,43,27495,11488,391078,0.005510181824195358,119131,789,0.0364935219113182,3799,653,2,2,657,16076,0.01690738535345433,7689,0,651,0,0.12899726647318796,0,9142,0,3346,564,0,13052,5796,0.03989226963543097,241357,122226,
10,0.0,0,33,-23,43,27495,11488,391078,0.005510181824195358,119131,789,0.0364935219113182,3799,97,18,5,120,16076,0.01690738535345433,7689,0,79,0,0.014969914490509533,0,9142,0,3346,564,0,13052,5796,0.03989226963543097,241357,122226,
10,0.0,0,33,-23,43,27495,11488,391078,0.005510181824195358,119131,789,0.0364935219113182,3799,15,28,0,43,16076,0.01690738535345433,7689,0,-13,0,0.06070136262559415,0,9142,0,3346,564,0,13052,5796,0.03989226963543097,241357,122226,
10,0.2631578947368421,0,33,-23,43,27495,11488,391078,0.005510181824195358,119131,789,0.0364935219113182,3799,269,114,29,412,16076,0.01690738535345433,7689,5,155,0,0.13843139848036304,5,9142,0,3346,564,-5,13052,5796,0.03989226963543097,241357,122226,
10,0.0,0,33,-23,43,27495,11488,391078,0.005510181824195358,119131,789,0.0364935219113182,3799,34,1,0,35,16076,0.01690738535345433,7689,0,33,0,0.0414654708037061,0,9142,0,3346,564,0,13052,5796,0.03989226963543097,241357,122226,
0,0.0,0,0,0,0,27495,11488,391078,0.0,119131,789,0.0364935219113182,3799,45,66,2,113,16076,0.01690738535345433,7689,0,-21,0,0.17060386098203295,0,1147,0,137,7,0,1291,1010,0.05987809068512417,241357,122226,
0,0.0,0,0,0,0,27495,11488,391078,0.0,119131,789,0.0364935219113182,3799,45,66,2,113,16076,0.01690738535345433,7689,0,-21,0,0.17060386098203295,0,1147,0,137,7,0,1291,1010,0.05987809068512417,241357,122226,
0,0.0,0,0,0,0,27495,11488,391078,0.0,119131,789,0.0364935219113182,3799,45,66,2,113,16076,0.01690738535345433,7689,0,-21,0,0.17060386098203295,0,1147,0,137,7,0,1291,1010,0.05987809068512417,241357,122226,
0,0.0,0,0,0,0,27495,11488,391078,0.0,119131,789,0.0364935219113182,3799,45,66,2,113,16076,0.01690738535345433,7689,0,-21,0,0.17060386098203295,0,1147,0,137,7,0,1291,1010,0.05987809068512417,241357,122226,
0,0.0,0,0,0,0,27495,11488,391078,0.0,119131,789,0.0364935219113182,3799,321,4,0,325,16076,0.01690738535345433,7689,0,317,0,0.08331739410579807,0,1147,0,137,7,0,1291,1010,0.05987809068512417,241357,122226,
0,0.0,0,0,0,0,27495,11488,391078,0.0,119131,789,0.0364935219113182,3799,321,4,0,325,16076,0.01690738535345433,7689,0,317,0,0.08331739410579807,0,1147,0,137,7,0,1291,1010,0.05987809068512417,241357,122226,
0,0.0,0,0,0,0,27495,11488,391078,0.0,119131,789,0.0364935219113182,3799,97,3,0,100,16076,0.01690738535345433,7689,0,94,0,0.03783172006960414,0,1147,0,137,7,0,1291,1010,0.05987809068512417,241357,122226,
0,0.0,0,0,0,0,27495,11488,391078,0.0,119131,789,0.0364935219113182,3799,171,21,0,192,16076,0.01690738535345433,7689,0,150,0,0.08013113629511341,0,1147,0,137,7,0,1291,1010,0.05987809068512417,241357,122226,
0,0.0,0,0,0,0,27495,11488,391078,0.0,119131,789,0.0364935219113182,3799,365,28,5,398,16076,0.01690738535345433,7689,0,337,0,0.0388147214325971,0,1147,0,137,7,0,1291,1010,0.05987809068512417,241357,122226,
0,0.0,0,0,0,0,27495,11488,391078,0.0,119131,789,0.0364935219113182,3799,51,15,0,66,16076,0.01690738535345433,7689,0,36,0,0.12129357209448742,0,1147,0,137,7,0,1291,1010,0.05987809068512417,241357,122226,
103,0.38492063492063494,0,0,103,103,27495,11488,391078,0.0230428545105162,119131,789,0.0364935219113182,3799,97,0,0,97,16076,0.01690738535345433,7689,0,97,97,0.38492063492063494,97,212,0,1,0,97,213,211,0.026589098730545255,241357,122226,
103,0.029850746268656716,0,0,103,103,27495,11488,391078,0.0230428545105162,119131,789,0.0364935219113182,3799,23,0,0,23,16076,0.01690738535345433,7689,0,23,6,0.03759203980099503,6,212,0,1,0,6,213,211,0.026589098730545255,241357,122226,
5,0.0,0,18,-13,23,27495,11488,391078,0.018734268248831357,119131,789,0.0364935219113182,3799,1,0,0,1,16076,0.01690738535345433,7689,0,1,0,0.0125,0,541,0,51,0,0,592,490,0.021203500849565248,241357,122226,
5,0.0,0,18,-13,23,27495,11488,391078,0.018734268248831357,119131,789,0.0364935219113182,3799,1,0,0,1,16076,0.01690738535345433,7689,0,1,0,0.0125,0,541,0,51,0,0,592,490,0.021203500849565248,241357,122226,
0,0.0,0,0,0,0,27495,11488,391078,0.0,119131,789,0.0364935219113182,3799,10,2,1,13,16076,0.01690738535345433,7689,0,8,0,0.016709511568123392,0,87,0,2,1,0,90,85,0.015004149545574155,241357,122226,
48,0.16666666666666666,1,1,47,50,27495,11488,391078,0.19658119658119658,119131,789,0.0364935219113182,3799,120,1,1,122,16076,0.01690738535345433,7689,1,119,4,0.07683167424399527,6,350,1,1,1,3,352,349,0.18252588305966208,241357,122226,
48,0.16666666666666666,1,1,47,50,27495,11488,391078,0.19658119658119658,119131,789,0.0364935219113182,3799,120,1,1,122,16076,0.01690738535345433,7689,1,119,4,0.07683167424399527,6,350,1,1,1,3,352,349,0.18252588305966208,241357,122226,
48,0.0,1,1,47,50,27495,11488,391078,0.19658119658119658,119131,789,0.0364935219113182,3799,186,0,0,186,16076,0.01690738535345433,7689,0,186,0,0.047669051858067885,0,350,0,1,1,0,352,349,0.18252588305966208,241357,122226,
48,0.0,1,1,47,50,27495,11488,391078,0.19658119658119658,119131,789,0.0364935219113182,3799,186,0,0,186,16076,0.01690738535345433,7689,0,186,0,0.047669051858067885,0,350,0,1,1,0,352,349,0.18252588305966208,241357,122226,
