F41,F40,F43,F42,F45,F44,F140,F47,F141,F46,F142,F49,F143,F48,F126,F127,F128,F129,F50,F52,F51,F36,F130,F35,F131,F38,F132,F37,F133,F134,F39,F135,F136,F137,F138,F139,
95,0.0013456469243672696,9,86,9,190,35836,42909,634583,0.007632146417612876,168583,1842,0.051400194328452505,19386,29,5,5,39,64137,0.01838378618992083,23523,3,24,4,0.013055142416955467,7,1649,0,599,265,1,2513,1050,0.11437850028339801,383665,215082,
95,0.0013456469243672696,9,86,9,190,35836,42909,634583,0.007632146417612876,168583,1842,0.051400194328452505,19386,29,5,5,39,64137,0.01838378618992083,23523,3,24,4,0.013055142416955467,7,1649,0,599,265,1,2513,1050,0.11437850028339801,383665,215082,
95,0.0,9,86,9,190,35836,42909,634583,0.007632146417612876,168583,1842,0.051400194328452505,19386,67,64,0,131,64137,0.01838378618992083,23523,0,3,0,0.017035348065970738,0,1649,0,599,265,0,2513,1050,0.11437850028339801,383665,215082,
95,0.0,9,86,9,190,35836,42909,634583,0.007632146417612876,168583,1842,0.051400194328452505,19386,67,64,0,131,64137,0.01838378618992083,23523,0,3,0,0.017035348065970738,0,1649,0,599,265,0,2513,1050,0.11437850028339801,383665,215082,
95,0.0,9,86,9,190,35836,42909,634583,0.007632146417612876,168583,1842,0.051400194328452505,19386,140,3,0,143,64137,0.01838378618992083,23523,0,137,0,0.4198987453224741,0,1649,0,599,265,0,2513,1050,0.11437850028339801,383665,215082,
95,0.0,9,86,9,190,35836,42909,634583,0.007632146417612876,168583,1842,0.051400194328452505,19386,140,3,0,143,64137,0.01838378618992083,23523,0,137,0,0.4198987453224741,0,1649,0,599,265,0,2513,1050,0.11437850028339801,383665,215082,
95,0.0,9,86,9,190,35836,42909,634583,0.007632146417612876,168583,1842,0.051400194328452505,19386,140,3,0,143,64137,0.01838378618992083,23523,0,137,0,0.4198987453224741,0,1649,0,599,265,0,2513,1050,0.11437850028339801,383665,215082,
95,1.644736842105263E-4,9,86,9,190,35836,42909,634583,0.007632146417612876,168583,1842,0.051400194328452505,19386,1,0,0,1,64137,0.01838378618992083,23523,0,1,1,1.644736842105263E-4,1,1649,0,599,265,1,2513,1050,0.11437850028339801,383665,215082,
95,0.01190844082965642,9,86,9,190,35836,42909,634583,0.007632146417612876,168583,1842,0.051400194328452505,19386,501,390,253,1144,64137,0.01838378618992083,23523,46,111,52,0.041734120522370126,107,1649,9,599,265,6,2513,1050,0.11437850028339801,383665,215082,
95,0.01190844082965642,9,86,9,190,35836,42909,634583,0.007632146417612876,168583,1842,0.051400194328452505,19386,501,390,253,1144,64137,0.01838378618992083,23523,46,111,52,0.041734120522370126,107,1649,9,599,265,6,2513,1050,0.11437850028339801,383665,215082,
95,0.08529352506409549,9,86,9,190,35836,42909,634583,0.007632146417612876,168583,1842,0.051400194328452505,19386,242,132,7,381,64137,0.01838378618992083,23523,35,110,36,0.03048325516709981,71,1649,0,599,265,1,2513,1050,0.11437850028339801,383665,215082,
10,0.0,0,10,0,20,35836,42909,634583,0.006961144495261334,168583,1842,0.051400194328452505,19386,31,34,18,83,64137,0.01838378618992083,23523,0,-3,0,0.09393314710229402,0,2882,0,795,131,0,3808,2087,0.08983340356775714,383665,215082,
10,0.0,0,10,0,20,35836,42909,634583,0.006961144495261334,168583,1842,0.051400194328452505,19386,31,34,18,83,64137,0.01838378618992083,23523,0,-3,0,0.09393314710229402,0,2882,0,795,131,0,3808,2087,0.08983340356775714,383665,215082,
10,0.0,0,10,0,20,35836,42909,634583,0.006961144495261334,168583,1842,0.051400194328452505,19386,182,115,30,327,64137,0.01838378618992083,23523,0,67,0,0.16103005051001712,0,2882,0,795,131,0,3808,2087,0.08983340356775714,383665,215082,
10,0.0,0,10,0,20,35836,42909,634583,0.006961144495261334,168583,1842,0.051400194328452505,19386,239,31,0,270,64137,0.01838378618992083,23523,0,208,0,0.06859127613960961,0,2882,0,795,131,0,3808,2087,0.08983340356775714,383665,215082,
10,0.022222222222222223,0,10,0,20,35836,42909,634583,0.006961144495261334,168583,1842,0.051400194328452505,19386,324,143,31,498,64137,0.01838378618992083,23523,2,181,2,0.09253152189416626,4,2882,0,795,131,0,3808,2087,0.08983340356775714,383665,215082,
1050,0.5280487804878049,0,7,1043,1057,35836,42909,634583,0.13844806806750592,168583,1842,0.051400194328452505,19386,433,0,0,433,64137,0.01838378618992083,23523,0,433,433,0.5280487804878049,433,1050,0,7,0,433,1057,1043,0.13844806806750592,383665,215082,
230,0.3116919519020444,24,424,-194,678,35836,42909,634583,0.06222714969257415,168583,1842,0.051400194328452505,19386,521,343,77,941,64137,0.01838378618992083,23523,102,178,152,0.16574477509086297,268,1591,14,989,121,50,2701,602,0.09136108335685444,383665,215082,
230,0.004407703037363467,24,424,-194,678,35836,42909,634583,0.06222714969257415,168583,1842,0.051400194328452505,19386,106,60,6,172,64137,0.01838378618992083,23523,13,46,13,0.021114080801327494,26,1591,0,989,121,0,2701,602,0.09136108335685444,383665,215082,
230,0.7392638036809815,24,424,-194,678,35836,42909,634583,0.06222714969257415,168583,1842,0.051400194328452505,19386,6,248,0,254,64137,0.01838378618992083,23523,241,-242,0,0.3721134052137048,241,1591,0,989,121,-241,2701,602,0.09136108335685444,383665,215082,
230,0.7392638036809815,24,424,-194,678,35836,42909,634583,0.06222714969257415,168583,1842,0.051400194328452505,19386,6,248,0,254,64137,0.01838378618992083,23523,241,-242,0,0.3721134052137048,241,1591,0,989,121,-241,2701,602,0.09136108335685444,383665,215082,
230,0.7392638036809815,24,424,-194,678,35836,42909,634583,0.06222714969257415,168583,1842,0.051400194328452505,19386,6,248,0,254,64137,0.01838378618992083,23523,241,-242,0,0.3721134052137048,241,1591,0,989,121,-241,2701,602,0.09136108335685444,383665,215082,
230,0.7392638036809815,24,424,-194,678,35836,42909,634583,0.06222714969257415,168583,1842,0.051400194328452505,19386,6,248,0,254,64137,0.01838378618992083,23523,241,-242,0,0.3721134052137048,241,1591,0,989,121,-241,2701,602,0.09136108335685444,383665,215082,
2586,0.0,88,1333,1253,4007,35836,42909,634583,0.023577161420399735,168583,1842,0.051400194328452505,19386,361,26,4,391,64137,0.01838378618992083,23523,0,335,0,0.12743246933340235,0,8805,0,4115,425,0,13345,4690,0.05622025343000698,383665,215082,
230,0.0,24,424,-194,678,35836,42909,634583,0.06222714969257415,168583,1842,0.051400194328452505,19386,6,4,0,10,64137,0.01838378618992083,23523,0,2,0,0.11330049261083744,0,1591,0,989,121,0,2701,602,0.09136108335685444,383665,215082,
230,0.02967359050445104,24,424,-194,678,35836,42909,634583,0.06222714969257415,168583,1842,0.051400194328452505,19386,92,38,2,132,64137,0.01838378618992083,23523,5,54,5,0.057055700118114484,10,1591,0,989,121,0,2701,602,0.09136108335685444,383665,215082,
230,0.02967359050445104,24,424,-194,678,35836,42909,634583,0.06222714969257415,168583,1842,0.051400194328452505,19386,92,38,2,132,64137,0.01838378618992083,23523,5,54,5,0.057055700118114484,10,1591,0,989,121,0,2701,602,0.09136108335685444,383665,215082,
0,0.0,0,0,0,0,35836,42909,634583,0.0,168583,1842,0.051400194328452505,19386,3924,1669,507,6100,64137,0.01838378618992083,23523,0,2255,0,0.18421746279484663,0,5656,0,13149,583,0,19388,-7493,0.1502884917763707,383665,215082,
0,0.0,0,0,0,0,35836,42909,634583,0.0,168583,1842,0.051400194328452505,19386,3924,1669,507,6100,64137,0.01838378618992083,23523,0,2255,0,0.18421746279484663,0,5656,0,13149,583,0,19388,-7493,0.1502884917763707,383665,215082,
0,0.0,0,0,0,0,35836,42909,634583,0.0,168583,1842,0.051400194328452505,19386,3924,1669,507,6100,64137,0.01838378618992083,23523,0,2255,0,0.18421746279484663,0,5656,0,13149,583,0,19388,-7493,0.1502884917763707,383665,215082,
0,0.0,0,0,0,0,35836,42909,634583,0.0,168583,1842,0.051400194328452505,19386,3924,1669,507,6100,64137,0.01838378618992083,23523,0,2255,0,0.18421746279484663,0,5656,0,13149,583,0,19388,-7493,0.1502884917763707,383665,215082,
0,0.0,0,0,0,0,35836,42909,634583,0.0,168583,1842,0.051400194328452505,19386,3924,1669,507,6100,64137,0.01838378618992083,23523,0,2255,0,0.18421746279484663,0,5656,0,13149,583,0,19388,-7493,0.1502884917763707,383665,215082,
0,0.0,0,0,0,0,35836,42909,634583,0.0,168583,1842,0.051400194328452505,19386,3924,1669,507,6100,64137,0.01838378618992083,23523,0,2255,0,0.18421746279484663,0,5656,0,13149,583,0,19388,-7493,0.1502884917763707,383665,215082,
0,0.0,0,0,0,0,35836,42909,634583,0.0,168583,1842,0.051400194328452505,19386,3924,1669,507,6100,64137,0.01838378618992083,23523,0,2255,0,0.18421746279484663,0,5656,0,13149,583,0,19388,-7493,0.1502884917763707,383665,215082,
0,0.0,0,0,0,0,35836,42909,634583,0.0,168583,1842,0.051400194328452505,19386,3924,1669,507,6100,64137,0.01838378618992083,23523,0,2255,0,0.18421746279484663,0,5656,0,13149,583,0,19388,-7493,0.1502884917763707,383665,215082,
0,0.0,0,0,0,0,35836,42909,634583,0.0,168583,1842,0.051400194328452505,19386,3924,1669,507,6100,64137,0.01838378618992083,23523,0,2255,0,0.18421746279484663,0,5656,0,13149,583,0,19388,-7493,0.1502884917763707,383665,215082,
0,0.0,0,0,0,0,35836,42909,634583,0.0,168583,1842,0.051400194328452505,19386,3924,1669,507,6100,64137,0.01838378618992083,23523,0,2255,0,0.18421746279484663,0,5656,0,13149,583,0,19388,-7493,0.1502884917763707,383665,215082,
0,0.0,0,0,0,0,35836,42909,634583,0.0,168583,1842,0.051400194328452505,19386,3924,1669,507,6100,64137,0.01838378618992083,23523,0,2255,0,0.18421746279484663,0,5656,0,13149,583,0,19388,-7493,0.1502884917763707,383665,215082,
0,0.0,0,0,0,0,35836,42909,634583,0.0,168583,1842,0.051400194328452505,19386,3924,1669,507,6100,64137,0.01838378618992083,23523,0,2255,0,0.18421746279484663,0,5656,0,13149,583,0,19388,-7493,0.1502884917763707,383665,215082,
0,0.0,0,0,0,0,35836,42909,634583,0.0,168583,1842,0.051400194328452505,19386,3924,1669,507,6100,64137,0.01838378618992083,23523,0,2255,0,0.18421746279484663,0,5656,0,13149,583,0,19388,-7493,0.1502884917763707,383665,215082,
0,0.0,0,0,0,0,35836,42909,634583,0.0,168583,1842,0.051400194328452505,19386,3924,1669,507,6100,64137,0.01838378618992083,23523,0,2255,0,0.18421746279484663,0,5656,0,13149,583,0,19388,-7493,0.1502884917763707,383665,215082,
0,0.0,0,0,0,0,35836,42909,634583,0.0,168583,1842,0.051400194328452505,19386,3924,1669,507,6100,64137,0.01838378618992083,23523,0,2255,0,0.18421746279484663,0,5656,0,13149,583,0,19388,-7493,0.1502884917763707,383665,215082,
0,0.0,0,0,0,0,35836,42909,634583,0.0,168583,1842,0.051400194328452505,19386,3924,1669,507,6100,64137,0.01838378618992083,23523,0,2255,0,0.18421746279484663,0,5656,0,13149,583,0,19388,-7493,0.1502884917763707,383665,215082,
0,0.0,0,0,0,0,35836,42909,634583,0.0,168583,1842,0.051400194328452505,19386,3924,1669,507,6100,64137,0.01838378618992083,23523,0,2255,0,0.18421746279484663,0,5656,0,13149,583,0,19388,-7493,0.1502884917763707,383665,215082,
0,0.0,0,0,0,0,35836,42909,634583,0.0,168583,1842,0.051400194328452505,19386,3924,1669,507,6100,64137,0.01838378618992083,23523,0,2255,0,0.18421746279484663,0,5656,0,13149,583,0,19388,-7493,0.1502884917763707,383665,215082,
0,0.0,0,0,0,0,35836,42909,634583,0.0,168583,1842,0.051400194328452505,19386,3924,1669,507,6100,64137,0.01838378618992083,23523,0,2255,0,0.18421746279484663,0,5656,0,13149,583,0,19388,-7493,0.1502884917763707,383665,215082,
0,0.0,0,0,0,0,35836,42909,634583,0.0,168583,1842,0.051400194328452505,19386,3924,1669,507,6100,64137,0.01838378618992083,23523,0,2255,0,0.18421746279484663,0,5656,0,13149,583,0,19388,-7493,0.1502884917763707,383665,215082,
0,0.0,0,0,0,0,35836,42909,634583,0.0,168583,1842,0.051400194328452505,19386,3924,1669,507,6100,64137,0.01838378618992083,23523,0,2255,0,0.18421746279484663,0,5656,0,13149,583,0,19388,-7493,0.1502884917763707,383665,215082,
0,0.0,0,0,0,0,35836,42909,634583,0.0,168583,1842,0.051400194328452505,19386,3924,1669,507,6100,64137,0.01838378618992083,23523,0,2255,0,0.18421746279484663,0,5656,0,13149,583,0,19388,-7493,0.1502884917763707,383665,215082,
0,0.0,0,0,0,0,35836,42909,634583,0.0,168583,1842,0.051400194328452505,19386,146,141,4,291,64137,0.01838378618992083,23523,0,5,0,0.03193893270008159,0,5656,0,13149,583,0,19388,-7493,0.1502884917763707,383665,215082,
0,0.0,0,0,0,0,35836,42909,634583,0.0,168583,1842,0.051400194328452505,19386,146,141,4,291,64137,0.01838378618992083,23523,0,5,0,0.03193893270008159,0,5656,0,13149,583,0,19388,-7493,0.1502884917763707,383665,215082,
0,0.0,0,0,0,0,35836,42909,634583,0.0,168583,1842,0.051400194328452505,19386,12,2599,0,2611,64137,0.01838378618992083,23523,0,-2587,0,0.5504757353493916,0,5656,0,13149,583,0,19388,-7493,0.1502884917763707,383665,215082,
0,0.0,0,0,0,0,35836,42909,634583,0.0,168583,1842,0.051400194328452505,19386,12,2599,0,2611,64137,0.01838378618992083,23523,0,-2587,0,0.5504757353493916,0,5656,0,13149,583,0,19388,-7493,0.1502884917763707,383665,215082,
0,0.0,0,0,0,0,35836,42909,634583,0.0,168583,1842,0.051400194328452505,19386,12,2599,0,2611,64137,0.01838378618992083,23523,0,-2587,0,0.5504757353493916,0,5656,0,13149,583,0,19388,-7493,0.1502884917763707,383665,215082,
0,0.0,0,0,0,0,35836,42909,634583,0.0,168583,1842,0.051400194328452505,19386,12,2599,0,2611,64137,0.01838378618992083,23523,0,-2587,0,0.5504757353493916,0,5656,0,13149,583,0,19388,-7493,0.1502884917763707,383665,215082,
0,0.0,0,0,0,0,35836,42909,634583,0.0,168583,1842,0.051400194328452505,19386,12,2599,0,2611,64137,0.01838378618992083,23523,0,-2587,0,0.5504757353493916,0,5656,0,13149,583,0,19388,-7493,0.1502884917763707,383665,215082,
0,0.0,0,0,0,0,35836,42909,634583,0.0,168583,1842,0.051400194328452505,19386,12,2599,0,2611,64137,0.01838378618992083,23523,0,-2587,0,0.5504757353493916,0,5656,0,13149,583,0,19388,-7493,0.1502884917763707,383665,215082,
0,0.0,0,0,0,0,35836,42909,634583,0.0,168583,1842,0.051400194328452505,19386,380,82,51,513,64137,0.01838378618992083,23523,0,298,0,0.11242572386785084,0,5656,0,13149,583,0,19388,-7493,0.1502884917763707,383665,215082,
0,0.0,0,0,0,0,35836,42909,634583,0.0,168583,1842,0.051400194328452505,19386,380,82,51,513,64137,0.01838378618992083,23523,0,298,0,0.11242572386785084,0,5656,0,13149,583,0,19388,-7493,0.1502884917763707,383665,215082,
0,0.0,0,0,0,0,35836,42909,634583,0.0,168583,1842,0.051400194328452505,19386,380,82,51,513,64137,0.01838378618992083,23523,0,298,0,0.11242572386785084,0,5656,0,13149,583,0,19388,-7493,0.1502884917763707,383665,215082,
0,0.0,0,0,0,0,35836,42909,634583,0.0,168583,1842,0.051400194328452505,19386,380,82,51,513,64137,0.01838378618992083,23523,0,298,0,0.11242572386785084,0,5656,0,13149,583,0,19388,-7493,0.1502884917763707,383665,215082,
0,0.0,0,0,0,0,35836,42909,634583,0.0,168583,1842,0.051400194328452505,19386,380,82,51,513,64137,0.01838378618992083,23523,0,298,0,0.11242572386785084,0,5656,0,13149,583,0,19388,-7493,0.1502884917763707,383665,215082,
0,0.0,0,0,0,0,35836,42909,634583,0.0,168583,1842,0.051400194328452505,19386,380,82,51,513,64137,0.01838378618992083,23523,0,298,0,0.11242572386785084,0,5656,0,13149,583,0,19388,-7493,0.1502884917763707,383665,215082,
0,0.0,0,0,0,0,35836,42909,634583,0.0,168583,1842,0.051400194328452505,19386,223,316,3,542,64137,0.01838378618992083,23523,0,-93,0,0.08407048169630195,0,5656,0,13149,583,0,19388,-7493,0.1502884917763707,383665,215082,
0,0.0,0,0,0,0,35836,42909,634583,0.0,168583,1842,0.051400194328452505,19386,223,316,3,542,64137,0.01838378618992083,23523,0,-93,0,0.08407048169630195,0,5656,0,13149,583,0,19388,-7493,0.1502884917763707,383665,215082,
0,0.0,0,0,0,0,35836,42909,634583,0.0,168583,1842,0.051400194328452505,19386,11,7167,0,7178,64137,0.01838378618992083,23523,0,-7156,0,0.43145562464669307,0,5656,0,13149,583,0,19388,-7493,0.1502884917763707,383665,215082,
0,0.0,0,0,0,0,35836,42909,634583,0.0,168583,1842,0.051400194328452505,19386,11,7167,0,7178,64137,0.01838378618992083,23523,0,-7156,0,0.43145562464669307,0,5656,0,13149,583,0,19388,-7493,0.1502884917763707,383665,215082,
0,0.0,0,0,0,0,35836,42909,634583,0.0,168583,1842,0.051400194328452505,19386,11,7167,0,7178,64137,0.01838378618992083,23523,0,-7156,0,0.43145562464669307,0,5656,0,13149,583,0,19388,-7493,0.1502884917763707,383665,215082,
0,0.0,0,0,0,0,35836,42909,634583,0.0,168583,1842,0.051400194328452505,19386,11,7167,0,7178,64137,0.01838378618992083,23523,0,-7156,0,0.43145562464669307,0,5656,0,13149,583,0,19388,-7493,0.1502884917763707,383665,215082,
0,0.0,0,0,0,0,35836,42909,634583,0.0,168583,1842,0.051400194328452505,19386,11,7167,0,7178,64137,0.01838378618992083,23523,0,-7156,0,0.43145562464669307,0,5656,0,13149,583,0,19388,-7493,0.1502884917763707,383665,215082,
0,0.0,0,0,0,0,35836,42909,634583,0.0,168583,1842,0.051400194328452505,19386,11,7167,0,7178,64137,0.01838378618992083,23523,0,-7156,0,0.43145562464669307,0,5656,0,13149,583,0,19388,-7493,0.1502884917763707,383665,215082,
0,0.0,0,0,0,0,35836,42909,634583,0.0,168583,1842,0.051400194328452505,19386,11,7167,0,7178,64137,0.01838378618992083,23523,0,-7156,0,0.43145562464669307,0,5656,0,13149,583,0,19388,-7493,0.1502884917763707,383665,215082,
0,0.0,0,0,0,0,35836,42909,634583,0.0,168583,1842,0.051400194328452505,19386,11,7167,0,7178,64137,0.01838378618992083,23523,0,-7156,0,0.43145562464669307,0,5656,0,13149,583,0,19388,-7493,0.1502884917763707,383665,215082,
0,0.0,0,0,0,0,35836,42909,634583,0.0,168583,1842,0.051400194328452505,19386,11,7167,0,7178,64137,0.01838378618992083,23523,0,-7156,0,0.43145562464669307,0,5656,0,13149,583,0,19388,-7493,0.1502884917763707,383665,215082,
0,0.0,0,0,0,0,35836,42909,634583,0.0,168583,1842,0.051400194328452505,19386,11,7167,0,7178,64137,0.01838378618992083,23523,0,-7156,0,0.43145562464669307,0,5656,0,13149,583,0,19388,-7493,0.1502884917763707,383665,215082,
0,0.0,0,0,0,0,35836,42909,634583,0.0,168583,1842,0.051400194328452505,19386,11,7167,0,7178,64137,0.01838378618992083,23523,0,-7156,0,0.43145562464669307,0,5656,0,13149,583,0,19388,-7493,0.1502884917763707,383665,215082,
0,0.0,0,0,0,0,35836,42909,634583,0.0,168583,1842,0.051400194328452505,19386,11,7167,0,7178,64137,0.01838378618992083,23523,0,-7156,0,0.43145562464669307,0,5656,0,13149,583,0,19388,-7493,0.1502884917763707,383665,215082,
0,0.0,0,0,0,0,35836,42909,634583,0.0,168583,1842,0.051400194328452505,19386,11,7167,0,7178,64137,0.01838378618992083,23523,0,-7156,0,0.43145562464669307,0,5656,0,13149,583,0,19388,-7493,0.1502884917763707,383665,215082,
0,0.0,0,0,0,0,35836,42909,634583,0.0,168583,1842,0.051400194328452505,19386,11,7167,0,7178,64137,0.01838378618992083,23523,0,-7156,0,0.43145562464669307,0,5656,0,13149,583,0,19388,-7493,0.1502884917763707,383665,215082,
0,0.0,0,0,0,0,35836,42909,634583,0.0,168583,1842,0.051400194328452505,19386,11,7167,0,7178,64137,0.01838378618992083,23523,0,-7156,0,0.43145562464669307,0,5656,0,13149,583,0,19388,-7493,0.1502884917763707,383665,215082,
0,0.0,0,0,0,0,35836,42909,634583,0.0,168583,1842,0.051400194328452505,19386,11,7167,0,7178,64137,0.01838378618992083,23523,0,-7156,0,0.43145562464669307,0,5656,0,13149,583,0,19388,-7493,0.1502884917763707,383665,215082,
0,0.0,0,0,0,0,35836,42909,634583,0.0,168583,1842,0.051400194328452505,19386,11,7167,0,7178,64137,0.01838378618992083,23523,0,-7156,0,0.43145562464669307,0,5656,0,13149,583,0,19388,-7493,0.1502884917763707,383665,215082,
0,0.0,0,0,0,0,35836,42909,634583,0.0,168583,1842,0.051400194328452505,19386,11,7167,0,7178,64137,0.01838378618992083,23523,0,-7156,0,0.43145562464669307,0,5656,0,13149,583,0,19388,-7493,0.1502884917763707,383665,215082,
0,0.0,0,0,0,0,35836,42909,634583,0.0,168583,1842,0.051400194328452505,19386,11,7167,0,7178,64137,0.01838378618992083,23523,0,-7156,0,0.43145562464669307,0,5656,0,13149,583,0,19388,-7493,0.1502884917763707,383665,215082,
0,0.0,0,0,0,0,35836,42909,634583,0.0,168583,1842,0.051400194328452505,19386,11,7167,0,7178,64137,0.01838378618992083,23523,0,-7156,0,0.43145562464669307,0,5656,0,13149,583,0,19388,-7493,0.1502884917763707,383665,215082,
0,0.0,0,0,0,0,35836,42909,634583,0.0,168583,1842,0.051400194328452505,19386,11,7167,0,7178,64137,0.01838378618992083,23523,0,-7156,0,0.43145562464669307,0,5656,0,13149,583,0,19388,-7493,0.1502884917763707,383665,215082,
0,0.0,0,0,0,0,35836,42909,634583,0.0,168583,1842,0.051400194328452505,19386,11,7167,0,7178,64137,0.01838378618992083,23523,0,-7156,0,0.43145562464669307,0,5656,0,13149,583,0,19388,-7493,0.1502884917763707,383665,215082,
0,0.0,0,0,0,0,35836,42909,634583,0.0,168583,1842,0.051400194328452505,19386,11,7167,0,7178,64137,0.01838378618992083,23523,0,-7156,0,0.43145562464669307,0,5656,0,13149,583,0,19388,-7493,0.1502884917763707,383665,215082,
0,0.0,0,0,0,0,35836,42909,634583,0.0,168583,1842,0.051400194328452505,19386,11,7167,0,7178,64137,0.01838378618992083,23523,0,-7156,0,0.43145562464669307,0,5656,0,13149,583,0,19388,-7493,0.1502884917763707,383665,215082,
0,0.0,0,0,0,0,35836,42909,634583,0.0,168583,1842,0.051400194328452505,19386,11,7167,0,7178,64137,0.01838378618992083,23523,0,-7156,0,0.43145562464669307,0,5656,0,13149,583,0,19388,-7493,0.1502884917763707,383665,215082,
0,0.0,0,0,0,0,35836,42909,634583,0.0,168583,1842,0.051400194328452505,19386,11,7167,0,7178,64137,0.01838378618992083,23523,0,-7156,0,0.43145562464669307,0,5656,0,13149,583,0,19388,-7493,0.1502884917763707,383665,215082,
0,0.0,0,0,0,0,35836,42909,634583,0.0,168583,1842,0.051400194328452505,19386,11,7167,0,7178,64137,0.01838378618992083,23523,0,-7156,0,0.43145562464669307,0,5656,0,13149,583,0,19388,-7493,0.1502884917763707,383665,215082,
0,0.0,0,0,0,0,35836,42909,634583,0.0,168583,1842,0.051400194328452505,19386,11,7167,0,7178,64137,0.01838378618992083,23523,0,-7156,0,0.43145562464669307,0,5656,0,13149,583,0,19388,-7493,0.1502884917763707,383665,215082,
0,0.0,0,0,0,0,35836,42909,634583,0.0,168583,1842,0.051400194328452505,19386,11,7167,0,7178,64137,0.01838378618992083,23523,0,-7156,0,0.43145562464669307,0,5656,0,13149,583,0,19388,-7493,0.1502884917763707,383665,215082,
0,0.0,0,0,0,0,35836,42909,634583,0.0,168583,1842,0.051400194328452505,19386,11,7167,0,7178,64137,0.01838378618992083,23523,0,-7156,0,0.43145562464669307,0,5656,0,13149,583,0,19388,-7493,0.1502884917763707,383665,215082,
0,0.0,0,0,0,0,35836,42909,634583,0.0,168583,1842,0.051400194328452505,19386,11,7167,0,7178,64137,0.01838378618992083,23523,0,-7156,0,0.43145562464669307,0,5656,0,13149,583,0,19388,-7493,0.1502884917763707,383665,215082,
0,0.0,0,0,0,0,35836,42909,634583,0.0,168583,1842,0.051400194328452505,19386,11,7167,0,7178,64137,0.01838378618992083,23523,0,-7156,0,0.43145562464669307,0,5656,0,13149,583,0,19388,-7493,0.1502884917763707,383665,215082,
0,0.0,0,0,0,0,35836,42909,634583,0.0,168583,1842,0.051400194328452505,19386,11,7167,0,7178,64137,0.01838378618992083,23523,0,-7156,0,0.43145562464669307,0,5656,0,13149,583,0,19388,-7493,0.1502884917763707,383665,215082,
0,0.0,0,0,0,0,35836,42909,634583,0.0,168583,1842,0.051400194328452505,19386,11,7167,0,7178,64137,0.01838378618992083,23523,0,-7156,0,0.43145562464669307,0,5656,0,13149,583,0,19388,-7493,0.1502884917763707,383665,215082,
0,0.0,0,0,0,0,35836,42909,634583,0.0,168583,1842,0.051400194328452505,19386,11,7167,0,7178,64137,0.01838378618992083,23523,0,-7156,0,0.43145562464669307,0,5656,0,13149,583,0,19388,-7493,0.1502884917763707,383665,215082,
0,0.0,0,0,0,0,35836,42909,634583,0.0,168583,1842,0.051400194328452505,19386,11,7167,0,7178,64137,0.01838378618992083,23523,0,-7156,0,0.43145562464669307,0,5656,0,13149,583,0,19388,-7493,0.1502884917763707,383665,215082,
0,0.0,0,0,0,0,35836,42909,634583,0.0,168583,1842,0.051400194328452505,19386,11,7167,0,7178,64137,0.01838378618992083,23523,0,-7156,0,0.43145562464669307,0,5656,0,13149,583,0,19388,-7493,0.1502884917763707,383665,215082,
0,0.0,0,0,0,0,35836,42909,634583,0.0,168583,1842,0.051400194328452505,19386,11,7167,0,7178,64137,0.01838378618992083,23523,0,-7156,0,0.43145562464669307,0,5656,0,13149,583,0,19388,-7493,0.1502884917763707,383665,215082,
0,0.0,0,0,0,0,35836,42909,634583,0.0,168583,1842,0.051400194328452505,19386,11,7167,0,7178,64137,0.01838378618992083,23523,0,-7156,0,0.43145562464669307,0,5656,0,13149,583,0,19388,-7493,0.1502884917763707,383665,215082,
0,0.0,0,0,0,0,35836,42909,634583,0.0,168583,1842,0.051400194328452505,19386,11,7167,0,7178,64137,0.01838378618992083,23523,0,-7156,0,0.43145562464669307,0,5656,0,13149,583,0,19388,-7493,0.1502884917763707,383665,215082,
0,0.0,0,0,0,0,35836,42909,634583,0.0,168583,1842,0.051400194328452505,19386,11,7167,0,7178,64137,0.01838378618992083,23523,0,-7156,0,0.43145562464669307,0,5656,0,13149,583,0,19388,-7493,0.1502884917763707,383665,215082,
0,0.0,0,0,0,0,35836,42909,634583,0.0,168583,1842,0.051400194328452505,19386,11,7167,0,7178,64137,0.01838378618992083,23523,0,-7156,0,0.43145562464669307,0,5656,0,13149,583,0,19388,-7493,0.1502884917763707,383665,215082,
0,0.0,0,0,0,0,35836,42909,634583,0.0,168583,1842,0.051400194328452505,19386,11,7167,0,7178,64137,0.01838378618992083,23523,0,-7156,0,0.43145562464669307,0,5656,0,13149,583,0,19388,-7493,0.1502884917763707,383665,215082,
0,0.0,0,0,0,0,35836,42909,634583,0.0,168583,1842,0.051400194328452505,19386,11,7167,0,7178,64137,0.01838378618992083,23523,0,-7156,0,0.43145562464669307,0,5656,0,13149,583,0,19388,-7493,0.1502884917763707,383665,215082,
0,0.0,0,0,0,0,35836,42909,634583,0.0,168583,1842,0.051400194328452505,19386,11,7167,0,7178,64137,0.01838378618992083,23523,0,-7156,0,0.43145562464669307,0,5656,0,13149,583,0,19388,-7493,0.1502884917763707,383665,215082,
0,0.0,0,0,0,0,35836,42909,634583,0.0,168583,1842,0.051400194328452505,19386,11,7167,0,7178,64137,0.01838378618992083,23523,0,-7156,0,0.43145562464669307,0,5656,0,13149,583,0,19388,-7493,0.1502884917763707,383665,215082,
0,0.0,0,0,0,0,35836,42909,634583,0.0,168583,1842,0.051400194328452505,19386,11,7167,0,7178,64137,0.01838378618992083,23523,0,-7156,0,0.43145562464669307,0,5656,0,13149,583,0,19388,-7493,0.1502884917763707,383665,215082,
0,0.0,0,0,0,0,35836,42909,634583,0.0,168583,1842,0.051400194328452505,19386,11,7167,0,7178,64137,0.01838378618992083,23523,0,-7156,0,0.43145562464669307,0,5656,0,13149,583,0,19388,-7493,0.1502884917763707,383665,215082,
0,0.0,0,0,0,0,35836,42909,634583,0.0,168583,1842,0.051400194328452505,19386,11,7167,0,7178,64137,0.01838378618992083,23523,0,-7156,0,0.43145562464669307,0,5656,0,13149,583,0,19388,-7493,0.1502884917763707,383665,215082,
0,0.0,0,0,0,0,35836,42909,634583,0.0,168583,1842,0.051400194328452505,19386,11,7167,0,7178,64137,0.01838378618992083,23523,0,-7156,0,0.43145562464669307,0,5656,0,13149,583,0,19388,-7493,0.1502884917763707,383665,215082,
0,0.0,0,0,0,0,35836,42909,634583,0.0,168583,1842,0.051400194328452505,19386,11,7167,0,7178,64137,0.01838378618992083,23523,0,-7156,0,0.43145562464669307,0,5656,0,13149,583,0,19388,-7493,0.1502884917763707,383665,215082,
0,0.0,0,0,0,0,35836,42909,634583,0.0,168583,1842,0.051400194328452505,19386,11,7167,0,7178,64137,0.01838378618992083,23523,0,-7156,0,0.43145562464669307,0,5656,0,13149,583,0,19388,-7493,0.1502884917763707,383665,215082,
0,0.0,0,0,0,0,35836,42909,634583,0.0,168583,1842,0.051400194328452505,19386,11,7167,0,7178,64137,0.01838378618992083,23523,0,-7156,0,0.43145562464669307,0,5656,0,13149,583,0,19388,-7493,0.1502884917763707,383665,215082,
0,0.0,0,0,0,0,35836,42909,634583,0.0,168583,1842,0.051400194328452505,19386,11,7167,0,7178,64137,0.01838378618992083,23523,0,-7156,0,0.43145562464669307,0,5656,0,13149,583,0,19388,-7493,0.1502884917763707,383665,215082,
0,0.0,0,0,0,0,35836,42909,634583,0.0,168583,1842,0.051400194328452505,19386,11,7167,0,7178,64137,0.01838378618992083,23523,0,-7156,0,0.43145562464669307,0,5656,0,13149,583,0,19388,-7493,0.1502884917763707,383665,215082,
0,0.0,0,0,0,0,35836,42909,634583,0.0,168583,1842,0.051400194328452505,19386,11,7167,0,7178,64137,0.01838378618992083,23523,0,-7156,0,0.43145562464669307,0,5656,0,13149,583,0,19388,-7493,0.1502884917763707,383665,215082,
0,0.0,0,0,0,0,35836,42909,634583,0.0,168583,1842,0.051400194328452505,19386,11,7167,0,7178,64137,0.01838378618992083,23523,0,-7156,0,0.43145562464669307,0,5656,0,13149,583,0,19388,-7493,0.1502884917763707,383665,215082,
0,0.0,0,0,0,0,35836,42909,634583,0.0,168583,1842,0.051400194328452505,19386,11,7167,0,7178,64137,0.01838378618992083,23523,0,-7156,0,0.43145562464669307,0,5656,0,13149,583,0,19388,-7493,0.1502884917763707,383665,215082,
0,0.0,0,0,0,0,35836,42909,634583,0.0,168583,1842,0.051400194328452505,19386,11,7167,0,7178,64137,0.01838378618992083,23523,0,-7156,0,0.43145562464669307,0,5656,0,13149,583,0,19388,-7493,0.1502884917763707,383665,215082,
0,0.0,0,0,0,0,35836,42909,634583,0.0,168583,1842,0.051400194328452505,19386,11,7167,0,7178,64137,0.01838378618992083,23523,0,-7156,0,0.43145562464669307,0,5656,0,13149,583,0,19388,-7493,0.1502884917763707,383665,215082,
0,0.0,0,0,0,0,35836,42909,634583,0.0,168583,1842,0.051400194328452505,19386,11,7167,0,7178,64137,0.01838378618992083,23523,0,-7156,0,0.43145562464669307,0,5656,0,13149,583,0,19388,-7493,0.1502884917763707,383665,215082,
0,0.0,0,0,0,0,35836,42909,634583,0.0,168583,1842,0.051400194328452505,19386,11,7167,0,7178,64137,0.01838378618992083,23523,0,-7156,0,0.43145562464669307,0,5656,0,13149,583,0,19388,-7493,0.1502884917763707,383665,215082,
0,0.0,0,0,0,0,35836,42909,634583,0.0,168583,1842,0.051400194328452505,19386,11,7167,0,7178,64137,0.01838378618992083,23523,0,-7156,0,0.43145562464669307,0,5656,0,13149,583,0,19388,-7493,0.1502884917763707,383665,215082,
0,0.0,0,0,0,0,35836,42909,634583,0.0,168583,1842,0.051400194328452505,19386,11,7167,0,7178,64137,0.01838378618992083,23523,0,-7156,0,0.43145562464669307,0,5656,0,13149,583,0,19388,-7493,0.1502884917763707,383665,215082,
0,0.0,0,0,0,0,35836,42909,634583,0.0,168583,1842,0.051400194328452505,19386,11,7167,0,7178,64137,0.01838378618992083,23523,0,-7156,0,0.43145562464669307,0,5656,0,13149,583,0,19388,-7493,0.1502884917763707,383665,215082,
0,0.0,0,0,0,0,35836,42909,634583,0.0,168583,1842,0.051400194328452505,19386,11,7167,0,7178,64137,0.01838378618992083,23523,0,-7156,0,0.43145562464669307,0,5656,0,13149,583,0,19388,-7493,0.1502884917763707,383665,215082,
0,0.0,0,0,0,0,35836,42909,634583,0.0,168583,1842,0.051400194328452505,19386,11,7167,0,7178,64137,0.01838378618992083,23523,0,-7156,0,0.43145562464669307,0,5656,0,13149,583,0,19388,-7493,0.1502884917763707,383665,215082,
0,0.0,0,0,0,0,35836,42909,634583,0.0,168583,1842,0.051400194328452505,19386,11,7167,0,7178,64137,0.01838378618992083,23523,0,-7156,0,0.43145562464669307,0,5656,0,13149,583,0,19388,-7493,0.1502884917763707,383665,215082,
0,0.0,0,0,0,0,35836,42909,634583,0.0,168583,1842,0.051400194328452505,19386,11,7167,0,7178,64137,0.01838378618992083,23523,0,-7156,0,0.43145562464669307,0,5656,0,13149,583,0,19388,-7493,0.1502884917763707,383665,215082,
0,0.0,0,0,0,0,35836,42909,634583,0.0,168583,1842,0.051400194328452505,19386,11,7167,0,7178,64137,0.01838378618992083,23523,0,-7156,0,0.43145562464669307,0,5656,0,13149,583,0,19388,-7493,0.1502884917763707,383665,215082,
0,0.0,0,0,0,0,35836,42909,634583,0.0,168583,1842,0.051400194328452505,19386,11,7167,0,7178,64137,0.01838378618992083,23523,0,-7156,0,0.43145562464669307,0,5656,0,13149,583,0,19388,-7493,0.1502884917763707,383665,215082,
0,0.0,0,0,0,0,35836,42909,634583,0.0,168583,1842,0.051400194328452505,19386,11,7167,0,7178,64137,0.01838378618992083,23523,0,-7156,0,0.43145562464669307,0,5656,0,13149,583,0,19388,-7493,0.1502884917763707,383665,215082,
0,0.0,0,0,0,0,35836,42909,634583,0.0,168583,1842,0.051400194328452505,19386,11,7167,0,7178,64137,0.01838378618992083,23523,0,-7156,0,0.43145562464669307,0,5656,0,13149,583,0,19388,-7493,0.1502884917763707,383665,215082,
0,0.0,0,0,0,0,35836,42909,634583,0.0,168583,1842,0.051400194328452505,19386,11,7167,0,7178,64137,0.01838378618992083,23523,0,-7156,0,0.43145562464669307,0,5656,0,13149,583,0,19388,-7493,0.1502884917763707,383665,215082,
0,0.0,0,0,0,0,35836,42909,634583,0.0,168583,1842,0.051400194328452505,19386,11,7167,0,7178,64137,0.01838378618992083,23523,0,-7156,0,0.43145562464669307,0,5656,0,13149,583,0,19388,-7493,0.1502884917763707,383665,215082,
0,0.0,0,0,0,0,35836,42909,634583,0.0,168583,1842,0.051400194328452505,19386,11,7167,0,7178,64137,0.01838378618992083,23523,0,-7156,0,0.43145562464669307,0,5656,0,13149,583,0,19388,-7493,0.1502884917763707,383665,215082,
0,0.0,0,0,0,0,35836,42909,634583,0.0,168583,1842,0.051400194328452505,19386,11,7167,0,7178,64137,0.01838378618992083,23523,0,-7156,0,0.43145562464669307,0,5656,0,13149,583,0,19388,-7493,0.1502884917763707,383665,215082,
0,0.0,0,0,0,0,35836,42909,634583,0.0,168583,1842,0.051400194328452505,19386,11,7167,0,7178,64137,0.01838378618992083,23523,0,-7156,0,0.43145562464669307,0,5656,0,13149,583,0,19388,-7493,0.1502884917763707,383665,215082,
0,0.0,0,0,0,0,35836,42909,634583,0.0,168583,1842,0.051400194328452505,19386,11,7167,0,7178,64137,0.01838378618992083,23523,0,-7156,0,0.43145562464669307,0,5656,0,13149,583,0,19388,-7493,0.1502884917763707,383665,215082,
0,0.0,0,0,0,0,35836,42909,634583,0.0,168583,1842,0.051400194328452505,19386,11,7167,0,7178,64137,0.01838378618992083,23523,0,-7156,0,0.43145562464669307,0,5656,0,13149,583,0,19388,-7493,0.1502884917763707,383665,215082,
0,0.0,0,0,0,0,35836,42909,634583,0.0,168583,1842,0.051400194328452505,19386,11,7167,0,7178,64137,0.01838378618992083,23523,0,-7156,0,0.43145562464669307,0,5656,0,13149,583,0,19388,-7493,0.1502884917763707,383665,215082,
0,0.0,0,0,0,0,35836,42909,634583,0.0,168583,1842,0.051400194328452505,19386,11,7167,0,7178,64137,0.01838378618992083,23523,0,-7156,0,0.43145562464669307,0,5656,0,13149,583,0,19388,-7493,0.1502884917763707,383665,215082,
0,0.0,0,0,0,0,35836,42909,634583,0.0,168583,1842,0.051400194328452505,19386,11,7167,0,7178,64137,0.01838378618992083,23523,0,-7156,0,0.43145562464669307,0,5656,0,13149,583,0,19388,-7493,0.1502884917763707,383665,215082,
0,0.0,0,0,0,0,35836,42909,634583,0.0,168583,1842,0.051400194328452505,19386,11,7167,0,7178,64137,0.01838378618992083,23523,0,-7156,0,0.43145562464669307,0,5656,0,13149,583,0,19388,-7493,0.1502884917763707,383665,215082,
0,0.0,0,0,0,0,35836,42909,634583,0.0,168583,1842,0.051400194328452505,19386,11,7167,0,7178,64137,0.01838378618992083,23523,0,-7156,0,0.43145562464669307,0,5656,0,13149,583,0,19388,-7493,0.1502884917763707,383665,215082,
0,0.0,0,0,0,0,35836,42909,634583,0.0,168583,1842,0.051400194328452505,19386,11,7167,0,7178,64137,0.01838378618992083,23523,0,-7156,0,0.43145562464669307,0,5656,0,13149,583,0,19388,-7493,0.1502884917763707,383665,215082,
0,0.0,0,0,0,0,35836,42909,634583,0.0,168583,1842,0.051400194328452505,19386,11,7167,0,7178,64137,0.01838378618992083,23523,0,-7156,0,0.43145562464669307,0,5656,0,13149,583,0,19388,-7493,0.1502884917763707,383665,215082,
0,0.0,0,0,0,0,35836,42909,634583,0.0,168583,1842,0.051400194328452505,19386,11,7167,0,7178,64137,0.01838378618992083,23523,0,-7156,0,0.43145562464669307,0,5656,0,13149,583,0,19388,-7493,0.1502884917763707,383665,215082,
0,0.0,0,0,0,0,35836,42909,634583,0.0,168583,1842,0.051400194328452505,19386,11,7167,0,7178,64137,0.01838378618992083,23523,0,-7156,0,0.43145562464669307,0,5656,0,13149,583,0,19388,-7493,0.1502884917763707,383665,215082,
0,0.0,0,0,0,0,35836,42909,634583,0.0,168583,1842,0.051400194328452505,19386,11,7167,0,7178,64137,0.01838378618992083,23523,0,-7156,0,0.43145562464669307,0,5656,0,13149,583,0,19388,-7493,0.1502884917763707,383665,215082,
0,0.0,0,0,0,0,35836,42909,634583,0.0,168583,1842,0.051400194328452505,19386,11,7167,0,7178,64137,0.01838378618992083,23523,0,-7156,0,0.43145562464669307,0,5656,0,13149,583,0,19388,-7493,0.1502884917763707,383665,215082,
0,0.0,0,0,0,0,35836,42909,634583,0.0,168583,1842,0.051400194328452505,19386,11,7167,0,7178,64137,0.01838378618992083,23523,0,-7156,0,0.43145562464669307,0,5656,0,13149,583,0,19388,-7493,0.1502884917763707,383665,215082,
0,0.0,0,0,0,0,35836,42909,634583,0.0,168583,1842,0.051400194328452505,19386,11,7167,0,7178,64137,0.01838378618992083,23523,0,-7156,0,0.43145562464669307,0,5656,0,13149,583,0,19388,-7493,0.1502884917763707,383665,215082,
0,0.0,0,0,0,0,35836,42909,634583,0.0,168583,1842,0.051400194328452505,19386,11,7167,0,7178,64137,0.01838378618992083,23523,0,-7156,0,0.43145562464669307,0,5656,0,13149,583,0,19388,-7493,0.1502884917763707,383665,215082,
0,0.0,0,0,0,0,35836,42909,634583,0.0,168583,1842,0.051400194328452505,19386,11,7167,0,7178,64137,0.01838378618992083,23523,0,-7156,0,0.43145562464669307,0,5656,0,13149,583,0,19388,-7493,0.1502884917763707,383665,215082,
0,0.0,0,0,0,0,35836,42909,634583,0.0,168583,1842,0.051400194328452505,19386,11,7167,0,7178,64137,0.01838378618992083,23523,0,-7156,0,0.43145562464669307,0,5656,0,13149,583,0,19388,-7493,0.1502884917763707,383665,215082,
0,0.0,0,0,0,0,35836,42909,634583,0.0,168583,1842,0.051400194328452505,19386,11,7167,0,7178,64137,0.01838378618992083,23523,0,-7156,0,0.43145562464669307,0,5656,0,13149,583,0,19388,-7493,0.1502884917763707,383665,215082,
0,0.0,0,0,0,0,35836,42909,634583,0.0,168583,1842,0.051400194328452505,19386,11,7167,0,7178,64137,0.01838378618992083,23523,0,-7156,0,0.43145562464669307,0,5656,0,13149,583,0,19388,-7493,0.1502884917763707,383665,215082,
0,0.0,0,0,0,0,35836,42909,634583,0.0,168583,1842,0.051400194328452505,19386,11,7167,0,7178,64137,0.01838378618992083,23523,0,-7156,0,0.43145562464669307,0,5656,0,13149,583,0,19388,-7493,0.1502884917763707,383665,215082,
0,0.0,0,0,0,0,35836,42909,634583,0.0,168583,1842,0.051400194328452505,19386,11,7167,0,7178,64137,0.01838378618992083,23523,0,-7156,0,0.43145562464669307,0,5656,0,13149,583,0,19388,-7493,0.1502884917763707,383665,215082,
0,0.0,0,0,0,0,35836,42909,634583,0.0,168583,1842,0.051400194328452505,19386,11,7167,0,7178,64137,0.01838378618992083,23523,0,-7156,0,0.43145562464669307,0,5656,0,13149,583,0,19388,-7493,0.1502884917763707,383665,215082,
0,0.0,0,0,0,0,35836,42909,634583,0.0,168583,1842,0.051400194328452505,19386,11,7167,0,7178,64137,0.01838378618992083,23523,0,-7156,0,0.43145562464669307,0,5656,0,13149,583,0,19388,-7493,0.1502884917763707,383665,215082,
0,0.0,0,0,0,0,35836,42909,634583,0.0,168583,1842,0.051400194328452505,19386,11,7167,0,7178,64137,0.01838378618992083,23523,0,-7156,0,0.43145562464669307,0,5656,0,13149,583,0,19388,-7493,0.1502884917763707,383665,215082,
0,0.0,0,0,0,0,35836,42909,634583,0.0,168583,1842,0.051400194328452505,19386,11,7167,0,7178,64137,0.01838378618992083,23523,0,-7156,0,0.43145562464669307,0,5656,0,13149,583,0,19388,-7493,0.1502884917763707,383665,215082,
0,0.0,0,0,0,0,35836,42909,634583,0.0,168583,1842,0.051400194328452505,19386,11,7167,0,7178,64137,0.01838378618992083,23523,0,-7156,0,0.43145562464669307,0,5656,0,13149,583,0,19388,-7493,0.1502884917763707,383665,215082,
0,0.0,0,0,0,0,35836,42909,634583,0.0,168583,1842,0.051400194328452505,19386,11,7167,0,7178,64137,0.01838378618992083,23523,0,-7156,0,0.43145562464669307,0,5656,0,13149,583,0,19388,-7493,0.1502884917763707,383665,215082,
0,0.0,0,0,0,0,35836,42909,634583,0.0,168583,1842,0.051400194328452505,19386,11,7167,0,7178,64137,0.01838378618992083,23523,0,-7156,0,0.43145562464669307,0,5656,0,13149,583,0,19388,-7493,0.1502884917763707,383665,215082,
0,0.0,0,0,0,0,35836,42909,634583,0.0,168583,1842,0.051400194328452505,19386,11,7167,0,7178,64137,0.01838378618992083,23523,0,-7156,0,0.43145562464669307,0,5656,0,13149,583,0,19388,-7493,0.1502884917763707,383665,215082,
0,0.0,0,0,0,0,35836,42909,634583,0.0,168583,1842,0.051400194328452505,19386,11,7167,0,7178,64137,0.01838378618992083,23523,0,-7156,0,0.43145562464669307,0,5656,0,13149,583,0,19388,-7493,0.1502884917763707,383665,215082,
0,0.0,0,0,0,0,35836,42909,634583,0.0,168583,1842,0.051400194328452505,19386,11,7167,0,7178,64137,0.01838378618992083,23523,0,-7156,0,0.43145562464669307,0,5656,0,13149,583,0,19388,-7493,0.1502884917763707,383665,215082,
0,0.0,0,0,0,0,35836,42909,634583,0.0,168583,1842,0.051400194328452505,19386,11,7167,0,7178,64137,0.01838378618992083,23523,0,-7156,0,0.43145562464669307,0,5656,0,13149,583,0,19388,-7493,0.1502884917763707,383665,215082,
0,0.0,0,0,0,0,35836,42909,634583,0.0,168583,1842,0.051400194328452505,19386,11,7167,0,7178,64137,0.01838378618992083,23523,0,-7156,0,0.43145562464669307,0,5656,0,13149,583,0,19388,-7493,0.1502884917763707,383665,215082,
0,0.0,0,0,0,0,35836,42909,634583,0.0,168583,1842,0.051400194328452505,19386,11,7167,0,7178,64137,0.01838378618992083,23523,0,-7156,0,0.43145562464669307,0,5656,0,13149,583,0,19388,-7493,0.1502884917763707,383665,215082,
0,0.0,0,0,0,0,35836,42909,634583,0.0,168583,1842,0.051400194328452505,19386,53,5,3,61,64137,0.01838378618992083,23523,0,48,0,0.019981282751385117,0,5656,0,13149,583,0,19388,-7493,0.1502884917763707,383665,215082,
0,0.0,0,0,0,0,35836,42909,634583,0.0,168583,1842,0.051400194328452505,19386,230,344,6,580,64137,0.01838378618992083,23523,0,-114,0,0.054873130418483664,0,5656,0,13149,583,0,19388,-7493,0.1502884917763707,383665,215082,
0,0.0,0,0,0,0,35836,42909,634583,0.0,168583,1842,0.051400194328452505,19386,230,344,6,580,64137,0.01838378618992083,23523,0,-114,0,0.054873130418483664,0,5656,0,13149,583,0,19388,-7493,0.1502884917763707,383665,215082,
0,0.0,0,0,0,0,35836,42909,634583,0.0,168583,1842,0.051400194328452505,19386,230,344,6,580,64137,0.01838378618992083,23523,0,-114,0,0.054873130418483664,0,5656,0,13149,583,0,19388,-7493,0.1502884917763707,383665,215082,
0,0.0,0,0,0,0,35836,42909,634583,0.0,168583,1842,0.051400194328452505,19386,230,344,6,580,64137,0.01838378618992083,23523,0,-114,0,0.054873130418483664,0,5656,0,13149,583,0,19388,-7493,0.1502884917763707,383665,215082,
0,0.0,0,0,0,0,35836,42909,634583,0.0,168583,1842,0.051400194328452505,19386,125,179,9,313,64137,0.01838378618992083,23523,0,-54,0,0.12562454899742734,0,5656,0,13149,583,0,19388,-7493,0.1502884917763707,383665,215082,
1,0.007633587786259542,0,1,0,2,35836,42909,634583,0.003816793893129771,168583,1842,0.051400194328452505,19386,148,81,80,309,64137,0.01838378618992083,23523,1,67,1,0.1291024349898544,2,252,0,120,81,0,453,132,0.07665835789962638,383665,215082,
1,0.0,0,1,0,2,35836,42909,634583,0.003816793893129771,168583,1842,0.051400194328452505,19386,104,39,1,144,64137,0.01838378618992083,23523,0,65,0,0.024214280809398345,0,252,0,120,81,0,453,132,0.07665835789962638,383665,215082,
1,0.0,0,1,0,2,35836,42909,634583,0.003816793893129771,168583,1842,0.051400194328452505,19386,104,39,1,144,64137,0.01838378618992083,23523,0,65,0,0.024214280809398345,0,252,0,120,81,0,453,132,0.07665835789962638,383665,215082,
1,0.0,0,1,0,2,35836,42909,634583,0.003816793893129771,168583,1842,0.051400194328452505,19386,104,39,1,144,64137,0.01838378618992083,23523,0,65,0,0.024214280809398345,0,252,0,120,81,0,453,132,0.07665835789962638,383665,215082,
66,0.05,2,127,-61,195,35836,42909,634583,0.026876795643369287,168583,1842,0.051400194328452505,19386,182,5,0,187,64137,0.01838378618992083,23523,1,177,2,0.30238095238095236,3,2470,0,722,271,1,3463,1748,0.1296889657414918,383665,215082,
66,0.0,2,127,-61,195,35836,42909,634583,0.026876795643369287,168583,1842,0.051400194328452505,19386,75,0,0,75,64137,0.01838378618992083,23523,0,75,0,0.5,0,2470,0,722,271,0,3463,1748,0.1296889657414918,383665,215082,
66,0.0,2,127,-61,195,35836,42909,634583,0.026876795643369287,168583,1842,0.051400194328452505,19386,75,0,0,75,64137,0.01838378618992083,23523,0,75,0,0.5,0,2470,0,722,271,0,3463,1748,0.1296889657414918,383665,215082,
66,0.0,2,127,-61,195,35836,42909,634583,0.026876795643369287,168583,1842,0.051400194328452505,19386,75,0,0,75,64137,0.01838378618992083,23523,0,75,0,0.5,0,2470,0,722,271,0,3463,1748,0.1296889657414918,383665,215082,
66,0.006944444444444444,2,127,-61,195,35836,42909,634583,0.026876795643369287,168583,1842,0.051400194328452505,19386,380,93,93,566,64137,0.01838378618992083,23523,1,287,1,0.1842407332786432,2,2470,0,722,271,0,3463,1748,0.1296889657414918,383665,215082,
66,0.0,2,127,-61,195,35836,42909,634583,0.026876795643369287,168583,1842,0.051400194328452505,19386,48,2,4,54,64137,0.01838378618992083,23523,0,46,0,0.04280765843069902,0,2470,0,722,271,0,3463,1748,0.1296889657414918,383665,215082,
66,0.0,2,127,-61,195,35836,42909,634583,0.026876795643369287,168583,1842,0.051400194328452505,19386,70,70,0,140,64137,0.01838378618992083,23523,0,0,0,0.146295865427397,0,2470,0,722,271,0,3463,1748,0.1296889657414918,383665,215082,
66,0.0,2,127,-61,195,35836,42909,634583,0.026876795643369287,168583,1842,0.051400194328452505,19386,563,6,0,569,64137,0.01838378618992083,23523,0,557,0,0.3776177698594771,0,2470,0,722,271,0,3463,1748,0.1296889657414918,383665,215082,
66,0.0,2,127,-61,195,35836,42909,634583,0.026876795643369287,168583,1842,0.051400194328452505,19386,378,191,0,569,64137,0.01838378618992083,23523,0,187,0,0.20965141966212936,0,2470,0,722,271,0,3463,1748,0.1296889657414918,383665,215082,
66,0.0,2,127,-61,195,35836,42909,634583,0.026876795643369287,168583,1842,0.051400194328452505,19386,378,191,0,569,64137,0.01838378618992083,23523,0,187,0,0.20965141966212936,0,2470,0,722,271,0,3463,1748,0.1296889657414918,383665,215082,
66,0.0,2,127,-61,195,35836,42909,634583,0.026876795643369287,168583,1842,0.051400194328452505,19386,24,18,0,42,64137,0.01838378618992083,23523,0,6,0,0.16415800036489692,0,2470,0,722,271,0,3463,1748,0.1296889657414918,383665,215082,
66,0.0,2,127,-61,195,35836,42909,634583,0.026876795643369287,168583,1842,0.051400194328452505,19386,24,18,0,42,64137,0.01838378618992083,23523,0,6,0,0.16415800036489692,0,2470,0,722,271,0,3463,1748,0.1296889657414918,383665,215082,
66,0.0,2,127,-61,195,35836,42909,634583,0.026876795643369287,168583,1842,0.051400194328452505,19386,7,0,0,7,64137,0.01838378618992083,23523,0,7,0,0.004181600955794504,0,2470,0,722,271,0,3463,1748,0.1296889657414918,383665,215082,
66,0.0,2,127,-61,195,35836,42909,634583,0.026876795643369287,168583,1842,0.051400194328452505,19386,17,0,0,17,64137,0.01838378618992083,23523,0,17,0,0.10581127733026467,0,2470,0,722,271,0,3463,1748,0.1296889657414918,383665,215082,
66,0.04048359240069085,2,127,-61,195,35836,42909,634583,0.026876795643369287,168583,1842,0.051400194328452505,19386,59,18,2,79,64137,0.01838378618992083,23523,2,41,10,0.1063638486914305,12,2470,0,722,271,8,3463,1748,0.1296889657414918,383665,215082,
66,0.04048359240069085,2,127,-61,195,35836,42909,634583,0.026876795643369287,168583,1842,0.051400194328452505,19386,59,18,2,79,64137,0.01838378618992083,23523,2,41,10,0.1063638486914305,12,2470,0,722,271,8,3463,1748,0.1296889657414918,383665,215082,
66,0.4970414201183432,2,127,-61,195,35836,42909,634583,0.026876795643369287,168583,1842,0.051400194328452505,19386,46,120,2,168,64137,0.01838378618992083,23523,120,-74,46,0.3313609467455621,168,2470,2,722,271,-74,3463,1748,0.1296889657414918,383665,215082,
66,0.4970414201183432,2,127,-61,195,35836,42909,634583,0.026876795643369287,168583,1842,0.051400194328452505,19386,46,120,2,168,64137,0.01838378618992083,23523,120,-74,46,0.3313609467455621,168,2470,2,722,271,-74,3463,1748,0.1296889657414918,383665,215082,
66,0.4970414201183432,2,127,-61,195,35836,42909,634583,0.026876795643369287,168583,1842,0.051400194328452505,19386,46,120,2,168,64137,0.01838378618992083,23523,120,-74,46,0.3313609467455621,168,2470,2,722,271,-74,3463,1748,0.1296889657414918,383665,215082,
842,0.1754814842388477,36,739,103,1617,35836,42909,634583,0.09918009443655847,168583,1842,0.051400194328452505,19386,3566,2369,299,6234,64137,0.01838378618992083,23523,232,1197,218,0.1805553994154673,473,11420,23,7160,1945,-14,20525,4260,0.09379802968443353,383665,215082,
842,0.1754814842388477,36,739,103,1617,35836,42909,634583,0.09918009443655847,168583,1842,0.051400194328452505,19386,3566,2369,299,6234,64137,0.01838378618992083,23523,232,1197,218,0.1805553994154673,473,11420,23,7160,1945,-14,20525,4260,0.09379802968443353,383665,215082,
842,0.1754814842388477,36,739,103,1617,35836,42909,634583,0.09918009443655847,168583,1842,0.051400194328452505,19386,3566,2369,299,6234,64137,0.01838378618992083,23523,232,1197,218,0.1805553994154673,473,11420,23,7160,1945,-14,20525,4260,0.09379802968443353,383665,215082,
842,0.1754814842388477,36,739,103,1617,35836,42909,634583,0.09918009443655847,168583,1842,0.051400194328452505,19386,3566,2369,299,6234,64137,0.01838378618992083,23523,232,1197,218,0.1805553994154673,473,11420,23,7160,1945,-14,20525,4260,0.09379802968443353,383665,215082,
842,0.1754814842388477,36,739,103,1617,35836,42909,634583,0.09918009443655847,168583,1842,0.051400194328452505,19386,3566,2369,299,6234,64137,0.01838378618992083,23523,232,1197,218,0.1805553994154673,473,11420,23,7160,1945,-14,20525,4260,0.09379802968443353,383665,215082,
842,0.1754814842388477,36,739,103,1617,35836,42909,634583,0.09918009443655847,168583,1842,0.051400194328452505,19386,3566,2369,299,6234,64137,0.01838378618992083,23523,232,1197,218,0.1805553994154673,473,11420,23,7160,1945,-14,20525,4260,0.09379802968443353,383665,215082,
842,0.2511007874164403,36,739,103,1617,35836,42909,634583,0.09918009443655847,168583,1842,0.051400194328452505,19386,472,533,56,1061,64137,0.01838378618992083,23523,173,-61,92,0.09370754454179697,268,11420,3,7160,1945,-81,20525,4260,0.09379802968443353,383665,215082,
842,0.2511007874164403,36,739,103,1617,35836,42909,634583,0.09918009443655847,168583,1842,0.051400194328452505,19386,472,533,56,1061,64137,0.01838378618992083,23523,173,-61,92,0.09370754454179697,268,11420,3,7160,1945,-81,20525,4260,0.09379802968443353,383665,215082,
842,0.2511007874164403,36,739,103,1617,35836,42909,634583,0.09918009443655847,168583,1842,0.051400194328452505,19386,472,533,56,1061,64137,0.01838378618992083,23523,173,-61,92,0.09370754454179697,268,11420,3,7160,1945,-81,20525,4260,0.09379802968443353,383665,215082,
842,0.11825246904319003,36,739,103,1617,35836,42909,634583,0.09918009443655847,168583,1842,0.051400194328452505,19386,3822,2050,1509,7381,64137,0.01838378618992083,23523,34,1772,234,0.1385451864056668,274,11420,6,7160,1945,200,20525,4260,0.09379802968443353,383665,215082,
842,0.11825246904319003,36,739,103,1617,35836,42909,634583,0.09918009443655847,168583,1842,0.051400194328452505,19386,3822,2050,1509,7381,64137,0.01838378618992083,23523,34,1772,234,0.1385451864056668,274,11420,6,7160,1945,200,20525,4260,0.09379802968443353,383665,215082,
842,0.11825246904319003,36,739,103,1617,35836,42909,634583,0.09918009443655847,168583,1842,0.051400194328452505,19386,3822,2050,1509,7381,64137,0.01838378618992083,23523,34,1772,234,0.1385451864056668,274,11420,6,7160,1945,200,20525,4260,0.09379802968443353,383665,215082,
842,0.11825246904319003,36,739,103,1617,35836,42909,634583,0.09918009443655847,168583,1842,0.051400194328452505,19386,3822,2050,1509,7381,64137,0.01838378618992083,23523,34,1772,234,0.1385451864056668,274,11420,6,7160,1945,200,20525,4260,0.09379802968443353,383665,215082,
842,0.11825246904319003,36,739,103,1617,35836,42909,634583,0.09918009443655847,168583,1842,0.051400194328452505,19386,3822,2050,1509,7381,64137,0.01838378618992083,23523,34,1772,234,0.1385451864056668,274,11420,6,7160,1945,200,20525,4260,0.09379802968443353,383665,215082,
842,0.11825246904319003,36,739,103,1617,35836,42909,634583,0.09918009443655847,168583,1842,0.051400194328452505,19386,3822,2050,1509,7381,64137,0.01838378618992083,23523,34,1772,234,0.1385451864056668,274,11420,6,7160,1945,200,20525,4260,0.09379802968443353,383665,215082,
842,0.11825246904319003,36,739,103,1617,35836,42909,634583,0.09918009443655847,168583,1842,0.051400194328452505,19386,3822,2050,1509,7381,64137,0.01838378618992083,23523,34,1772,234,0.1385451864056668,274,11420,6,7160,1945,200,20525,4260,0.09379802968443353,383665,215082,
842,0.0,36,739,103,1617,35836,42909,634583,0.09918009443655847,168583,1842,0.051400194328452505,19386,1325,623,1,1949,64137,0.01838378618992083,23523,0,702,0,0.08365860151225947,0,11420,0,7160,1945,0,20525,4260,0.09379802968443353,383665,215082,
842,0.0,36,739,103,1617,35836,42909,634583,0.09918009443655847,168583,1842,0.051400194328452505,19386,1325,623,1,1949,64137,0.01838378618992083,23523,0,702,0,0.08365860151225947,0,11420,0,7160,1945,0,20525,4260,0.09379802968443353,383665,215082,
842,0.10853725369207126,36,739,103,1617,35836,42909,634583,0.09918009443655847,168583,1842,0.051400194328452505,19386,378,195,19,592,64137,0.01838378618992083,23523,11,183,111,0.10895405094494318,125,11420,3,7160,1945,100,20525,4260,0.09379802968443353,383665,215082,
842,0.0,36,739,103,1617,35836,42909,634583,0.09918009443655847,168583,1842,0.051400194328452505,19386,55,112,8,175,64137,0.01838378618992083,23523,0,-57,0,0.12437035339971322,0,11420,0,7160,1945,0,20525,4260,0.09379802968443353,383665,215082,
842,0.19047619047619047,36,739,103,1617,35836,42909,634583,0.09918009443655847,168583,1842,0.051400194328452505,19386,132,12,0,144,64137,0.01838378618992083,23523,3,120,5,0.11244737114846244,8,11420,0,7160,1945,2,20525,4260,0.09379802968443353,383665,215082,
0,0.0,0,0,0,0,35836,42909,634583,0.0,168583,1842,0.051400194328452505,19386,81,128,0,209,64137,0.01838378618992083,23523,0,-47,0,0.13393423102043905,0,3057,0,10170,292,0,13519,-7113,0.07489309435914684,383665,215082,
0,0.0,0,0,0,0,35836,42909,634583,0.0,168583,1842,0.051400194328452505,19386,47,24,0,71,64137,0.01838378618992083,23523,0,23,0,0.01931505613222065,0,3057,0,10170,292,0,13519,-7113,0.07489309435914684,383665,215082,
0,0.0,0,0,0,0,35836,42909,634583,0.0,168583,1842,0.051400194328452505,19386,47,24,0,71,64137,0.01838378618992083,23523,0,23,0,0.01931505613222065,0,3057,0,10170,292,0,13519,-7113,0.07489309435914684,383665,215082,
0,0.0,0,0,0,0,35836,42909,634583,0.0,168583,1842,0.051400194328452505,19386,47,24,0,71,64137,0.01838378618992083,23523,0,23,0,0.01931505613222065,0,3057,0,10170,292,0,13519,-7113,0.07489309435914684,383665,215082,
0,0.0,0,0,0,0,35836,42909,634583,0.0,168583,1842,0.051400194328452505,19386,47,24,0,71,64137,0.01838378618992083,23523,0,23,0,0.01931505613222065,0,3057,0,10170,292,0,13519,-7113,0.07489309435914684,383665,215082,
0,0.0,0,0,0,0,35836,42909,634583,0.0,168583,1842,0.051400194328452505,19386,47,24,0,71,64137,0.01838378618992083,23523,0,23,0,0.01931505613222065,0,3057,0,10170,292,0,13519,-7113,0.07489309435914684,383665,215082,
0,0.0,0,0,0,0,35836,42909,634583,0.0,168583,1842,0.051400194328452505,19386,47,24,0,71,64137,0.01838378618992083,23523,0,23,0,0.01931505613222065,0,3057,0,10170,292,0,13519,-7113,0.07489309435914684,383665,215082,
0,0.0,0,0,0,0,35836,42909,634583,0.0,168583,1842,0.051400194328452505,19386,0,3721,0,3721,64137,0.01838378618992083,23523,0,-3721,0,0.22356404710406153,0,3057,0,10170,292,0,13519,-7113,0.07489309435914684,383665,215082,
0,0.0,0,0,0,0,35836,42909,634583,0.0,168583,1842,0.051400194328452505,19386,0,3721,0,3721,64137,0.01838378618992083,23523,0,-3721,0,0.22356404710406153,0,3057,0,10170,292,0,13519,-7113,0.07489309435914684,383665,215082,
0,0.0,0,0,0,0,35836,42909,634583,0.0,168583,1842,0.051400194328452505,19386,0,3721,0,3721,64137,0.01838378618992083,23523,0,-3721,0,0.22356404710406153,0,3057,0,10170,292,0,13519,-7113,0.07489309435914684,383665,215082,
0,0.0,0,0,0,0,35836,42909,634583,0.0,168583,1842,0.051400194328452505,19386,0,3721,0,3721,64137,0.01838378618992083,23523,0,-3721,0,0.22356404710406153,0,3057,0,10170,292,0,13519,-7113,0.07489309435914684,383665,215082,
0,0.0,0,0,0,0,35836,42909,634583,0.0,168583,1842,0.051400194328452505,19386,0,3721,0,3721,64137,0.01838378618992083,23523,0,-3721,0,0.22356404710406153,0,3057,0,10170,292,0,13519,-7113,0.07489309435914684,383665,215082,
0,0.0,0,0,0,0,35836,42909,634583,0.0,168583,1842,0.051400194328452505,19386,0,3721,0,3721,64137,0.01838378618992083,23523,0,-3721,0,0.22356404710406153,0,3057,0,10170,292,0,13519,-7113,0.07489309435914684,383665,215082,
0,0.0,0,0,0,0,35836,42909,634583,0.0,168583,1842,0.051400194328452505,19386,0,3721,0,3721,64137,0.01838378618992083,23523,0,-3721,0,0.22356404710406153,0,3057,0,10170,292,0,13519,-7113,0.07489309435914684,383665,215082,
0,0.0,0,0,0,0,35836,42909,634583,0.0,168583,1842,0.051400194328452505,19386,0,3721,0,3721,64137,0.01838378618992083,23523,0,-3721,0,0.22356404710406153,0,3057,0,10170,292,0,13519,-7113,0.07489309435914684,383665,215082,
0,0.0,0,0,0,0,35836,42909,634583,0.0,168583,1842,0.051400194328452505,19386,0,3721,0,3721,64137,0.01838378618992083,23523,0,-3721,0,0.22356404710406153,0,3057,0,10170,292,0,13519,-7113,0.07489309435914684,383665,215082,
0,0.0,0,0,0,0,35836,42909,634583,0.0,168583,1842,0.051400194328452505,19386,0,3721,0,3721,64137,0.01838378618992083,23523,0,-3721,0,0.22356404710406153,0,3057,0,10170,292,0,13519,-7113,0.07489309435914684,383665,215082,
0,0.0,0,0,0,0,35836,42909,634583,0.0,168583,1842,0.051400194328452505,19386,0,3119,0,3119,64137,0.01838378618992083,23523,0,-3119,0,0.15167282629838552,0,3057,0,10170,292,0,13519,-7113,0.07489309435914684,383665,215082,
0,0.0,0,0,0,0,35836,42909,634583,0.0,168583,1842,0.051400194328452505,19386,0,3119,0,3119,64137,0.01838378618992083,23523,0,-3119,0,0.15167282629838552,0,3057,0,10170,292,0,13519,-7113,0.07489309435914684,383665,215082,
0,0.0,0,0,0,0,35836,42909,634583,0.0,168583,1842,0.051400194328452505,19386,0,3119,0,3119,64137,0.01838378618992083,23523,0,-3119,0,0.15167282629838552,0,3057,0,10170,292,0,13519,-7113,0.07489309435914684,383665,215082,
0,0.0,0,0,0,0,35836,42909,634583,0.0,168583,1842,0.051400194328452505,19386,0,3119,0,3119,64137,0.01838378618992083,23523,0,-3119,0,0.15167282629838552,0,3057,0,10170,292,0,13519,-7113,0.07489309435914684,383665,215082,
0,0.0,0,0,0,0,35836,42909,634583,0.0,168583,1842,0.051400194328452505,19386,0,3119,0,3119,64137,0.01838378618992083,23523,0,-3119,0,0.15167282629838552,0,3057,0,10170,292,0,13519,-7113,0.07489309435914684,383665,215082,
0,0.0,0,0,0,0,35836,42909,634583,0.0,168583,1842,0.051400194328452505,19386,0,3119,0,3119,64137,0.01838378618992083,23523,0,-3119,0,0.15167282629838552,0,3057,0,10170,292,0,13519,-7113,0.07489309435914684,383665,215082,
0,0.0,0,0,0,0,35836,42909,634583,0.0,168583,1842,0.051400194328452505,19386,0,3119,0,3119,64137,0.01838378618992083,23523,0,-3119,0,0.15167282629838552,0,3057,0,10170,292,0,13519,-7113,0.07489309435914684,383665,215082,
0,0.0,0,0,0,0,35836,42909,634583,0.0,168583,1842,0.051400194328452505,19386,0,3119,0,3119,64137,0.01838378618992083,23523,0,-3119,0,0.15167282629838552,0,3057,0,10170,292,0,13519,-7113,0.07489309435914684,383665,215082,
0,0.0,0,0,0,0,35836,42909,634583,0.0,168583,1842,0.051400194328452505,19386,0,3119,0,3119,64137,0.01838378618992083,23523,0,-3119,0,0.15167282629838552,0,3057,0,10170,292,0,13519,-7113,0.07489309435914684,383665,215082,
0,0.0,0,0,0,0,35836,42909,634583,0.0,168583,1842,0.051400194328452505,19386,0,3119,0,3119,64137,0.01838378618992083,23523,0,-3119,0,0.15167282629838552,0,3057,0,10170,292,0,13519,-7113,0.07489309435914684,383665,215082,
0,0.0,0,0,0,0,35836,42909,634583,0.0,168583,1842,0.051400194328452505,19386,0,3119,0,3119,64137,0.01838378618992083,23523,0,-3119,0,0.15167282629838552,0,3057,0,10170,292,0,13519,-7113,0.07489309435914684,383665,215082,
0,0.0,0,0,0,0,35836,42909,634583,0.0,168583,1842,0.051400194328452505,19386,0,3119,0,3119,64137,0.01838378618992083,23523,0,-3119,0,0.15167282629838552,0,3057,0,10170,292,0,13519,-7113,0.07489309435914684,383665,215082,
0,0.0,0,0,0,0,35836,42909,634583,0.0,168583,1842,0.051400194328452505,19386,0,3119,0,3119,64137,0.01838378618992083,23523,0,-3119,0,0.15167282629838552,0,3057,0,10170,292,0,13519,-7113,0.07489309435914684,383665,215082,
0,0.0,0,0,0,0,35836,42909,634583,0.0,168583,1842,0.051400194328452505,19386,0,3119,0,3119,64137,0.01838378618992083,23523,0,-3119,0,0.15167282629838552,0,3057,0,10170,292,0,13519,-7113,0.07489309435914684,383665,215082,
0,0.0,0,0,0,0,35836,42909,634583,0.0,168583,1842,0.051400194328452505,19386,0,3119,0,3119,64137,0.01838378618992083,23523,0,-3119,0,0.15167282629838552,0,3057,0,10170,292,0,13519,-7113,0.07489309435914684,383665,215082,
0,0.0,0,0,0,0,35836,42909,634583,0.0,168583,1842,0.051400194328452505,19386,0,3119,0,3119,64137,0.01838378618992083,23523,0,-3119,0,0.15167282629838552,0,3057,0,10170,292,0,13519,-7113,0.07489309435914684,383665,215082,
0,0.0,0,0,0,0,35836,42909,634583,0.0,168583,1842,0.051400194328452505,19386,0,3119,0,3119,64137,0.01838378618992083,23523,0,-3119,0,0.15167282629838552,0,3057,0,10170,292,0,13519,-7113,0.07489309435914684,383665,215082,
0,0.0,0,0,0,0,35836,42909,634583,0.0,168583,1842,0.051400194328452505,19386,0,3119,0,3119,64137,0.01838378618992083,23523,0,-3119,0,0.15167282629838552,0,3057,0,10170,292,0,13519,-7113,0.07489309435914684,383665,215082,
0,0.0,0,0,0,0,35836,42909,634583,0.0,168583,1842,0.051400194328452505,19386,0,3119,0,3119,64137,0.01838378618992083,23523,0,-3119,0,0.15167282629838552,0,3057,0,10170,292,0,13519,-7113,0.07489309435914684,383665,215082,
0,0.0,0,0,0,0,35836,42909,634583,0.0,168583,1842,0.051400194328452505,19386,0,3119,0,3119,64137,0.01838378618992083,23523,0,-3119,0,0.15167282629838552,0,3057,0,10170,292,0,13519,-7113,0.07489309435914684,383665,215082,
0,0.0,0,0,0,0,35836,42909,634583,0.0,168583,1842,0.051400194328452505,19386,0,3119,0,3119,64137,0.01838378618992083,23523,0,-3119,0,0.15167282629838552,0,3057,0,10170,292,0,13519,-7113,0.07489309435914684,383665,215082,
0,0.0,0,0,0,0,35836,42909,634583,0.0,168583,1842,0.051400194328452505,19386,0,3119,0,3119,64137,0.01838378618992083,23523,0,-3119,0,0.15167282629838552,0,3057,0,10170,292,0,13519,-7113,0.07489309435914684,383665,215082,
0,0.0,0,0,0,0,35836,42909,634583,0.0,168583,1842,0.051400194328452505,19386,0,3119,0,3119,64137,0.01838378618992083,23523,0,-3119,0,0.15167282629838552,0,3057,0,10170,292,0,13519,-7113,0.07489309435914684,383665,215082,
0,0.0,0,0,0,0,35836,42909,634583,0.0,168583,1842,0.051400194328452505,19386,0,3119,0,3119,64137,0.01838378618992083,23523,0,-3119,0,0.15167282629838552,0,3057,0,10170,292,0,13519,-7113,0.07489309435914684,383665,215082,
0,0.0,0,0,0,0,35836,42909,634583,0.0,168583,1842,0.051400194328452505,19386,0,3119,0,3119,64137,0.01838378618992083,23523,0,-3119,0,0.15167282629838552,0,3057,0,10170,292,0,13519,-7113,0.07489309435914684,383665,215082,
0,0.0,0,0,0,0,35836,42909,634583,0.0,168583,1842,0.051400194328452505,19386,0,3119,0,3119,64137,0.01838378618992083,23523,0,-3119,0,0.15167282629838552,0,3057,0,10170,292,0,13519,-7113,0.07489309435914684,383665,215082,
0,0.0,0,0,0,0,35836,42909,634583,0.0,168583,1842,0.051400194328452505,19386,0,3119,0,3119,64137,0.01838378618992083,23523,0,-3119,0,0.15167282629838552,0,3057,0,10170,292,0,13519,-7113,0.07489309435914684,383665,215082,
0,0.0,0,0,0,0,35836,42909,634583,0.0,168583,1842,0.051400194328452505,19386,0,3119,0,3119,64137,0.01838378618992083,23523,0,-3119,0,0.15167282629838552,0,3057,0,10170,292,0,13519,-7113,0.07489309435914684,383665,215082,
0,0.0,0,0,0,0,35836,42909,634583,0.0,168583,1842,0.051400194328452505,19386,0,3119,0,3119,64137,0.01838378618992083,23523,0,-3119,0,0.15167282629838552,0,3057,0,10170,292,0,13519,-7113,0.07489309435914684,383665,215082,
0,0.0,0,0,0,0,35836,42909,634583,0.0,168583,1842,0.051400194328452505,19386,0,3119,0,3119,64137,0.01838378618992083,23523,0,-3119,0,0.15167282629838552,0,3057,0,10170,292,0,13519,-7113,0.07489309435914684,383665,215082,
0,0.0,0,0,0,0,35836,42909,634583,0.0,168583,1842,0.051400194328452505,19386,0,3119,0,3119,64137,0.01838378618992083,23523,0,-3119,0,0.15167282629838552,0,3057,0,10170,292,0,13519,-7113,0.07489309435914684,383665,215082,
0,0.0,0,0,0,0,35836,42909,634583,0.0,168583,1842,0.051400194328452505,19386,0,3119,0,3119,64137,0.01838378618992083,23523,0,-3119,0,0.15167282629838552,0,3057,0,10170,292,0,13519,-7113,0.07489309435914684,383665,215082,
0,0.0,0,0,0,0,35836,42909,634583,0.0,168583,1842,0.051400194328452505,19386,0,3119,0,3119,64137,0.01838378618992083,23523,0,-3119,0,0.15167282629838552,0,3057,0,10170,292,0,13519,-7113,0.07489309435914684,383665,215082,
0,0.0,0,0,0,0,35836,42909,634583,0.0,168583,1842,0.051400194328452505,19386,0,3119,0,3119,64137,0.01838378618992083,23523,0,-3119,0,0.15167282629838552,0,3057,0,10170,292,0,13519,-7113,0.07489309435914684,383665,215082,
0,0.0,0,0,0,0,35836,42909,634583,0.0,168583,1842,0.051400194328452505,19386,0,3119,0,3119,64137,0.01838378618992083,23523,0,-3119,0,0.15167282629838552,0,3057,0,10170,292,0,13519,-7113,0.07489309435914684,383665,215082,
0,0.0,0,0,0,0,35836,42909,634583,0.0,168583,1842,0.051400194328452505,19386,0,3119,0,3119,64137,0.01838378618992083,23523,0,-3119,0,0.15167282629838552,0,3057,0,10170,292,0,13519,-7113,0.07489309435914684,383665,215082,
0,0.0,0,0,0,0,35836,42909,634583,0.0,168583,1842,0.051400194328452505,19386,464,274,21,759,64137,0.01838378618992083,23523,0,190,0,0.0723282891994292,0,3057,0,10170,292,0,13519,-7113,0.07489309435914684,383665,215082,
0,0.0,0,0,0,0,35836,42909,634583,0.0,168583,1842,0.051400194328452505,19386,464,274,21,759,64137,0.01838378618992083,23523,0,190,0,0.0723282891994292,0,3057,0,10170,292,0,13519,-7113,0.07489309435914684,383665,215082,
0,0.0,0,0,0,0,35836,42909,634583,0.0,168583,1842,0.051400194328452505,19386,464,274,21,759,64137,0.01838378618992083,23523,0,190,0,0.0723282891994292,0,3057,0,10170,292,0,13519,-7113,0.07489309435914684,383665,215082,
0,0.0,0,0,0,0,35836,42909,634583,0.0,168583,1842,0.051400194328452505,19386,102,90,8,200,64137,0.01838378618992083,23523,0,12,0,0.0835741708347547,0,3057,0,10170,292,0,13519,-7113,0.07489309435914684,383665,215082,
0,0.0,0,0,0,0,35836,42909,634583,0.0,168583,1842,0.051400194328452505,19386,1064,1356,150,2570,64137,0.01838378618992083,23523,0,-292,0,0.1239060892304269,0,3057,0,10170,292,0,13519,-7113,0.07489309435914684,383665,215082,
0,0.0,0,0,0,0,35836,42909,634583,0.0,168583,1842,0.051400194328452505,19386,1064,1356,150,2570,64137,0.01838378618992083,23523,0,-292,0,0.1239060892304269,0,3057,0,10170,292,0,13519,-7113,0.07489309435914684,383665,215082,
0,0.0,0,0,0,0,35836,42909,634583,0.0,168583,1842,0.051400194328452505,19386,94,174,23,291,64137,0.01838378618992083,23523,0,-80,0,0.044397509644763904,0,3057,0,10170,292,0,13519,-7113,0.07489309435914684,383665,215082,
0,0.0,0,0,0,0,35836,42909,634583,0.0,168583,1842,0.051400194328452505,19386,94,174,23,291,64137,0.01838378618992083,23523,0,-80,0,0.044397509644763904,0,3057,0,10170,292,0,13519,-7113,0.07489309435914684,383665,215082,
0,0.0,0,0,0,0,35836,42909,634583,0.0,168583,1842,0.051400194328452505,19386,0,33,0,33,64137,0.01838378618992083,23523,0,-33,0,0.006126995915336057,0,0,0,124,0,0,124,-124,0.005683526076072453,383665,215082,
0,0.0,0,0,0,0,35836,42909,634583,0.0,168583,1842,0.051400194328452505,19386,0,28,0,28,64137,0.01838378618992083,23523,0,-28,0,0.005066039442735661,0,0,0,124,0,0,124,-124,0.005683526076072453,383665,215082,
0,0.0,0,0,0,0,35836,42909,634583,0.0,168583,1842,0.051400194328452505,19386,0,28,0,28,64137,0.01838378618992083,23523,0,-28,0,0.005066039442735661,0,0,0,124,0,0,124,-124,0.005683526076072453,383665,215082,
0,0.0,0,0,0,0,35836,42909,634583,0.0,168583,1842,0.051400194328452505,19386,0,28,0,28,64137,0.01838378618992083,23523,0,-28,0,0.005066039442735661,0,0,0,124,0,0,124,-124,0.005683526076072453,383665,215082,
2465,0.323943661971831,27,241,2224,2733,35836,42909,634583,0.03831224672260137,168583,1842,0.051400194328452505,19386,62,0,0,62,64137,0.01838378618992083,23523,0,62,23,0.28131455399061034,23,9120,0,2151,412,23,11683,6969,0.08382677513567144,383665,215082,
2465,0.323943661971831,27,241,2224,2733,35836,42909,634583,0.03831224672260137,168583,1842,0.051400194328452505,19386,62,0,0,62,64137,0.01838378618992083,23523,0,62,23,0.28131455399061034,23,9120,0,2151,412,23,11683,6969,0.08382677513567144,383665,215082,
2465,0.005089058524173028,27,241,2224,2733,35836,42909,634583,0.03831224672260137,168583,1842,0.051400194328452505,19386,418,61,11,490,64137,0.01838378618992083,23523,1,357,1,0.15153356154067565,2,9120,0,2151,412,0,11683,6969,0.08382677513567144,383665,215082,
2465,0.03456825322214942,27,241,2224,2733,35836,42909,634583,0.03831224672260137,168583,1842,0.051400194328452505,19386,914,94,22,1030,64137,0.01838378618992083,23523,37,820,100,0.08010566347303483,145,9120,8,2151,412,63,11683,6969,0.08382677513567144,383665,215082,
2465,0.03456825322214942,27,241,2224,2733,35836,42909,634583,0.03831224672260137,168583,1842,0.051400194328452505,19386,914,94,22,1030,64137,0.01838378618992083,23523,37,820,100,0.08010566347303483,145,9120,8,2151,412,63,11683,6969,0.08382677513567144,383665,215082,
2465,0.03456825322214942,27,241,2224,2733,35836,42909,634583,0.03831224672260137,168583,1842,0.051400194328452505,19386,914,94,22,1030,64137,0.01838378618992083,23523,37,820,100,0.08010566347303483,145,9120,8,2151,412,63,11683,6969,0.08382677513567144,383665,215082,
2465,0.03456825322214942,27,241,2224,2733,35836,42909,634583,0.03831224672260137,168583,1842,0.051400194328452505,19386,914,94,22,1030,64137,0.01838378618992083,23523,37,820,100,0.08010566347303483,145,9120,8,2151,412,63,11683,6969,0.08382677513567144,383665,215082,
2465,0.03456825322214942,27,241,2224,2733,35836,42909,634583,0.03831224672260137,168583,1842,0.051400194328452505,19386,914,94,22,1030,64137,0.01838378618992083,23523,37,820,100,0.08010566347303483,145,9120,8,2151,412,63,11683,6969,0.08382677513567144,383665,215082,
2465,0.03456825322214942,27,241,2224,2733,35836,42909,634583,0.03831224672260137,168583,1842,0.051400194328452505,19386,914,94,22,1030,64137,0.01838378618992083,23523,37,820,100,0.08010566347303483,145,9120,8,2151,412,63,11683,6969,0.08382677513567144,383665,215082,
2465,0.03456825322214942,27,241,2224,2733,35836,42909,634583,0.03831224672260137,168583,1842,0.051400194328452505,19386,914,94,22,1030,64137,0.01838378618992083,23523,37,820,100,0.08010566347303483,145,9120,8,2151,412,63,11683,6969,0.08382677513567144,383665,215082,
2465,0.03731343283582089,27,241,2224,2733,35836,42909,634583,0.03831224672260137,168583,1842,0.051400194328452505,19386,512,174,162,848,64137,0.01838378618992083,23523,1,338,4,0.22387268157420037,5,9120,0,2151,412,3,11683,6969,0.08382677513567144,383665,215082,
2465,0.002544633695875231,27,241,2224,2733,35836,42909,634583,0.03831224672260137,168583,1842,0.051400194328452505,19386,45,69,2,116,64137,0.01838378618992083,23523,45,-24,15,0.011699577134976762,62,9120,2,2151,412,-30,11683,6969,0.08382677513567144,383665,215082,
2465,0.002544633695875231,27,241,2224,2733,35836,42909,634583,0.03831224672260137,168583,1842,0.051400194328452505,19386,45,69,2,116,64137,0.01838378618992083,23523,45,-24,15,0.011699577134976762,62,9120,2,2151,412,-30,11683,6969,0.08382677513567144,383665,215082,
2465,0.002544633695875231,27,241,2224,2733,35836,42909,634583,0.03831224672260137,168583,1842,0.051400194328452505,19386,45,69,2,116,64137,0.01838378618992083,23523,45,-24,15,0.011699577134976762,62,9120,2,2151,412,-30,11683,6969,0.08382677513567144,383665,215082,
2465,0.002544633695875231,27,241,2224,2733,35836,42909,634583,0.03831224672260137,168583,1842,0.051400194328452505,19386,45,69,2,116,64137,0.01838378618992083,23523,45,-24,15,0.011699577134976762,62,9120,2,2151,412,-30,11683,6969,0.08382677513567144,383665,215082,
2465,0.002544633695875231,27,241,2224,2733,35836,42909,634583,0.03831224672260137,168583,1842,0.051400194328452505,19386,45,69,2,116,64137,0.01838378618992083,23523,45,-24,15,0.011699577134976762,62,9120,2,2151,412,-30,11683,6969,0.08382677513567144,383665,215082,
2465,0.002544633695875231,27,241,2224,2733,35836,42909,634583,0.03831224672260137,168583,1842,0.051400194328452505,19386,45,69,2,116,64137,0.01838378618992083,23523,45,-24,15,0.011699577134976762,62,9120,2,2151,412,-30,11683,6969,0.08382677513567144,383665,215082,
2465,0.053824362606232294,27,241,2224,2733,35836,42909,634583,0.03831224672260137,168583,1842,0.051400194328452505,19386,117,72,7,196,64137,0.01838378618992083,23523,8,45,7,0.08175798809514732,19,9120,4,2151,412,-1,11683,6969,0.08382677513567144,383665,215082,
2465,0.0,27,241,2224,2733,35836,42909,634583,0.03831224672260137,168583,1842,0.051400194328452505,19386,0,0,0,0,64137,0.01838378618992083,23523,0,0,0,0.0,0,9120,0,2151,412,0,11683,6969,0.08382677513567144,383665,215082,
2465,0.0,27,241,2224,2733,35836,42909,634583,0.03831224672260137,168583,1842,0.051400194328452505,19386,0,0,0,0,64137,0.01838378618992083,23523,0,0,0,0.0,0,9120,0,2151,412,0,11683,6969,0.08382677513567144,383665,215082,
2465,0.0,27,241,2224,2733,35836,42909,634583,0.03831224672260137,168583,1842,0.051400194328452505,19386,0,0,0,0,64137,0.01838378618992083,23523,0,0,0,0.0,0,9120,0,2151,412,0,11683,6969,0.08382677513567144,383665,215082,
2465,0.0,27,241,2224,2733,35836,42909,634583,0.03831224672260137,168583,1842,0.051400194328452505,19386,0,0,0,0,64137,0.01838378618992083,23523,0,0,0,0.0,0,9120,0,2151,412,0,11683,6969,0.08382677513567144,383665,215082,
2465,0.0,27,241,2224,2733,35836,42909,634583,0.03831224672260137,168583,1842,0.051400194328452505,19386,0,0,0,0,64137,0.01838378618992083,23523,0,0,0,0.0,0,9120,0,2151,412,0,11683,6969,0.08382677513567144,383665,215082,
2465,0.0,27,241,2224,2733,35836,42909,634583,0.03831224672260137,168583,1842,0.051400194328452505,19386,0,0,0,0,64137,0.01838378618992083,23523,0,0,0,0.0,0,9120,0,2151,412,0,11683,6969,0.08382677513567144,383665,215082,
2465,0.0,27,241,2224,2733,35836,42909,634583,0.03831224672260137,168583,1842,0.051400194328452505,19386,0,0,0,0,64137,0.01838378618992083,23523,0,0,0,0.0,0,9120,0,2151,412,0,11683,6969,0.08382677513567144,383665,215082,
2465,0.0,27,241,2224,2733,35836,42909,634583,0.03831224672260137,168583,1842,0.051400194328452505,19386,0,0,0,0,64137,0.01838378618992083,23523,0,0,0,0.0,0,9120,0,2151,412,0,11683,6969,0.08382677513567144,383665,215082,
2465,0.0,27,241,2224,2733,35836,42909,634583,0.03831224672260137,168583,1842,0.051400194328452505,19386,0,0,0,0,64137,0.01838378618992083,23523,0,0,0,0.0,0,9120,0,2151,412,0,11683,6969,0.08382677513567144,383665,215082,
2465,0.0,27,241,2224,2733,35836,42909,634583,0.03831224672260137,168583,1842,0.051400194328452505,19386,0,0,0,0,64137,0.01838378618992083,23523,0,0,0,0.0,0,9120,0,2151,412,0,11683,6969,0.08382677513567144,383665,215082,
2465,0.0,27,241,2224,2733,35836,42909,634583,0.03831224672260137,168583,1842,0.051400194328452505,19386,0,0,0,0,64137,0.01838378618992083,23523,0,0,0,0.0,0,9120,0,2151,412,0,11683,6969,0.08382677513567144,383665,215082,
2465,0.0,27,241,2224,2733,35836,42909,634583,0.03831224672260137,168583,1842,0.051400194328452505,19386,0,0,0,0,64137,0.01838378618992083,23523,0,0,0,0.0,0,9120,0,2151,412,0,11683,6969,0.08382677513567144,383665,215082,
2465,0.0,27,241,2224,2733,35836,42909,634583,0.03831224672260137,168583,1842,0.051400194328452505,19386,0,0,0,0,64137,0.01838378618992083,23523,0,0,0,0.0,0,9120,0,2151,412,0,11683,6969,0.08382677513567144,383665,215082,
2465,0.0,27,241,2224,2733,35836,42909,634583,0.03831224672260137,168583,1842,0.051400194328452505,19386,0,0,0,0,64137,0.01838378618992083,23523,0,0,0,0.0,0,9120,0,2151,412,0,11683,6969,0.08382677513567144,383665,215082,
2465,0.0,27,241,2224,2733,35836,42909,634583,0.03831224672260137,168583,1842,0.051400194328452505,19386,0,0,0,0,64137,0.01838378618992083,23523,0,0,0,0.0,0,9120,0,2151,412,0,11683,6969,0.08382677513567144,383665,215082,
2465,0.0,27,241,2224,2733,35836,42909,634583,0.03831224672260137,168583,1842,0.051400194328452505,19386,0,0,0,0,64137,0.01838378618992083,23523,0,0,0,0.0,0,9120,0,2151,412,0,11683,6969,0.08382677513567144,383665,215082,
2465,0.0,27,241,2224,2733,35836,42909,634583,0.03831224672260137,168583,1842,0.051400194328452505,19386,0,0,0,0,64137,0.01838378618992083,23523,0,0,0,0.0,0,9120,0,2151,412,0,11683,6969,0.08382677513567144,383665,215082,
2465,0.0,27,241,2224,2733,35836,42909,634583,0.03831224672260137,168583,1842,0.051400194328452505,19386,0,0,0,0,64137,0.01838378618992083,23523,0,0,0,0.0,0,9120,0,2151,412,0,11683,6969,0.08382677513567144,383665,215082,
2465,0.0,27,241,2224,2733,35836,42909,634583,0.03831224672260137,168583,1842,0.051400194328452505,19386,0,0,0,0,64137,0.01838378618992083,23523,0,0,0,0.0,0,9120,0,2151,412,0,11683,6969,0.08382677513567144,383665,215082,
2465,0.0,27,241,2224,2733,35836,42909,634583,0.03831224672260137,168583,1842,0.051400194328452505,19386,0,0,0,0,64137,0.01838378618992083,23523,0,0,0,0.0,0,9120,0,2151,412,0,11683,6969,0.08382677513567144,383665,215082,
2465,0.0,27,241,2224,2733,35836,42909,634583,0.03831224672260137,168583,1842,0.051400194328452505,19386,0,0,0,0,64137,0.01838378618992083,23523,0,0,0,0.0,0,9120,0,2151,412,0,11683,6969,0.08382677513567144,383665,215082,
2465,0.0,27,241,2224,2733,35836,42909,634583,0.03831224672260137,168583,1842,0.051400194328452505,19386,0,0,0,0,64137,0.01838378618992083,23523,0,0,0,0.0,0,9120,0,2151,412,0,11683,6969,0.08382677513567144,383665,215082,
2465,0.0,27,241,2224,2733,35836,42909,634583,0.03831224672260137,168583,1842,0.051400194328452505,19386,0,0,0,0,64137,0.01838378618992083,23523,0,0,0,0.0,0,9120,0,2151,412,0,11683,6969,0.08382677513567144,383665,215082,
2465,0.0,27,241,2224,2733,35836,42909,634583,0.03831224672260137,168583,1842,0.051400194328452505,19386,0,0,0,0,64137,0.01838378618992083,23523,0,0,0,0.0,0,9120,0,2151,412,0,11683,6969,0.08382677513567144,383665,215082,
2465,0.0,27,241,2224,2733,35836,42909,634583,0.03831224672260137,168583,1842,0.051400194328452505,19386,0,0,0,0,64137,0.01838378618992083,23523,0,0,0,0.0,0,9120,0,2151,412,0,11683,6969,0.08382677513567144,383665,215082,
2465,0.0,27,241,2224,2733,35836,42909,634583,0.03831224672260137,168583,1842,0.051400194328452505,19386,0,0,0,0,64137,0.01838378618992083,23523,0,0,0,0.0,0,9120,0,2151,412,0,11683,6969,0.08382677513567144,383665,215082,
2465,0.0,27,241,2224,2733,35836,42909,634583,0.03831224672260137,168583,1842,0.051400194328452505,19386,0,0,0,0,64137,0.01838378618992083,23523,0,0,0,0.0,0,9120,0,2151,412,0,11683,6969,0.08382677513567144,383665,215082,
2465,0.0,27,241,2224,2733,35836,42909,634583,0.03831224672260137,168583,1842,0.051400194328452505,19386,0,0,0,0,64137,0.01838378618992083,23523,0,0,0,0.0,0,9120,0,2151,412,0,11683,6969,0.08382677513567144,383665,215082,
2465,0.0,27,241,2224,2733,35836,42909,634583,0.03831224672260137,168583,1842,0.051400194328452505,19386,0,0,0,0,64137,0.01838378618992083,23523,0,0,0,0.0,0,9120,0,2151,412,0,11683,6969,0.08382677513567144,383665,215082,
2465,0.0,27,241,2224,2733,35836,42909,634583,0.03831224672260137,168583,1842,0.051400194328452505,19386,0,0,0,0,64137,0.01838378618992083,23523,0,0,0,0.0,0,9120,0,2151,412,0,11683,6969,0.08382677513567144,383665,215082,
2465,0.0,27,241,2224,2733,35836,42909,634583,0.03831224672260137,168583,1842,0.051400194328452505,19386,0,0,0,0,64137,0.01838378618992083,23523,0,0,0,0.0,0,9120,0,2151,412,0,11683,6969,0.08382677513567144,383665,215082,
2465,0.0,27,241,2224,2733,35836,42909,634583,0.03831224672260137,168583,1842,0.051400194328452505,19386,0,0,0,0,64137,0.01838378618992083,23523,0,0,0,0.0,0,9120,0,2151,412,0,11683,6969,0.08382677513567144,383665,215082,
2465,0.0,27,241,2224,2733,35836,42909,634583,0.03831224672260137,168583,1842,0.051400194328452505,19386,0,0,0,0,64137,0.01838378618992083,23523,0,0,0,0.0,0,9120,0,2151,412,0,11683,6969,0.08382677513567144,383665,215082,
2465,0.0,27,241,2224,2733,35836,42909,634583,0.03831224672260137,168583,1842,0.051400194328452505,19386,0,0,0,0,64137,0.01838378618992083,23523,0,0,0,0.0,0,9120,0,2151,412,0,11683,6969,0.08382677513567144,383665,215082,
2465,0.0,27,241,2224,2733,35836,42909,634583,0.03831224672260137,168583,1842,0.051400194328452505,19386,0,0,0,0,64137,0.01838378618992083,23523,0,0,0,0.0,0,9120,0,2151,412,0,11683,6969,0.08382677513567144,383665,215082,
2465,0.0,27,241,2224,2733,35836,42909,634583,0.03831224672260137,168583,1842,0.051400194328452505,19386,0,0,0,0,64137,0.01838378618992083,23523,0,0,0,0.0,0,9120,0,2151,412,0,11683,6969,0.08382677513567144,383665,215082,
2465,0.0,27,241,2224,2733,35836,42909,634583,0.03831224672260137,168583,1842,0.051400194328452505,19386,0,0,0,0,64137,0.01838378618992083,23523,0,0,0,0.0,0,9120,0,2151,412,0,11683,6969,0.08382677513567144,383665,215082,
2465,0.0,27,241,2224,2733,35836,42909,634583,0.03831224672260137,168583,1842,0.051400194328452505,19386,0,0,0,0,64137,0.01838378618992083,23523,0,0,0,0.0,0,9120,0,2151,412,0,11683,6969,0.08382677513567144,383665,215082,
2465,0.0,27,241,2224,2733,35836,42909,634583,0.03831224672260137,168583,1842,0.051400194328452505,19386,0,0,0,0,64137,0.01838378618992083,23523,0,0,0,0.0,0,9120,0,2151,412,0,11683,6969,0.08382677513567144,383665,215082,
2465,0.0,27,241,2224,2733,35836,42909,634583,0.03831224672260137,168583,1842,0.051400194328452505,19386,0,0,0,0,64137,0.01838378618992083,23523,0,0,0,0.0,0,9120,0,2151,412,0,11683,6969,0.08382677513567144,383665,215082,
2465,0.0,27,241,2224,2733,35836,42909,634583,0.03831224672260137,168583,1842,0.051400194328452505,19386,0,0,0,0,64137,0.01838378618992083,23523,0,0,0,0.0,0,9120,0,2151,412,0,11683,6969,0.08382677513567144,383665,215082,
2465,0.0,27,241,2224,2733,35836,42909,634583,0.03831224672260137,168583,1842,0.051400194328452505,19386,0,0,0,0,64137,0.01838378618992083,23523,0,0,0,0.0,0,9120,0,2151,412,0,11683,6969,0.08382677513567144,383665,215082,
2465,0.0,27,241,2224,2733,35836,42909,634583,0.03831224672260137,168583,1842,0.051400194328452505,19386,0,0,0,0,64137,0.01838378618992083,23523,0,0,0,0.0,0,9120,0,2151,412,0,11683,6969,0.08382677513567144,383665,215082,
2465,0.0,27,241,2224,2733,35836,42909,634583,0.03831224672260137,168583,1842,0.051400194328452505,19386,0,0,0,0,64137,0.01838378618992083,23523,0,0,0,0.0,0,9120,0,2151,412,0,11683,6969,0.08382677513567144,383665,215082,
2465,0.0,27,241,2224,2733,35836,42909,634583,0.03831224672260137,168583,1842,0.051400194328452505,19386,0,0,0,0,64137,0.01838378618992083,23523,0,0,0,0.0,0,9120,0,2151,412,0,11683,6969,0.08382677513567144,383665,215082,
2465,0.0,27,241,2224,2733,35836,42909,634583,0.03831224672260137,168583,1842,0.051400194328452505,19386,0,0,0,0,64137,0.01838378618992083,23523,0,0,0,0.0,0,9120,0,2151,412,0,11683,6969,0.08382677513567144,383665,215082,
2465,0.0,27,241,2224,2733,35836,42909,634583,0.03831224672260137,168583,1842,0.051400194328452505,19386,0,0,0,0,64137,0.01838378618992083,23523,0,0,0,0.0,0,9120,0,2151,412,0,11683,6969,0.08382677513567144,383665,215082,
2465,0.0,27,241,2224,2733,35836,42909,634583,0.03831224672260137,168583,1842,0.051400194328452505,19386,0,0,0,0,64137,0.01838378618992083,23523,0,0,0,0.0,0,9120,0,2151,412,0,11683,6969,0.08382677513567144,383665,215082,
2465,0.0,27,241,2224,2733,35836,42909,634583,0.03831224672260137,168583,1842,0.051400194328452505,19386,0,0,0,0,64137,0.01838378618992083,23523,0,0,0,0.0,0,9120,0,2151,412,0,11683,6969,0.08382677513567144,383665,215082,
2465,0.0,27,241,2224,2733,35836,42909,634583,0.03831224672260137,168583,1842,0.051400194328452505,19386,0,0,0,0,64137,0.01838378618992083,23523,0,0,0,0.0,0,9120,0,2151,412,0,11683,6969,0.08382677513567144,383665,215082,
2465,0.0,27,241,2224,2733,35836,42909,634583,0.03831224672260137,168583,1842,0.051400194328452505,19386,0,0,0,0,64137,0.01838378618992083,23523,0,0,0,0.0,0,9120,0,2151,412,0,11683,6969,0.08382677513567144,383665,215082,
2465,0.0,27,241,2224,2733,35836,42909,634583,0.03831224672260137,168583,1842,0.051400194328452505,19386,0,0,0,0,64137,0.01838378618992083,23523,0,0,0,0.0,0,9120,0,2151,412,0,11683,6969,0.08382677513567144,383665,215082,
2465,0.0,27,241,2224,2733,35836,42909,634583,0.03831224672260137,168583,1842,0.051400194328452505,19386,0,0,0,0,64137,0.01838378618992083,23523,0,0,0,0.0,0,9120,0,2151,412,0,11683,6969,0.08382677513567144,383665,215082,
2465,0.0,27,241,2224,2733,35836,42909,634583,0.03831224672260137,168583,1842,0.051400194328452505,19386,0,0,0,0,64137,0.01838378618992083,23523,0,0,0,0.0,0,9120,0,2151,412,0,11683,6969,0.08382677513567144,383665,215082,
2465,0.0,27,241,2224,2733,35836,42909,634583,0.03831224672260137,168583,1842,0.051400194328452505,19386,0,0,0,0,64137,0.01838378618992083,23523,0,0,0,0.0,0,9120,0,2151,412,0,11683,6969,0.08382677513567144,383665,215082,
2465,0.0,27,241,2224,2733,35836,42909,634583,0.03831224672260137,168583,1842,0.051400194328452505,19386,0,0,0,0,64137,0.01838378618992083,23523,0,0,0,0.0,0,9120,0,2151,412,0,11683,6969,0.08382677513567144,383665,215082,
2465,0.0,27,241,2224,2733,35836,42909,634583,0.03831224672260137,168583,1842,0.051400194328452505,19386,0,0,0,0,64137,0.01838378618992083,23523,0,0,0,0.0,0,9120,0,2151,412,0,11683,6969,0.08382677513567144,383665,215082,
2465,0.0,27,241,2224,2733,35836,42909,634583,0.03831224672260137,168583,1842,0.051400194328452505,19386,0,0,0,0,64137,0.01838378618992083,23523,0,0,0,0.0,0,9120,0,2151,412,0,11683,6969,0.08382677513567144,383665,215082,
2465,0.0,27,241,2224,2733,35836,42909,634583,0.03831224672260137,168583,1842,0.051400194328452505,19386,0,0,0,0,64137,0.01838378618992083,23523,0,0,0,0.0,0,9120,0,2151,412,0,11683,6969,0.08382677513567144,383665,215082,
2465,0.0,27,241,2224,2733,35836,42909,634583,0.03831224672260137,168583,1842,0.051400194328452505,19386,0,0,0,0,64137,0.01838378618992083,23523,0,0,0,0.0,0,9120,0,2151,412,0,11683,6969,0.08382677513567144,383665,215082,
2465,0.0,27,241,2224,2733,35836,42909,634583,0.03831224672260137,168583,1842,0.051400194328452505,19386,0,0,0,0,64137,0.01838378618992083,23523,0,0,0,0.0,0,9120,0,2151,412,0,11683,6969,0.08382677513567144,383665,215082,
2465,0.0,27,241,2224,2733,35836,42909,634583,0.03831224672260137,168583,1842,0.051400194328452505,19386,0,0,0,0,64137,0.01838378618992083,23523,0,0,0,0.0,0,9120,0,2151,412,0,11683,6969,0.08382677513567144,383665,215082,
2465,0.0,27,241,2224,2733,35836,42909,634583,0.03831224672260137,168583,1842,0.051400194328452505,19386,0,0,0,0,64137,0.01838378618992083,23523,0,0,0,0.0,0,9120,0,2151,412,0,11683,6969,0.08382677513567144,383665,215082,
2465,0.0,27,241,2224,2733,35836,42909,634583,0.03831224672260137,168583,1842,0.051400194328452505,19386,0,0,0,0,64137,0.01838378618992083,23523,0,0,0,0.0,0,9120,0,2151,412,0,11683,6969,0.08382677513567144,383665,215082,
2465,0.0,27,241,2224,2733,35836,42909,634583,0.03831224672260137,168583,1842,0.051400194328452505,19386,0,0,0,0,64137,0.01838378618992083,23523,0,0,0,0.0,0,9120,0,2151,412,0,11683,6969,0.08382677513567144,383665,215082,
2465,0.0,27,241,2224,2733,35836,42909,634583,0.03831224672260137,168583,1842,0.051400194328452505,19386,0,0,0,0,64137,0.01838378618992083,23523,0,0,0,0.0,0,9120,0,2151,412,0,11683,6969,0.08382677513567144,383665,215082,
2465,0.0,27,241,2224,2733,35836,42909,634583,0.03831224672260137,168583,1842,0.051400194328452505,19386,0,0,0,0,64137,0.01838378618992083,23523,0,0,0,0.0,0,9120,0,2151,412,0,11683,6969,0.08382677513567144,383665,215082,
2465,0.0,27,241,2224,2733,35836,42909,634583,0.03831224672260137,168583,1842,0.051400194328452505,19386,0,0,0,0,64137,0.01838378618992083,23523,0,0,0,0.0,0,9120,0,2151,412,0,11683,6969,0.08382677513567144,383665,215082,
2465,0.0,27,241,2224,2733,35836,42909,634583,0.03831224672260137,168583,1842,0.051400194328452505,19386,0,0,0,0,64137,0.01838378618992083,23523,0,0,0,0.0,0,9120,0,2151,412,0,11683,6969,0.08382677513567144,383665,215082,
2465,0.0,27,241,2224,2733,35836,42909,634583,0.03831224672260137,168583,1842,0.051400194328452505,19386,0,0,0,0,64137,0.01838378618992083,23523,0,0,0,0.0,0,9120,0,2151,412,0,11683,6969,0.08382677513567144,383665,215082,
2465,0.0,27,241,2224,2733,35836,42909,634583,0.03831224672260137,168583,1842,0.051400194328452505,19386,0,0,0,0,64137,0.01838378618992083,23523,0,0,0,0.0,0,9120,0,2151,412,0,11683,6969,0.08382677513567144,383665,215082,
2465,0.0,27,241,2224,2733,35836,42909,634583,0.03831224672260137,168583,1842,0.051400194328452505,19386,0,0,0,0,64137,0.01838378618992083,23523,0,0,0,0.0,0,9120,0,2151,412,0,11683,6969,0.08382677513567144,383665,215082,
2465,0.0,27,241,2224,2733,35836,42909,634583,0.03831224672260137,168583,1842,0.051400194328452505,19386,0,0,0,0,64137,0.01838378618992083,23523,0,0,0,0.0,0,9120,0,2151,412,0,11683,6969,0.08382677513567144,383665,215082,
2465,0.0,27,241,2224,2733,35836,42909,634583,0.03831224672260137,168583,1842,0.051400194328452505,19386,0,0,0,0,64137,0.01838378618992083,23523,0,0,0,0.0,0,9120,0,2151,412,0,11683,6969,0.08382677513567144,383665,215082,
2465,0.0,27,241,2224,2733,35836,42909,634583,0.03831224672260137,168583,1842,0.051400194328452505,19386,0,0,0,0,64137,0.01838378618992083,23523,0,0,0,0.0,0,9120,0,2151,412,0,11683,6969,0.08382677513567144,383665,215082,
2465,0.0,27,241,2224,2733,35836,42909,634583,0.03831224672260137,168583,1842,0.051400194328452505,19386,0,0,0,0,64137,0.01838378618992083,23523,0,0,0,0.0,0,9120,0,2151,412,0,11683,6969,0.08382677513567144,383665,215082,
2465,0.0,27,241,2224,2733,35836,42909,634583,0.03831224672260137,168583,1842,0.051400194328452505,19386,0,0,0,0,64137,0.01838378618992083,23523,0,0,0,0.0,0,9120,0,2151,412,0,11683,6969,0.08382677513567144,383665,215082,
2465,0.0,27,241,2224,2733,35836,42909,634583,0.03831224672260137,168583,1842,0.051400194328452505,19386,0,0,0,0,64137,0.01838378618992083,23523,0,0,0,0.0,0,9120,0,2151,412,0,11683,6969,0.08382677513567144,383665,215082,
2465,0.0,27,241,2224,2733,35836,42909,634583,0.03831224672260137,168583,1842,0.051400194328452505,19386,0,0,0,0,64137,0.01838378618992083,23523,0,0,0,0.0,0,9120,0,2151,412,0,11683,6969,0.08382677513567144,383665,215082,
2465,0.0,27,241,2224,2733,35836,42909,634583,0.03831224672260137,168583,1842,0.051400194328452505,19386,0,0,0,0,64137,0.01838378618992083,23523,0,0,0,0.0,0,9120,0,2151,412,0,11683,6969,0.08382677513567144,383665,215082,
2465,0.0,27,241,2224,2733,35836,42909,634583,0.03831224672260137,168583,1842,0.051400194328452505,19386,0,0,0,0,64137,0.01838378618992083,23523,0,0,0,0.0,0,9120,0,2151,412,0,11683,6969,0.08382677513567144,383665,215082,
2465,0.0,27,241,2224,2733,35836,42909,634583,0.03831224672260137,168583,1842,0.051400194328452505,19386,0,0,0,0,64137,0.01838378618992083,23523,0,0,0,0.0,0,9120,0,2151,412,0,11683,6969,0.08382677513567144,383665,215082,
2465,0.0,27,241,2224,2733,35836,42909,634583,0.03831224672260137,168583,1842,0.051400194328452505,19386,0,0,0,0,64137,0.01838378618992083,23523,0,0,0,0.0,0,9120,0,2151,412,0,11683,6969,0.08382677513567144,383665,215082,
2465,0.0,27,241,2224,2733,35836,42909,634583,0.03831224672260137,168583,1842,0.051400194328452505,19386,0,0,0,0,64137,0.01838378618992083,23523,0,0,0,0.0,0,9120,0,2151,412,0,11683,6969,0.08382677513567144,383665,215082,
2465,0.0,27,241,2224,2733,35836,42909,634583,0.03831224672260137,168583,1842,0.051400194328452505,19386,0,0,0,0,64137,0.01838378618992083,23523,0,0,0,0.0,0,9120,0,2151,412,0,11683,6969,0.08382677513567144,383665,215082,
2465,0.0,27,241,2224,2733,35836,42909,634583,0.03831224672260137,168583,1842,0.051400194328452505,19386,0,0,0,0,64137,0.01838378618992083,23523,0,0,0,0.0,0,9120,0,2151,412,0,11683,6969,0.08382677513567144,383665,215082,
2465,0.0,27,241,2224,2733,35836,42909,634583,0.03831224672260137,168583,1842,0.051400194328452505,19386,0,0,0,0,64137,0.01838378618992083,23523,0,0,0,0.0,0,9120,0,2151,412,0,11683,6969,0.08382677513567144,383665,215082,
2465,0.0,27,241,2224,2733,35836,42909,634583,0.03831224672260137,168583,1842,0.051400194328452505,19386,0,0,0,0,64137,0.01838378618992083,23523,0,0,0,0.0,0,9120,0,2151,412,0,11683,6969,0.08382677513567144,383665,215082,
2465,0.0,27,241,2224,2733,35836,42909,634583,0.03831224672260137,168583,1842,0.051400194328452505,19386,0,0,0,0,64137,0.01838378618992083,23523,0,0,0,0.0,0,9120,0,2151,412,0,11683,6969,0.08382677513567144,383665,215082,
2465,0.0,27,241,2224,2733,35836,42909,634583,0.03831224672260137,168583,1842,0.051400194328452505,19386,0,0,0,0,64137,0.01838378618992083,23523,0,0,0,0.0,0,9120,0,2151,412,0,11683,6969,0.08382677513567144,383665,215082,
2465,0.0,27,241,2224,2733,35836,42909,634583,0.03831224672260137,168583,1842,0.051400194328452505,19386,0,0,0,0,64137,0.01838378618992083,23523,0,0,0,0.0,0,9120,0,2151,412,0,11683,6969,0.08382677513567144,383665,215082,
2465,0.0,27,241,2224,2733,35836,42909,634583,0.03831224672260137,168583,1842,0.051400194328452505,19386,0,0,0,0,64137,0.01838378618992083,23523,0,0,0,0.0,0,9120,0,2151,412,0,11683,6969,0.08382677513567144,383665,215082,
2465,0.0,27,241,2224,2733,35836,42909,634583,0.03831224672260137,168583,1842,0.051400194328452505,19386,0,0,0,0,64137,0.01838378618992083,23523,0,0,0,0.0,0,9120,0,2151,412,0,11683,6969,0.08382677513567144,383665,215082,
2465,0.0,27,241,2224,2733,35836,42909,634583,0.03831224672260137,168583,1842,0.051400194328452505,19386,0,0,0,0,64137,0.01838378618992083,23523,0,0,0,0.0,0,9120,0,2151,412,0,11683,6969,0.08382677513567144,383665,215082,
2465,0.0,27,241,2224,2733,35836,42909,634583,0.03831224672260137,168583,1842,0.051400194328452505,19386,0,0,0,0,64137,0.01838378618992083,23523,0,0,0,0.0,0,9120,0,2151,412,0,11683,6969,0.08382677513567144,383665,215082,
2465,0.0,27,241,2224,2733,35836,42909,634583,0.03831224672260137,168583,1842,0.051400194328452505,19386,0,0,0,0,64137,0.01838378618992083,23523,0,0,0,0.0,0,9120,0,2151,412,0,11683,6969,0.08382677513567144,383665,215082,
2465,0.0,27,241,2224,2733,35836,42909,634583,0.03831224672260137,168583,1842,0.051400194328452505,19386,0,0,0,0,64137,0.01838378618992083,23523,0,0,0,0.0,0,9120,0,2151,412,0,11683,6969,0.08382677513567144,383665,215082,
2465,0.0,27,241,2224,2733,35836,42909,634583,0.03831224672260137,168583,1842,0.051400194328452505,19386,0,0,0,0,64137,0.01838378618992083,23523,0,0,0,0.0,0,9120,0,2151,412,0,11683,6969,0.08382677513567144,383665,215082,
2465,0.0,27,241,2224,2733,35836,42909,634583,0.03831224672260137,168583,1842,0.051400194328452505,19386,0,0,0,0,64137,0.01838378618992083,23523,0,0,0,0.0,0,9120,0,2151,412,0,11683,6969,0.08382677513567144,383665,215082,
2465,0.0,27,241,2224,2733,35836,42909,634583,0.03831224672260137,168583,1842,0.051400194328452505,19386,0,0,0,0,64137,0.01838378618992083,23523,0,0,0,0.0,0,9120,0,2151,412,0,11683,6969,0.08382677513567144,383665,215082,
2465,0.0,27,241,2224,2733,35836,42909,634583,0.03831224672260137,168583,1842,0.051400194328452505,19386,0,0,0,0,64137,0.01838378618992083,23523,0,0,0,0.0,0,9120,0,2151,412,0,11683,6969,0.08382677513567144,383665,215082,
2465,0.0,27,241,2224,2733,35836,42909,634583,0.03831224672260137,168583,1842,0.051400194328452505,19386,0,0,0,0,64137,0.01838378618992083,23523,0,0,0,0.0,0,9120,0,2151,412,0,11683,6969,0.08382677513567144,383665,215082,
2465,0.0,27,241,2224,2733,35836,42909,634583,0.03831224672260137,168583,1842,0.051400194328452505,19386,0,0,0,0,64137,0.01838378618992083,23523,0,0,0,0.0,0,9120,0,2151,412,0,11683,6969,0.08382677513567144,383665,215082,
2465,0.0,27,241,2224,2733,35836,42909,634583,0.03831224672260137,168583,1842,0.051400194328452505,19386,0,0,0,0,64137,0.01838378618992083,23523,0,0,0,0.0,0,9120,0,2151,412,0,11683,6969,0.08382677513567144,383665,215082,
2465,0.0,27,241,2224,2733,35836,42909,634583,0.03831224672260137,168583,1842,0.051400194328452505,19386,0,0,0,0,64137,0.01838378618992083,23523,0,0,0,0.0,0,9120,0,2151,412,0,11683,6969,0.08382677513567144,383665,215082,
2465,0.0,27,241,2224,2733,35836,42909,634583,0.03831224672260137,168583,1842,0.051400194328452505,19386,0,0,0,0,64137,0.01838378618992083,23523,0,0,0,0.0,0,9120,0,2151,412,0,11683,6969,0.08382677513567144,383665,215082,
2465,0.0,27,241,2224,2733,35836,42909,634583,0.03831224672260137,168583,1842,0.051400194328452505,19386,0,0,0,0,64137,0.01838378618992083,23523,0,0,0,0.0,0,9120,0,2151,412,0,11683,6969,0.08382677513567144,383665,215082,
2465,0.0,27,241,2224,2733,35836,42909,634583,0.03831224672260137,168583,1842,0.051400194328452505,19386,0,0,0,0,64137,0.01838378618992083,23523,0,0,0,0.0,0,9120,0,2151,412,0,11683,6969,0.08382677513567144,383665,215082,
2465,0.0,27,241,2224,2733,35836,42909,634583,0.03831224672260137,168583,1842,0.051400194328452505,19386,0,0,0,0,64137,0.01838378618992083,23523,0,0,0,0.0,0,9120,0,2151,412,0,11683,6969,0.08382677513567144,383665,215082,
2465,0.0,27,241,2224,2733,35836,42909,634583,0.03831224672260137,168583,1842,0.051400194328452505,19386,0,0,0,0,64137,0.01838378618992083,23523,0,0,0,0.0,0,9120,0,2151,412,0,11683,6969,0.08382677513567144,383665,215082,
2465,0.0,27,241,2224,2733,35836,42909,634583,0.03831224672260137,168583,1842,0.051400194328452505,19386,0,0,0,0,64137,0.01838378618992083,23523,0,0,0,0.0,0,9120,0,2151,412,0,11683,6969,0.08382677513567144,383665,215082,
2465,0.0,27,241,2224,2733,35836,42909,634583,0.03831224672260137,168583,1842,0.051400194328452505,19386,0,0,0,0,64137,0.01838378618992083,23523,0,0,0,0.0,0,9120,0,2151,412,0,11683,6969,0.08382677513567144,383665,215082,
2465,0.0,27,241,2224,2733,35836,42909,634583,0.03831224672260137,168583,1842,0.051400194328452505,19386,0,0,0,0,64137,0.01838378618992083,23523,0,0,0,0.0,0,9120,0,2151,412,0,11683,6969,0.08382677513567144,383665,215082,
2465,0.0,27,241,2224,2733,35836,42909,634583,0.03831224672260137,168583,1842,0.051400194328452505,19386,0,0,0,0,64137,0.01838378618992083,23523,0,0,0,0.0,0,9120,0,2151,412,0,11683,6969,0.08382677513567144,383665,215082,
2465,0.0,27,241,2224,2733,35836,42909,634583,0.03831224672260137,168583,1842,0.051400194328452505,19386,0,0,0,0,64137,0.01838378618992083,23523,0,0,0,0.0,0,9120,0,2151,412,0,11683,6969,0.08382677513567144,383665,215082,
2465,0.0,27,241,2224,2733,35836,42909,634583,0.03831224672260137,168583,1842,0.051400194328452505,19386,0,0,0,0,64137,0.01838378618992083,23523,0,0,0,0.0,0,9120,0,2151,412,0,11683,6969,0.08382677513567144,383665,215082,
2465,0.0,27,241,2224,2733,35836,42909,634583,0.03831224672260137,168583,1842,0.051400194328452505,19386,0,0,0,0,64137,0.01838378618992083,23523,0,0,0,0.0,0,9120,0,2151,412,0,11683,6969,0.08382677513567144,383665,215082,
2465,0.0,27,241,2224,2733,35836,42909,634583,0.03831224672260137,168583,1842,0.051400194328452505,19386,0,0,0,0,64137,0.01838378618992083,23523,0,0,0,0.0,0,9120,0,2151,412,0,11683,6969,0.08382677513567144,383665,215082,
2465,0.0,27,241,2224,2733,35836,42909,634583,0.03831224672260137,168583,1842,0.051400194328452505,19386,0,0,0,0,64137,0.01838378618992083,23523,0,0,0,0.0,0,9120,0,2151,412,0,11683,6969,0.08382677513567144,383665,215082,
2465,0.0,27,241,2224,2733,35836,42909,634583,0.03831224672260137,168583,1842,0.051400194328452505,19386,0,0,0,0,64137,0.01838378618992083,23523,0,0,0,0.0,0,9120,0,2151,412,0,11683,6969,0.08382677513567144,383665,215082,
2465,0.0,27,241,2224,2733,35836,42909,634583,0.03831224672260137,168583,1842,0.051400194328452505,19386,0,0,0,0,64137,0.01838378618992083,23523,0,0,0,0.0,0,9120,0,2151,412,0,11683,6969,0.08382677513567144,383665,215082,
2465,0.0,27,241,2224,2733,35836,42909,634583,0.03831224672260137,168583,1842,0.051400194328452505,19386,0,0,0,0,64137,0.01838378618992083,23523,0,0,0,0.0,0,9120,0,2151,412,0,11683,6969,0.08382677513567144,383665,215082,
2465,0.0,27,241,2224,2733,35836,42909,634583,0.03831224672260137,168583,1842,0.051400194328452505,19386,0,0,0,0,64137,0.01838378618992083,23523,0,0,0,0.0,0,9120,0,2151,412,0,11683,6969,0.08382677513567144,383665,215082,
2465,0.0,27,241,2224,2733,35836,42909,634583,0.03831224672260137,168583,1842,0.051400194328452505,19386,0,0,0,0,64137,0.01838378618992083,23523,0,0,0,0.0,0,9120,0,2151,412,0,11683,6969,0.08382677513567144,383665,215082,
2465,0.0,27,241,2224,2733,35836,42909,634583,0.03831224672260137,168583,1842,0.051400194328452505,19386,0,0,0,0,64137,0.01838378618992083,23523,0,0,0,0.0,0,9120,0,2151,412,0,11683,6969,0.08382677513567144,383665,215082,
2465,0.0,27,241,2224,2733,35836,42909,634583,0.03831224672260137,168583,1842,0.051400194328452505,19386,0,0,0,0,64137,0.01838378618992083,23523,0,0,0,0.0,0,9120,0,2151,412,0,11683,6969,0.08382677513567144,383665,215082,
2465,0.0,27,241,2224,2733,35836,42909,634583,0.03831224672260137,168583,1842,0.051400194328452505,19386,0,0,0,0,64137,0.01838378618992083,23523,0,0,0,0.0,0,9120,0,2151,412,0,11683,6969,0.08382677513567144,383665,215082,
2465,0.0,27,241,2224,2733,35836,42909,634583,0.03831224672260137,168583,1842,0.051400194328452505,19386,0,0,0,0,64137,0.01838378618992083,23523,0,0,0,0.0,0,9120,0,2151,412,0,11683,6969,0.08382677513567144,383665,215082,
2465,0.0,27,241,2224,2733,35836,42909,634583,0.03831224672260137,168583,1842,0.051400194328452505,19386,0,0,0,0,64137,0.01838378618992083,23523,0,0,0,0.0,0,9120,0,2151,412,0,11683,6969,0.08382677513567144,383665,215082,
2465,0.0,27,241,2224,2733,35836,42909,634583,0.03831224672260137,168583,1842,0.051400194328452505,19386,0,0,0,0,64137,0.01838378618992083,23523,0,0,0,0.0,0,9120,0,2151,412,0,11683,6969,0.08382677513567144,383665,215082,
2465,0.0,27,241,2224,2733,35836,42909,634583,0.03831224672260137,168583,1842,0.051400194328452505,19386,0,0,0,0,64137,0.01838378618992083,23523,0,0,0,0.0,0,9120,0,2151,412,0,11683,6969,0.08382677513567144,383665,215082,
2465,0.0,27,241,2224,2733,35836,42909,634583,0.03831224672260137,168583,1842,0.051400194328452505,19386,0,0,0,0,64137,0.01838378618992083,23523,0,0,0,0.0,0,9120,0,2151,412,0,11683,6969,0.08382677513567144,383665,215082,
2465,0.0,27,241,2224,2733,35836,42909,634583,0.03831224672260137,168583,1842,0.051400194328452505,19386,0,0,0,0,64137,0.01838378618992083,23523,0,0,0,0.0,0,9120,0,2151,412,0,11683,6969,0.08382677513567144,383665,215082,
2465,0.0,27,241,2224,2733,35836,42909,634583,0.03831224672260137,168583,1842,0.051400194328452505,19386,0,0,0,0,64137,0.01838378618992083,23523,0,0,0,0.0,0,9120,0,2151,412,0,11683,6969,0.08382677513567144,383665,215082,
2465,0.0,27,241,2224,2733,35836,42909,634583,0.03831224672260137,168583,1842,0.051400194328452505,19386,0,0,0,0,64137,0.01838378618992083,23523,0,0,0,0.0,0,9120,0,2151,412,0,11683,6969,0.08382677513567144,383665,215082,
2465,0.0,27,241,2224,2733,35836,42909,634583,0.03831224672260137,168583,1842,0.051400194328452505,19386,0,0,0,0,64137,0.01838378618992083,23523,0,0,0,0.0,0,9120,0,2151,412,0,11683,6969,0.08382677513567144,383665,215082,
2465,0.0,27,241,2224,2733,35836,42909,634583,0.03831224672260137,168583,1842,0.051400194328452505,19386,0,0,0,0,64137,0.01838378618992083,23523,0,0,0,0.0,0,9120,0,2151,412,0,11683,6969,0.08382677513567144,383665,215082,
2465,0.0,27,241,2224,2733,35836,42909,634583,0.03831224672260137,168583,1842,0.051400194328452505,19386,0,0,0,0,64137,0.01838378618992083,23523,0,0,0,0.0,0,9120,0,2151,412,0,11683,6969,0.08382677513567144,383665,215082,
2465,0.0,27,241,2224,2733,35836,42909,634583,0.03831224672260137,168583,1842,0.051400194328452505,19386,0,0,0,0,64137,0.01838378618992083,23523,0,0,0,0.0,0,9120,0,2151,412,0,11683,6969,0.08382677513567144,383665,215082,
2465,0.0,27,241,2224,2733,35836,42909,634583,0.03831224672260137,168583,1842,0.051400194328452505,19386,0,0,0,0,64137,0.01838378618992083,23523,0,0,0,0.0,0,9120,0,2151,412,0,11683,6969,0.08382677513567144,383665,215082,
2465,0.0,27,241,2224,2733,35836,42909,634583,0.03831224672260137,168583,1842,0.051400194328452505,19386,0,0,0,0,64137,0.01838378618992083,23523,0,0,0,0.0,0,9120,0,2151,412,0,11683,6969,0.08382677513567144,383665,215082,
2465,0.0,27,241,2224,2733,35836,42909,634583,0.03831224672260137,168583,1842,0.051400194328452505,19386,0,0,0,0,64137,0.01838378618992083,23523,0,0,0,0.0,0,9120,0,2151,412,0,11683,6969,0.08382677513567144,383665,215082,
2465,0.0,27,241,2224,2733,35836,42909,634583,0.03831224672260137,168583,1842,0.051400194328452505,19386,0,0,0,0,64137,0.01838378618992083,23523,0,0,0,0.0,0,9120,0,2151,412,0,11683,6969,0.08382677513567144,383665,215082,
2465,0.0,27,241,2224,2733,35836,42909,634583,0.03831224672260137,168583,1842,0.051400194328452505,19386,0,0,0,0,64137,0.01838378618992083,23523,0,0,0,0.0,0,9120,0,2151,412,0,11683,6969,0.08382677513567144,383665,215082,
2465,0.0,27,241,2224,2733,35836,42909,634583,0.03831224672260137,168583,1842,0.051400194328452505,19386,0,0,0,0,64137,0.01838378618992083,23523,0,0,0,0.0,0,9120,0,2151,412,0,11683,6969,0.08382677513567144,383665,215082,
2465,0.0,27,241,2224,2733,35836,42909,634583,0.03831224672260137,168583,1842,0.051400194328452505,19386,0,0,0,0,64137,0.01838378618992083,23523,0,0,0,0.0,0,9120,0,2151,412,0,11683,6969,0.08382677513567144,383665,215082,
2465,0.0,27,241,2224,2733,35836,42909,634583,0.03831224672260137,168583,1842,0.051400194328452505,19386,0,0,0,0,64137,0.01838378618992083,23523,0,0,0,0.0,0,9120,0,2151,412,0,11683,6969,0.08382677513567144,383665,215082,
2465,0.0,27,241,2224,2733,35836,42909,634583,0.03831224672260137,168583,1842,0.051400194328452505,19386,0,0,0,0,64137,0.01838378618992083,23523,0,0,0,0.0,0,9120,0,2151,412,0,11683,6969,0.08382677513567144,383665,215082,
2465,0.0,27,241,2224,2733,35836,42909,634583,0.03831224672260137,168583,1842,0.051400194328452505,19386,0,0,0,0,64137,0.01838378618992083,23523,0,0,0,0.0,0,9120,0,2151,412,0,11683,6969,0.08382677513567144,383665,215082,
2465,0.0,27,241,2224,2733,35836,42909,634583,0.03831224672260137,168583,1842,0.051400194328452505,19386,0,0,0,0,64137,0.01838378618992083,23523,0,0,0,0.0,0,9120,0,2151,412,0,11683,6969,0.08382677513567144,383665,215082,
2465,0.0,27,241,2224,2733,35836,42909,634583,0.03831224672260137,168583,1842,0.051400194328452505,19386,0,0,0,0,64137,0.01838378618992083,23523,0,0,0,0.0,0,9120,0,2151,412,0,11683,6969,0.08382677513567144,383665,215082,
2465,0.0,27,241,2224,2733,35836,42909,634583,0.03831224672260137,168583,1842,0.051400194328452505,19386,0,0,0,0,64137,0.01838378618992083,23523,0,0,0,0.0,0,9120,0,2151,412,0,11683,6969,0.08382677513567144,383665,215082,
2465,0.0,27,241,2224,2733,35836,42909,634583,0.03831224672260137,168583,1842,0.051400194328452505,19386,0,0,0,0,64137,0.01838378618992083,23523,0,0,0,0.0,0,9120,0,2151,412,0,11683,6969,0.08382677513567144,383665,215082,
2465,0.0,27,241,2224,2733,35836,42909,634583,0.03831224672260137,168583,1842,0.051400194328452505,19386,0,0,0,0,64137,0.01838378618992083,23523,0,0,0,0.0,0,9120,0,2151,412,0,11683,6969,0.08382677513567144,383665,215082,
2465,0.0,27,241,2224,2733,35836,42909,634583,0.03831224672260137,168583,1842,0.051400194328452505,19386,0,0,0,0,64137,0.01838378618992083,23523,0,0,0,0.0,0,9120,0,2151,412,0,11683,6969,0.08382677513567144,383665,215082,
2465,0.0,27,241,2224,2733,35836,42909,634583,0.03831224672260137,168583,1842,0.051400194328452505,19386,0,0,0,0,64137,0.01838378618992083,23523,0,0,0,0.0,0,9120,0,2151,412,0,11683,6969,0.08382677513567144,383665,215082,
2465,0.0,27,241,2224,2733,35836,42909,634583,0.03831224672260137,168583,1842,0.051400194328452505,19386,0,0,0,0,64137,0.01838378618992083,23523,0,0,0,0.0,0,9120,0,2151,412,0,11683,6969,0.08382677513567144,383665,215082,
2465,0.0,27,241,2224,2733,35836,42909,634583,0.03831224672260137,168583,1842,0.051400194328452505,19386,0,0,0,0,64137,0.01838378618992083,23523,0,0,0,0.0,0,9120,0,2151,412,0,11683,6969,0.08382677513567144,383665,215082,
2465,0.0,27,241,2224,2733,35836,42909,634583,0.03831224672260137,168583,1842,0.051400194328452505,19386,0,0,0,0,64137,0.01838378618992083,23523,0,0,0,0.0,0,9120,0,2151,412,0,11683,6969,0.08382677513567144,383665,215082,
2465,0.0,27,241,2224,2733,35836,42909,634583,0.03831224672260137,168583,1842,0.051400194328452505,19386,0,0,0,0,64137,0.01838378618992083,23523,0,0,0,0.0,0,9120,0,2151,412,0,11683,6969,0.08382677513567144,383665,215082,
2465,0.0,27,241,2224,2733,35836,42909,634583,0.03831224672260137,168583,1842,0.051400194328452505,19386,0,0,0,0,64137,0.01838378618992083,23523,0,0,0,0.0,0,9120,0,2151,412,0,11683,6969,0.08382677513567144,383665,215082,
2465,0.0,27,241,2224,2733,35836,42909,634583,0.03831224672260137,168583,1842,0.051400194328452505,19386,0,0,0,0,64137,0.01838378618992083,23523,0,0,0,0.0,0,9120,0,2151,412,0,11683,6969,0.08382677513567144,383665,215082,
2465,0.0,27,241,2224,2733,35836,42909,634583,0.03831224672260137,168583,1842,0.051400194328452505,19386,0,0,0,0,64137,0.01838378618992083,23523,0,0,0,0.0,0,9120,0,2151,412,0,11683,6969,0.08382677513567144,383665,215082,
2465,0.0,27,241,2224,2733,35836,42909,634583,0.03831224672260137,168583,1842,0.051400194328452505,19386,0,0,0,0,64137,0.01838378618992083,23523,0,0,0,0.0,0,9120,0,2151,412,0,11683,6969,0.08382677513567144,383665,215082,
2465,0.0,27,241,2224,2733,35836,42909,634583,0.03831224672260137,168583,1842,0.051400194328452505,19386,0,0,0,0,64137,0.01838378618992083,23523,0,0,0,0.0,0,9120,0,2151,412,0,11683,6969,0.08382677513567144,383665,215082,
2465,0.0,27,241,2224,2733,35836,42909,634583,0.03831224672260137,168583,1842,0.051400194328452505,19386,0,0,0,0,64137,0.01838378618992083,23523,0,0,0,0.0,0,9120,0,2151,412,0,11683,6969,0.08382677513567144,383665,215082,
2465,0.0,27,241,2224,2733,35836,42909,634583,0.03831224672260137,168583,1842,0.051400194328452505,19386,0,0,0,0,64137,0.01838378618992083,23523,0,0,0,0.0,0,9120,0,2151,412,0,11683,6969,0.08382677513567144,383665,215082,
2465,0.0,27,241,2224,2733,35836,42909,634583,0.03831224672260137,168583,1842,0.051400194328452505,19386,0,0,0,0,64137,0.01838378618992083,23523,0,0,0,0.0,0,9120,0,2151,412,0,11683,6969,0.08382677513567144,383665,215082,
2465,0.0,27,241,2224,2733,35836,42909,634583,0.03831224672260137,168583,1842,0.051400194328452505,19386,0,0,0,0,64137,0.01838378618992083,23523,0,0,0,0.0,0,9120,0,2151,412,0,11683,6969,0.08382677513567144,383665,215082,
2465,0.0,27,241,2224,2733,35836,42909,634583,0.03831224672260137,168583,1842,0.051400194328452505,19386,0,0,0,0,64137,0.01838378618992083,23523,0,0,0,0.0,0,9120,0,2151,412,0,11683,6969,0.08382677513567144,383665,215082,
2465,0.0,27,241,2224,2733,35836,42909,634583,0.03831224672260137,168583,1842,0.051400194328452505,19386,0,0,0,0,64137,0.01838378618992083,23523,0,0,0,0.0,0,9120,0,2151,412,0,11683,6969,0.08382677513567144,383665,215082,
2465,0.0,27,241,2224,2733,35836,42909,634583,0.03831224672260137,168583,1842,0.051400194328452505,19386,0,0,0,0,64137,0.01838378618992083,23523,0,0,0,0.0,0,9120,0,2151,412,0,11683,6969,0.08382677513567144,383665,215082,
2465,0.0,27,241,2224,2733,35836,42909,634583,0.03831224672260137,168583,1842,0.051400194328452505,19386,0,0,0,0,64137,0.01838378618992083,23523,0,0,0,0.0,0,9120,0,2151,412,0,11683,6969,0.08382677513567144,383665,215082,
2465,0.0,27,241,2224,2733,35836,42909,634583,0.03831224672260137,168583,1842,0.051400194328452505,19386,0,0,0,0,64137,0.01838378618992083,23523,0,0,0,0.0,0,9120,0,2151,412,0,11683,6969,0.08382677513567144,383665,215082,
2465,0.0,27,241,2224,2733,35836,42909,634583,0.03831224672260137,168583,1842,0.051400194328452505,19386,0,0,0,0,64137,0.01838378618992083,23523,0,0,0,0.0,0,9120,0,2151,412,0,11683,6969,0.08382677513567144,383665,215082,
2465,0.0,27,241,2224,2733,35836,42909,634583,0.03831224672260137,168583,1842,0.051400194328452505,19386,0,0,0,0,64137,0.01838378618992083,23523,0,0,0,0.0,0,9120,0,2151,412,0,11683,6969,0.08382677513567144,383665,215082,
2465,0.0,27,241,2224,2733,35836,42909,634583,0.03831224672260137,168583,1842,0.051400194328452505,19386,0,0,0,0,64137,0.01838378618992083,23523,0,0,0,0.0,0,9120,0,2151,412,0,11683,6969,0.08382677513567144,383665,215082,
2465,0.0,27,241,2224,2733,35836,42909,634583,0.03831224672260137,168583,1842,0.051400194328452505,19386,0,0,0,0,64137,0.01838378618992083,23523,0,0,0,0.0,0,9120,0,2151,412,0,11683,6969,0.08382677513567144,383665,215082,
2465,0.0,27,241,2224,2733,35836,42909,634583,0.03831224672260137,168583,1842,0.051400194328452505,19386,0,0,0,0,64137,0.01838378618992083,23523,0,0,0,0.0,0,9120,0,2151,412,0,11683,6969,0.08382677513567144,383665,215082,
2465,0.0,27,241,2224,2733,35836,42909,634583,0.03831224672260137,168583,1842,0.051400194328452505,19386,0,0,0,0,64137,0.01838378618992083,23523,0,0,0,0.0,0,9120,0,2151,412,0,11683,6969,0.08382677513567144,383665,215082,
2465,0.0,27,241,2224,2733,35836,42909,634583,0.03831224672260137,168583,1842,0.051400194328452505,19386,0,0,0,0,64137,0.01838378618992083,23523,0,0,0,0.0,0,9120,0,2151,412,0,11683,6969,0.08382677513567144,383665,215082,
2465,0.0,27,241,2224,2733,35836,42909,634583,0.03831224672260137,168583,1842,0.051400194328452505,19386,0,0,0,0,64137,0.01838378618992083,23523,0,0,0,0.0,0,9120,0,2151,412,0,11683,6969,0.08382677513567144,383665,215082,
2465,0.0,27,241,2224,2733,35836,42909,634583,0.03831224672260137,168583,1842,0.051400194328452505,19386,0,0,0,0,64137,0.01838378618992083,23523,0,0,0,0.0,0,9120,0,2151,412,0,11683,6969,0.08382677513567144,383665,215082,
2465,0.0,27,241,2224,2733,35836,42909,634583,0.03831224672260137,168583,1842,0.051400194328452505,19386,0,0,0,0,64137,0.01838378618992083,23523,0,0,0,0.0,0,9120,0,2151,412,0,11683,6969,0.08382677513567144,383665,215082,
2465,0.0,27,241,2224,2733,35836,42909,634583,0.03831224672260137,168583,1842,0.051400194328452505,19386,0,0,0,0,64137,0.01838378618992083,23523,0,0,0,0.0,0,9120,0,2151,412,0,11683,6969,0.08382677513567144,383665,215082,
2465,0.0,27,241,2224,2733,35836,42909,634583,0.03831224672260137,168583,1842,0.051400194328452505,19386,0,0,0,0,64137,0.01838378618992083,23523,0,0,0,0.0,0,9120,0,2151,412,0,11683,6969,0.08382677513567144,383665,215082,
2465,0.0,27,241,2224,2733,35836,42909,634583,0.03831224672260137,168583,1842,0.051400194328452505,19386,0,0,0,0,64137,0.01838378618992083,23523,0,0,0,0.0,0,9120,0,2151,412,0,11683,6969,0.08382677513567144,383665,215082,
2465,0.0,27,241,2224,2733,35836,42909,634583,0.03831224672260137,168583,1842,0.051400194328452505,19386,0,0,0,0,64137,0.01838378618992083,23523,0,0,0,0.0,0,9120,0,2151,412,0,11683,6969,0.08382677513567144,383665,215082,
2465,0.0,27,241,2224,2733,35836,42909,634583,0.03831224672260137,168583,1842,0.051400194328452505,19386,0,0,0,0,64137,0.01838378618992083,23523,0,0,0,0.0,0,9120,0,2151,412,0,11683,6969,0.08382677513567144,383665,215082,
2465,0.0,27,241,2224,2733,35836,42909,634583,0.03831224672260137,168583,1842,0.051400194328452505,19386,0,0,0,0,64137,0.01838378618992083,23523,0,0,0,0.0,0,9120,0,2151,412,0,11683,6969,0.08382677513567144,383665,215082,
2465,0.0,27,241,2224,2733,35836,42909,634583,0.03831224672260137,168583,1842,0.051400194328452505,19386,0,0,0,0,64137,0.01838378618992083,23523,0,0,0,0.0,0,9120,0,2151,412,0,11683,6969,0.08382677513567144,383665,215082,
2465,0.0,27,241,2224,2733,35836,42909,634583,0.03831224672260137,168583,1842,0.051400194328452505,19386,0,0,0,0,64137,0.01838378618992083,23523,0,0,0,0.0,0,9120,0,2151,412,0,11683,6969,0.08382677513567144,383665,215082,
2465,0.0,27,241,2224,2733,35836,42909,634583,0.03831224672260137,168583,1842,0.051400194328452505,19386,0,0,0,0,64137,0.01838378618992083,23523,0,0,0,0.0,0,9120,0,2151,412,0,11683,6969,0.08382677513567144,383665,215082,
2465,0.0,27,241,2224,2733,35836,42909,634583,0.03831224672260137,168583,1842,0.051400194328452505,19386,0,0,0,0,64137,0.01838378618992083,23523,0,0,0,0.0,0,9120,0,2151,412,0,11683,6969,0.08382677513567144,383665,215082,
2465,0.0,27,241,2224,2733,35836,42909,634583,0.03831224672260137,168583,1842,0.051400194328452505,19386,0,0,0,0,64137,0.01838378618992083,23523,0,0,0,0.0,0,9120,0,2151,412,0,11683,6969,0.08382677513567144,383665,215082,
2465,0.0,27,241,2224,2733,35836,42909,634583,0.03831224672260137,168583,1842,0.051400194328452505,19386,0,0,0,0,64137,0.01838378618992083,23523,0,0,0,0.0,0,9120,0,2151,412,0,11683,6969,0.08382677513567144,383665,215082,
2465,0.0,27,241,2224,2733,35836,42909,634583,0.03831224672260137,168583,1842,0.051400194328452505,19386,0,0,0,0,64137,0.01838378618992083,23523,0,0,0,0.0,0,9120,0,2151,412,0,11683,6969,0.08382677513567144,383665,215082,
2465,0.0,27,241,2224,2733,35836,42909,634583,0.03831224672260137,168583,1842,0.051400194328452505,19386,0,0,0,0,64137,0.01838378618992083,23523,0,0,0,0.0,0,9120,0,2151,412,0,11683,6969,0.08382677513567144,383665,215082,
2465,0.0,27,241,2224,2733,35836,42909,634583,0.03831224672260137,168583,1842,0.051400194328452505,19386,0,0,0,0,64137,0.01838378618992083,23523,0,0,0,0.0,0,9120,0,2151,412,0,11683,6969,0.08382677513567144,383665,215082,
2465,0.0,27,241,2224,2733,35836,42909,634583,0.03831224672260137,168583,1842,0.051400194328452505,19386,0,0,0,0,64137,0.01838378618992083,23523,0,0,0,0.0,0,9120,0,2151,412,0,11683,6969,0.08382677513567144,383665,215082,
2465,0.0,27,241,2224,2733,35836,42909,634583,0.03831224672260137,168583,1842,0.051400194328452505,19386,0,0,0,0,64137,0.01838378618992083,23523,0,0,0,0.0,0,9120,0,2151,412,0,11683,6969,0.08382677513567144,383665,215082,
2465,0.0,27,241,2224,2733,35836,42909,634583,0.03831224672260137,168583,1842,0.051400194328452505,19386,0,0,0,0,64137,0.01838378618992083,23523,0,0,0,0.0,0,9120,0,2151,412,0,11683,6969,0.08382677513567144,383665,215082,
2465,0.0,27,241,2224,2733,35836,42909,634583,0.03831224672260137,168583,1842,0.051400194328452505,19386,0,0,0,0,64137,0.01838378618992083,23523,0,0,0,0.0,0,9120,0,2151,412,0,11683,6969,0.08382677513567144,383665,215082,
2465,0.0,27,241,2224,2733,35836,42909,634583,0.03831224672260137,168583,1842,0.051400194328452505,19386,0,0,0,0,64137,0.01838378618992083,23523,0,0,0,0.0,0,9120,0,2151,412,0,11683,6969,0.08382677513567144,383665,215082,
2465,0.0,27,241,2224,2733,35836,42909,634583,0.03831224672260137,168583,1842,0.051400194328452505,19386,0,0,0,0,64137,0.01838378618992083,23523,0,0,0,0.0,0,9120,0,2151,412,0,11683,6969,0.08382677513567144,383665,215082,
2465,0.0,27,241,2224,2733,35836,42909,634583,0.03831224672260137,168583,1842,0.051400194328452505,19386,0,0,0,0,64137,0.01838378618992083,23523,0,0,0,0.0,0,9120,0,2151,412,0,11683,6969,0.08382677513567144,383665,215082,
2465,0.0,27,241,2224,2733,35836,42909,634583,0.03831224672260137,168583,1842,0.051400194328452505,19386,0,0,0,0,64137,0.01838378618992083,23523,0,0,0,0.0,0,9120,0,2151,412,0,11683,6969,0.08382677513567144,383665,215082,
2465,0.0,27,241,2224,2733,35836,42909,634583,0.03831224672260137,168583,1842,0.051400194328452505,19386,0,0,0,0,64137,0.01838378618992083,23523,0,0,0,0.0,0,9120,0,2151,412,0,11683,6969,0.08382677513567144,383665,215082,
2465,0.0,27,241,2224,2733,35836,42909,634583,0.03831224672260137,168583,1842,0.051400194328452505,19386,0,0,0,0,64137,0.01838378618992083,23523,0,0,0,0.0,0,9120,0,2151,412,0,11683,6969,0.08382677513567144,383665,215082,
2465,0.0,27,241,2224,2733,35836,42909,634583,0.03831224672260137,168583,1842,0.051400194328452505,19386,0,0,0,0,64137,0.01838378618992083,23523,0,0,0,0.0,0,9120,0,2151,412,0,11683,6969,0.08382677513567144,383665,215082,
2465,0.0,27,241,2224,2733,35836,42909,634583,0.03831224672260137,168583,1842,0.051400194328452505,19386,0,0,0,0,64137,0.01838378618992083,23523,0,0,0,0.0,0,9120,0,2151,412,0,11683,6969,0.08382677513567144,383665,215082,
2465,0.0,27,241,2224,2733,35836,42909,634583,0.03831224672260137,168583,1842,0.051400194328452505,19386,0,0,0,0,64137,0.01838378618992083,23523,0,0,0,0.0,0,9120,0,2151,412,0,11683,6969,0.08382677513567144,383665,215082,
2465,0.0,27,241,2224,2733,35836,42909,634583,0.03831224672260137,168583,1842,0.051400194328452505,19386,0,0,0,0,64137,0.01838378618992083,23523,0,0,0,0.0,0,9120,0,2151,412,0,11683,6969,0.08382677513567144,383665,215082,
2465,0.0,27,241,2224,2733,35836,42909,634583,0.03831224672260137,168583,1842,0.051400194328452505,19386,0,0,0,0,64137,0.01838378618992083,23523,0,0,0,0.0,0,9120,0,2151,412,0,11683,6969,0.08382677513567144,383665,215082,
2465,0.0,27,241,2224,2733,35836,42909,634583,0.03831224672260137,168583,1842,0.051400194328452505,19386,0,0,0,0,64137,0.01838378618992083,23523,0,0,0,0.0,0,9120,0,2151,412,0,11683,6969,0.08382677513567144,383665,215082,
2465,0.0,27,241,2224,2733,35836,42909,634583,0.03831224672260137,168583,1842,0.051400194328452505,19386,0,0,0,0,64137,0.01838378618992083,23523,0,0,0,0.0,0,9120,0,2151,412,0,11683,6969,0.08382677513567144,383665,215082,
2465,0.0,27,241,2224,2733,35836,42909,634583,0.03831224672260137,168583,1842,0.051400194328452505,19386,0,0,0,0,64137,0.01838378618992083,23523,0,0,0,0.0,0,9120,0,2151,412,0,11683,6969,0.08382677513567144,383665,215082,
2465,0.0,27,241,2224,2733,35836,42909,634583,0.03831224672260137,168583,1842,0.051400194328452505,19386,0,0,0,0,64137,0.01838378618992083,23523,0,0,0,0.0,0,9120,0,2151,412,0,11683,6969,0.08382677513567144,383665,215082,
2465,0.0,27,241,2224,2733,35836,42909,634583,0.03831224672260137,168583,1842,0.051400194328452505,19386,0,0,0,0,64137,0.01838378618992083,23523,0,0,0,0.0,0,9120,0,2151,412,0,11683,6969,0.08382677513567144,383665,215082,
2465,0.0,27,241,2224,2733,35836,42909,634583,0.03831224672260137,168583,1842,0.051400194328452505,19386,0,0,0,0,64137,0.01838378618992083,23523,0,0,0,0.0,0,9120,0,2151,412,0,11683,6969,0.08382677513567144,383665,215082,
2465,0.0,27,241,2224,2733,35836,42909,634583,0.03831224672260137,168583,1842,0.051400194328452505,19386,0,0,0,0,64137,0.01838378618992083,23523,0,0,0,0.0,0,9120,0,2151,412,0,11683,6969,0.08382677513567144,383665,215082,
2465,0.0,27,241,2224,2733,35836,42909,634583,0.03831224672260137,168583,1842,0.051400194328452505,19386,0,0,0,0,64137,0.01838378618992083,23523,0,0,0,0.0,0,9120,0,2151,412,0,11683,6969,0.08382677513567144,383665,215082,
2465,0.0,27,241,2224,2733,35836,42909,634583,0.03831224672260137,168583,1842,0.051400194328452505,19386,0,0,0,0,64137,0.01838378618992083,23523,0,0,0,0.0,0,9120,0,2151,412,0,11683,6969,0.08382677513567144,383665,215082,
2465,0.0,27,241,2224,2733,35836,42909,634583,0.03831224672260137,168583,1842,0.051400194328452505,19386,0,0,0,0,64137,0.01838378618992083,23523,0,0,0,0.0,0,9120,0,2151,412,0,11683,6969,0.08382677513567144,383665,215082,
2465,0.0,27,241,2224,2733,35836,42909,634583,0.03831224672260137,168583,1842,0.051400194328452505,19386,0,0,0,0,64137,0.01838378618992083,23523,0,0,0,0.0,0,9120,0,2151,412,0,11683,6969,0.08382677513567144,383665,215082,
2465,0.0,27,241,2224,2733,35836,42909,634583,0.03831224672260137,168583,1842,0.051400194328452505,19386,0,0,0,0,64137,0.01838378618992083,23523,0,0,0,0.0,0,9120,0,2151,412,0,11683,6969,0.08382677513567144,383665,215082,
2465,0.0,27,241,2224,2733,35836,42909,634583,0.03831224672260137,168583,1842,0.051400194328452505,19386,0,0,0,0,64137,0.01838378618992083,23523,0,0,0,0.0,0,9120,0,2151,412,0,11683,6969,0.08382677513567144,383665,215082,
2465,0.0,27,241,2224,2733,35836,42909,634583,0.03831224672260137,168583,1842,0.051400194328452505,19386,0,0,0,0,64137,0.01838378618992083,23523,0,0,0,0.0,0,9120,0,2151,412,0,11683,6969,0.08382677513567144,383665,215082,
2465,0.0,27,241,2224,2733,35836,42909,634583,0.03831224672260137,168583,1842,0.051400194328452505,19386,0,0,0,0,64137,0.01838378618992083,23523,0,0,0,0.0,0,9120,0,2151,412,0,11683,6969,0.08382677513567144,383665,215082,
2465,0.0,27,241,2224,2733,35836,42909,634583,0.03831224672260137,168583,1842,0.051400194328452505,19386,0,0,0,0,64137,0.01838378618992083,23523,0,0,0,0.0,0,9120,0,2151,412,0,11683,6969,0.08382677513567144,383665,215082,
2465,0.0,27,241,2224,2733,35836,42909,634583,0.03831224672260137,168583,1842,0.051400194328452505,19386,0,0,0,0,64137,0.01838378618992083,23523,0,0,0,0.0,0,9120,0,2151,412,0,11683,6969,0.08382677513567144,383665,215082,
2465,0.0,27,241,2224,2733,35836,42909,634583,0.03831224672260137,168583,1842,0.051400194328452505,19386,0,0,0,0,64137,0.01838378618992083,23523,0,0,0,0.0,0,9120,0,2151,412,0,11683,6969,0.08382677513567144,383665,215082,
2465,0.0,27,241,2224,2733,35836,42909,634583,0.03831224672260137,168583,1842,0.051400194328452505,19386,0,0,0,0,64137,0.01838378618992083,23523,0,0,0,0.0,0,9120,0,2151,412,0,11683,6969,0.08382677513567144,383665,215082,
2465,0.0,27,241,2224,2733,35836,42909,634583,0.03831224672260137,168583,1842,0.051400194328452505,19386,0,0,0,0,64137,0.01838378618992083,23523,0,0,0,0.0,0,9120,0,2151,412,0,11683,6969,0.08382677513567144,383665,215082,
2465,0.0,27,241,2224,2733,35836,42909,634583,0.03831224672260137,168583,1842,0.051400194328452505,19386,0,0,0,0,64137,0.01838378618992083,23523,0,0,0,0.0,0,9120,0,2151,412,0,11683,6969,0.08382677513567144,383665,215082,
2465,0.0,27,241,2224,2733,35836,42909,634583,0.03831224672260137,168583,1842,0.051400194328452505,19386,0,0,0,0,64137,0.01838378618992083,23523,0,0,0,0.0,0,9120,0,2151,412,0,11683,6969,0.08382677513567144,383665,215082,
2465,0.0,27,241,2224,2733,35836,42909,634583,0.03831224672260137,168583,1842,0.051400194328452505,19386,0,0,0,0,64137,0.01838378618992083,23523,0,0,0,0.0,0,9120,0,2151,412,0,11683,6969,0.08382677513567144,383665,215082,
2465,0.0,27,241,2224,2733,35836,42909,634583,0.03831224672260137,168583,1842,0.051400194328452505,19386,0,0,0,0,64137,0.01838378618992083,23523,0,0,0,0.0,0,9120,0,2151,412,0,11683,6969,0.08382677513567144,383665,215082,
2465,0.0,27,241,2224,2733,35836,42909,634583,0.03831224672260137,168583,1842,0.051400194328452505,19386,0,0,0,0,64137,0.01838378618992083,23523,0,0,0,0.0,0,9120,0,2151,412,0,11683,6969,0.08382677513567144,383665,215082,
2465,0.0,27,241,2224,2733,35836,42909,634583,0.03831224672260137,168583,1842,0.051400194328452505,19386,0,0,0,0,64137,0.01838378618992083,23523,0,0,0,0.0,0,9120,0,2151,412,0,11683,6969,0.08382677513567144,383665,215082,
2465,0.0,27,241,2224,2733,35836,42909,634583,0.03831224672260137,168583,1842,0.051400194328452505,19386,0,0,0,0,64137,0.01838378618992083,23523,0,0,0,0.0,0,9120,0,2151,412,0,11683,6969,0.08382677513567144,383665,215082,
2465,0.0,27,241,2224,2733,35836,42909,634583,0.03831224672260137,168583,1842,0.051400194328452505,19386,0,0,0,0,64137,0.01838378618992083,23523,0,0,0,0.0,0,9120,0,2151,412,0,11683,6969,0.08382677513567144,383665,215082,
2465,0.0,27,241,2224,2733,35836,42909,634583,0.03831224672260137,168583,1842,0.051400194328452505,19386,0,0,0,0,64137,0.01838378618992083,23523,0,0,0,0.0,0,9120,0,2151,412,0,11683,6969,0.08382677513567144,383665,215082,
2465,0.0,27,241,2224,2733,35836,42909,634583,0.03831224672260137,168583,1842,0.051400194328452505,19386,0,0,0,0,64137,0.01838378618992083,23523,0,0,0,0.0,0,9120,0,2151,412,0,11683,6969,0.08382677513567144,383665,215082,
2465,0.0,27,241,2224,2733,35836,42909,634583,0.03831224672260137,168583,1842,0.051400194328452505,19386,0,0,0,0,64137,0.01838378618992083,23523,0,0,0,0.0,0,9120,0,2151,412,0,11683,6969,0.08382677513567144,383665,215082,
2465,0.0,27,241,2224,2733,35836,42909,634583,0.03831224672260137,168583,1842,0.051400194328452505,19386,0,0,0,0,64137,0.01838378618992083,23523,0,0,0,0.0,0,9120,0,2151,412,0,11683,6969,0.08382677513567144,383665,215082,
2465,0.0,27,241,2224,2733,35836,42909,634583,0.03831224672260137,168583,1842,0.051400194328452505,19386,0,0,0,0,64137,0.01838378618992083,23523,0,0,0,0.0,0,9120,0,2151,412,0,11683,6969,0.08382677513567144,383665,215082,
2465,0.0,27,241,2224,2733,35836,42909,634583,0.03831224672260137,168583,1842,0.051400194328452505,19386,0,0,0,0,64137,0.01838378618992083,23523,0,0,0,0.0,0,9120,0,2151,412,0,11683,6969,0.08382677513567144,383665,215082,
2465,0.0,27,241,2224,2733,35836,42909,634583,0.03831224672260137,168583,1842,0.051400194328452505,19386,0,0,0,0,64137,0.01838378618992083,23523,0,0,0,0.0,0,9120,0,2151,412,0,11683,6969,0.08382677513567144,383665,215082,
2465,0.0,27,241,2224,2733,35836,42909,634583,0.03831224672260137,168583,1842,0.051400194328452505,19386,0,0,0,0,64137,0.01838378618992083,23523,0,0,0,0.0,0,9120,0,2151,412,0,11683,6969,0.08382677513567144,383665,215082,
2465,0.0,27,241,2224,2733,35836,42909,634583,0.03831224672260137,168583,1842,0.051400194328452505,19386,0,0,0,0,64137,0.01838378618992083,23523,0,0,0,0.0,0,9120,0,2151,412,0,11683,6969,0.08382677513567144,383665,215082,
2465,0.0,27,241,2224,2733,35836,42909,634583,0.03831224672260137,168583,1842,0.051400194328452505,19386,0,0,0,0,64137,0.01838378618992083,23523,0,0,0,0.0,0,9120,0,2151,412,0,11683,6969,0.08382677513567144,383665,215082,
2465,0.0,27,241,2224,2733,35836,42909,634583,0.03831224672260137,168583,1842,0.051400194328452505,19386,0,0,0,0,64137,0.01838378618992083,23523,0,0,0,0.0,0,9120,0,2151,412,0,11683,6969,0.08382677513567144,383665,215082,
2465,0.0,27,241,2224,2733,35836,42909,634583,0.03831224672260137,168583,1842,0.051400194328452505,19386,0,0,0,0,64137,0.01838378618992083,23523,0,0,0,0.0,0,9120,0,2151,412,0,11683,6969,0.08382677513567144,383665,215082,
2465,0.0,27,241,2224,2733,35836,42909,634583,0.03831224672260137,168583,1842,0.051400194328452505,19386,0,0,0,0,64137,0.01838378618992083,23523,0,0,0,0.0,0,9120,0,2151,412,0,11683,6969,0.08382677513567144,383665,215082,
2465,0.0,27,241,2224,2733,35836,42909,634583,0.03831224672260137,168583,1842,0.051400194328452505,19386,0,0,0,0,64137,0.01838378618992083,23523,0,0,0,0.0,0,9120,0,2151,412,0,11683,6969,0.08382677513567144,383665,215082,
2465,0.0,27,241,2224,2733,35836,42909,634583,0.03831224672260137,168583,1842,0.051400194328452505,19386,0,0,0,0,64137,0.01838378618992083,23523,0,0,0,0.0,0,9120,0,2151,412,0,11683,6969,0.08382677513567144,383665,215082,
2465,0.0,27,241,2224,2733,35836,42909,634583,0.03831224672260137,168583,1842,0.051400194328452505,19386,0,0,0,0,64137,0.01838378618992083,23523,0,0,0,0.0,0,9120,0,2151,412,0,11683,6969,0.08382677513567144,383665,215082,
2465,0.0,27,241,2224,2733,35836,42909,634583,0.03831224672260137,168583,1842,0.051400194328452505,19386,0,0,0,0,64137,0.01838378618992083,23523,0,0,0,0.0,0,9120,0,2151,412,0,11683,6969,0.08382677513567144,383665,215082,
2465,0.0,27,241,2224,2733,35836,42909,634583,0.03831224672260137,168583,1842,0.051400194328452505,19386,0,0,0,0,64137,0.01838378618992083,23523,0,0,0,0.0,0,9120,0,2151,412,0,11683,6969,0.08382677513567144,383665,215082,
2465,0.0,27,241,2224,2733,35836,42909,634583,0.03831224672260137,168583,1842,0.051400194328452505,19386,0,0,0,0,64137,0.01838378618992083,23523,0,0,0,0.0,0,9120,0,2151,412,0,11683,6969,0.08382677513567144,383665,215082,
2465,0.0,27,241,2224,2733,35836,42909,634583,0.03831224672260137,168583,1842,0.051400194328452505,19386,0,0,0,0,64137,0.01838378618992083,23523,0,0,0,0.0,0,9120,0,2151,412,0,11683,6969,0.08382677513567144,383665,215082,
2465,0.0,27,241,2224,2733,35836,42909,634583,0.03831224672260137,168583,1842,0.051400194328452505,19386,0,0,0,0,64137,0.01838378618992083,23523,0,0,0,0.0,0,9120,0,2151,412,0,11683,6969,0.08382677513567144,383665,215082,
2465,0.0,27,241,2224,2733,35836,42909,634583,0.03831224672260137,168583,1842,0.051400194328452505,19386,0,0,0,0,64137,0.01838378618992083,23523,0,0,0,0.0,0,9120,0,2151,412,0,11683,6969,0.08382677513567144,383665,215082,
2465,0.0,27,241,2224,2733,35836,42909,634583,0.03831224672260137,168583,1842,0.051400194328452505,19386,0,0,0,0,64137,0.01838378618992083,23523,0,0,0,0.0,0,9120,0,2151,412,0,11683,6969,0.08382677513567144,383665,215082,
2465,0.0,27,241,2224,2733,35836,42909,634583,0.03831224672260137,168583,1842,0.051400194328452505,19386,0,0,0,0,64137,0.01838378618992083,23523,0,0,0,0.0,0,9120,0,2151,412,0,11683,6969,0.08382677513567144,383665,215082,
2465,0.0,27,241,2224,2733,35836,42909,634583,0.03831224672260137,168583,1842,0.051400194328452505,19386,0,0,0,0,64137,0.01838378618992083,23523,0,0,0,0.0,0,9120,0,2151,412,0,11683,6969,0.08382677513567144,383665,215082,
2465,0.0,27,241,2224,2733,35836,42909,634583,0.03831224672260137,168583,1842,0.051400194328452505,19386,0,0,0,0,64137,0.01838378618992083,23523,0,0,0,0.0,0,9120,0,2151,412,0,11683,6969,0.08382677513567144,383665,215082,
2465,0.0,27,241,2224,2733,35836,42909,634583,0.03831224672260137,168583,1842,0.051400194328452505,19386,0,0,0,0,64137,0.01838378618992083,23523,0,0,0,0.0,0,9120,0,2151,412,0,11683,6969,0.08382677513567144,383665,215082,
2465,0.0,27,241,2224,2733,35836,42909,634583,0.03831224672260137,168583,1842,0.051400194328452505,19386,0,0,0,0,64137,0.01838378618992083,23523,0,0,0,0.0,0,9120,0,2151,412,0,11683,6969,0.08382677513567144,383665,215082,
2465,0.0,27,241,2224,2733,35836,42909,634583,0.03831224672260137,168583,1842,0.051400194328452505,19386,0,0,0,0,64137,0.01838378618992083,23523,0,0,0,0.0,0,9120,0,2151,412,0,11683,6969,0.08382677513567144,383665,215082,
2465,0.0,27,241,2224,2733,35836,42909,634583,0.03831224672260137,168583,1842,0.051400194328452505,19386,0,0,0,0,64137,0.01838378618992083,23523,0,0,0,0.0,0,9120,0,2151,412,0,11683,6969,0.08382677513567144,383665,215082,
2465,0.0,27,241,2224,2733,35836,42909,634583,0.03831224672260137,168583,1842,0.051400194328452505,19386,0,0,0,0,64137,0.01838378618992083,23523,0,0,0,0.0,0,9120,0,2151,412,0,11683,6969,0.08382677513567144,383665,215082,
2465,0.0,27,241,2224,2733,35836,42909,634583,0.03831224672260137,168583,1842,0.051400194328452505,19386,0,0,0,0,64137,0.01838378618992083,23523,0,0,0,0.0,0,9120,0,2151,412,0,11683,6969,0.08382677513567144,383665,215082,
2465,0.0,27,241,2224,2733,35836,42909,634583,0.03831224672260137,168583,1842,0.051400194328452505,19386,0,0,0,0,64137,0.01838378618992083,23523,0,0,0,0.0,0,9120,0,2151,412,0,11683,6969,0.08382677513567144,383665,215082,
2465,0.0,27,241,2224,2733,35836,42909,634583,0.03831224672260137,168583,1842,0.051400194328452505,19386,0,0,0,0,64137,0.01838378618992083,23523,0,0,0,0.0,0,9120,0,2151,412,0,11683,6969,0.08382677513567144,383665,215082,
2465,0.0,27,241,2224,2733,35836,42909,634583,0.03831224672260137,168583,1842,0.051400194328452505,19386,0,0,0,0,64137,0.01838378618992083,23523,0,0,0,0.0,0,9120,0,2151,412,0,11683,6969,0.08382677513567144,383665,215082,
2465,0.0,27,241,2224,2733,35836,42909,634583,0.03831224672260137,168583,1842,0.051400194328452505,19386,0,0,0,0,64137,0.01838378618992083,23523,0,0,0,0.0,0,9120,0,2151,412,0,11683,6969,0.08382677513567144,383665,215082,
2465,0.0,27,241,2224,2733,35836,42909,634583,0.03831224672260137,168583,1842,0.051400194328452505,19386,0,0,0,0,64137,0.01838378618992083,23523,0,0,0,0.0,0,9120,0,2151,412,0,11683,6969,0.08382677513567144,383665,215082,
2465,0.0,27,241,2224,2733,35836,42909,634583,0.03831224672260137,168583,1842,0.051400194328452505,19386,0,0,0,0,64137,0.01838378618992083,23523,0,0,0,0.0,0,9120,0,2151,412,0,11683,6969,0.08382677513567144,383665,215082,
2465,0.0,27,241,2224,2733,35836,42909,634583,0.03831224672260137,168583,1842,0.051400194328452505,19386,0,0,0,0,64137,0.01838378618992083,23523,0,0,0,0.0,0,9120,0,2151,412,0,11683,6969,0.08382677513567144,383665,215082,
2465,0.0,27,241,2224,2733,35836,42909,634583,0.03831224672260137,168583,1842,0.051400194328452505,19386,0,0,0,0,64137,0.01838378618992083,23523,0,0,0,0.0,0,9120,0,2151,412,0,11683,6969,0.08382677513567144,383665,215082,
2465,0.0,27,241,2224,2733,35836,42909,634583,0.03831224672260137,168583,1842,0.051400194328452505,19386,0,0,0,0,64137,0.01838378618992083,23523,0,0,0,0.0,0,9120,0,2151,412,0,11683,6969,0.08382677513567144,383665,215082,
2465,0.0,27,241,2224,2733,35836,42909,634583,0.03831224672260137,168583,1842,0.051400194328452505,19386,0,0,0,0,64137,0.01838378618992083,23523,0,0,0,0.0,0,9120,0,2151,412,0,11683,6969,0.08382677513567144,383665,215082,
2465,0.0,27,241,2224,2733,35836,42909,634583,0.03831224672260137,168583,1842,0.051400194328452505,19386,0,0,0,0,64137,0.01838378618992083,23523,0,0,0,0.0,0,9120,0,2151,412,0,11683,6969,0.08382677513567144,383665,215082,
2465,0.0,27,241,2224,2733,35836,42909,634583,0.03831224672260137,168583,1842,0.051400194328452505,19386,0,0,0,0,64137,0.01838378618992083,23523,0,0,0,0.0,0,9120,0,2151,412,0,11683,6969,0.08382677513567144,383665,215082,
2465,0.0,27,241,2224,2733,35836,42909,634583,0.03831224672260137,168583,1842,0.051400194328452505,19386,0,0,0,0,64137,0.01838378618992083,23523,0,0,0,0.0,0,9120,0,2151,412,0,11683,6969,0.08382677513567144,383665,215082,
2465,0.0,27,241,2224,2733,35836,42909,634583,0.03831224672260137,168583,1842,0.051400194328452505,19386,0,0,0,0,64137,0.01838378618992083,23523,0,0,0,0.0,0,9120,0,2151,412,0,11683,6969,0.08382677513567144,383665,215082,
2465,0.0,27,241,2224,2733,35836,42909,634583,0.03831224672260137,168583,1842,0.051400194328452505,19386,0,0,0,0,64137,0.01838378618992083,23523,0,0,0,0.0,0,9120,0,2151,412,0,11683,6969,0.08382677513567144,383665,215082,
2465,0.0,27,241,2224,2733,35836,42909,634583,0.03831224672260137,168583,1842,0.051400194328452505,19386,0,0,0,0,64137,0.01838378618992083,23523,0,0,0,0.0,0,9120,0,2151,412,0,11683,6969,0.08382677513567144,383665,215082,
2465,0.0,27,241,2224,2733,35836,42909,634583,0.03831224672260137,168583,1842,0.051400194328452505,19386,0,0,0,0,64137,0.01838378618992083,23523,0,0,0,0.0,0,9120,0,2151,412,0,11683,6969,0.08382677513567144,383665,215082,
2465,0.0,27,241,2224,2733,35836,42909,634583,0.03831224672260137,168583,1842,0.051400194328452505,19386,0,0,0,0,64137,0.01838378618992083,23523,0,0,0,0.0,0,9120,0,2151,412,0,11683,6969,0.08382677513567144,383665,215082,
2465,0.0,27,241,2224,2733,35836,42909,634583,0.03831224672260137,168583,1842,0.051400194328452505,19386,0,0,0,0,64137,0.01838378618992083,23523,0,0,0,0.0,0,9120,0,2151,412,0,11683,6969,0.08382677513567144,383665,215082,
2465,0.0,27,241,2224,2733,35836,42909,634583,0.03831224672260137,168583,1842,0.051400194328452505,19386,0,0,0,0,64137,0.01838378618992083,23523,0,0,0,0.0,0,9120,0,2151,412,0,11683,6969,0.08382677513567144,383665,215082,
2465,0.0,27,241,2224,2733,35836,42909,634583,0.03831224672260137,168583,1842,0.051400194328452505,19386,0,0,0,0,64137,0.01838378618992083,23523,0,0,0,0.0,0,9120,0,2151,412,0,11683,6969,0.08382677513567144,383665,215082,
2465,0.0,27,241,2224,2733,35836,42909,634583,0.03831224672260137,168583,1842,0.051400194328452505,19386,0,0,0,0,64137,0.01838378618992083,23523,0,0,0,0.0,0,9120,0,2151,412,0,11683,6969,0.08382677513567144,383665,215082,
2465,0.0,27,241,2224,2733,35836,42909,634583,0.03831224672260137,168583,1842,0.051400194328452505,19386,0,0,0,0,64137,0.01838378618992083,23523,0,0,0,0.0,0,9120,0,2151,412,0,11683,6969,0.08382677513567144,383665,215082,
2465,0.0,27,241,2224,2733,35836,42909,634583,0.03831224672260137,168583,1842,0.051400194328452505,19386,0,0,0,0,64137,0.01838378618992083,23523,0,0,0,0.0,0,9120,0,2151,412,0,11683,6969,0.08382677513567144,383665,215082,
2465,0.0,27,241,2224,2733,35836,42909,634583,0.03831224672260137,168583,1842,0.051400194328452505,19386,0,0,0,0,64137,0.01838378618992083,23523,0,0,0,0.0,0,9120,0,2151,412,0,11683,6969,0.08382677513567144,383665,215082,
2465,0.0,27,241,2224,2733,35836,42909,634583,0.03831224672260137,168583,1842,0.051400194328452505,19386,0,0,0,0,64137,0.01838378618992083,23523,0,0,0,0.0,0,9120,0,2151,412,0,11683,6969,0.08382677513567144,383665,215082,
2465,0.0,27,241,2224,2733,35836,42909,634583,0.03831224672260137,168583,1842,0.051400194328452505,19386,0,0,0,0,64137,0.01838378618992083,23523,0,0,0,0.0,0,9120,0,2151,412,0,11683,6969,0.08382677513567144,383665,215082,
2465,0.0,27,241,2224,2733,35836,42909,634583,0.03831224672260137,168583,1842,0.051400194328452505,19386,0,0,0,0,64137,0.01838378618992083,23523,0,0,0,0.0,0,9120,0,2151,412,0,11683,6969,0.08382677513567144,383665,215082,
2465,0.0,27,241,2224,2733,35836,42909,634583,0.03831224672260137,168583,1842,0.051400194328452505,19386,0,0,0,0,64137,0.01838378618992083,23523,0,0,0,0.0,0,9120,0,2151,412,0,11683,6969,0.08382677513567144,383665,215082,
2465,0.0,27,241,2224,2733,35836,42909,634583,0.03831224672260137,168583,1842,0.051400194328452505,19386,0,0,0,0,64137,0.01838378618992083,23523,0,0,0,0.0,0,9120,0,2151,412,0,11683,6969,0.08382677513567144,383665,215082,
2465,0.0,27,241,2224,2733,35836,42909,634583,0.03831224672260137,168583,1842,0.051400194328452505,19386,0,0,0,0,64137,0.01838378618992083,23523,0,0,0,0.0,0,9120,0,2151,412,0,11683,6969,0.08382677513567144,383665,215082,
2465,0.0,27,241,2224,2733,35836,42909,634583,0.03831224672260137,168583,1842,0.051400194328452505,19386,0,0,0,0,64137,0.01838378618992083,23523,0,0,0,0.0,0,9120,0,2151,412,0,11683,6969,0.08382677513567144,383665,215082,
2465,0.0,27,241,2224,2733,35836,42909,634583,0.03831224672260137,168583,1842,0.051400194328452505,19386,0,0,0,0,64137,0.01838378618992083,23523,0,0,0,0.0,0,9120,0,2151,412,0,11683,6969,0.08382677513567144,383665,215082,
2465,0.0,27,241,2224,2733,35836,42909,634583,0.03831224672260137,168583,1842,0.051400194328452505,19386,0,0,0,0,64137,0.01838378618992083,23523,0,0,0,0.0,0,9120,0,2151,412,0,11683,6969,0.08382677513567144,383665,215082,
2465,0.0,27,241,2224,2733,35836,42909,634583,0.03831224672260137,168583,1842,0.051400194328452505,19386,0,0,0,0,64137,0.01838378618992083,23523,0,0,0,0.0,0,9120,0,2151,412,0,11683,6969,0.08382677513567144,383665,215082,
2465,0.0,27,241,2224,2733,35836,42909,634583,0.03831224672260137,168583,1842,0.051400194328452505,19386,0,0,0,0,64137,0.01838378618992083,23523,0,0,0,0.0,0,9120,0,2151,412,0,11683,6969,0.08382677513567144,383665,215082,
2465,0.0,27,241,2224,2733,35836,42909,634583,0.03831224672260137,168583,1842,0.051400194328452505,19386,0,0,0,0,64137,0.01838378618992083,23523,0,0,0,0.0,0,9120,0,2151,412,0,11683,6969,0.08382677513567144,383665,215082,
2465,0.0,27,241,2224,2733,35836,42909,634583,0.03831224672260137,168583,1842,0.051400194328452505,19386,0,0,0,0,64137,0.01838378618992083,23523,0,0,0,0.0,0,9120,0,2151,412,0,11683,6969,0.08382677513567144,383665,215082,
2465,0.0,27,241,2224,2733,35836,42909,634583,0.03831224672260137,168583,1842,0.051400194328452505,19386,0,0,0,0,64137,0.01838378618992083,23523,0,0,0,0.0,0,9120,0,2151,412,0,11683,6969,0.08382677513567144,383665,215082,
2465,0.0,27,241,2224,2733,35836,42909,634583,0.03831224672260137,168583,1842,0.051400194328452505,19386,0,0,0,0,64137,0.01838378618992083,23523,0,0,0,0.0,0,9120,0,2151,412,0,11683,6969,0.08382677513567144,383665,215082,
2465,0.0,27,241,2224,2733,35836,42909,634583,0.03831224672260137,168583,1842,0.051400194328452505,19386,0,0,0,0,64137,0.01838378618992083,23523,0,0,0,0.0,0,9120,0,2151,412,0,11683,6969,0.08382677513567144,383665,215082,
2465,0.0,27,241,2224,2733,35836,42909,634583,0.03831224672260137,168583,1842,0.051400194328452505,19386,0,0,0,0,64137,0.01838378618992083,23523,0,0,0,0.0,0,9120,0,2151,412,0,11683,6969,0.08382677513567144,383665,215082,
2465,0.0,27,241,2224,2733,35836,42909,634583,0.03831224672260137,168583,1842,0.051400194328452505,19386,0,0,0,0,64137,0.01838378618992083,23523,0,0,0,0.0,0,9120,0,2151,412,0,11683,6969,0.08382677513567144,383665,215082,
2465,0.0,27,241,2224,2733,35836,42909,634583,0.03831224672260137,168583,1842,0.051400194328452505,19386,0,0,0,0,64137,0.01838378618992083,23523,0,0,0,0.0,0,9120,0,2151,412,0,11683,6969,0.08382677513567144,383665,215082,
2465,0.0,27,241,2224,2733,35836,42909,634583,0.03831224672260137,168583,1842,0.051400194328452505,19386,0,0,0,0,64137,0.01838378618992083,23523,0,0,0,0.0,0,9120,0,2151,412,0,11683,6969,0.08382677513567144,383665,215082,
2465,0.0,27,241,2224,2733,35836,42909,634583,0.03831224672260137,168583,1842,0.051400194328452505,19386,0,0,0,0,64137,0.01838378618992083,23523,0,0,0,0.0,0,9120,0,2151,412,0,11683,6969,0.08382677513567144,383665,215082,
2465,0.0,27,241,2224,2733,35836,42909,634583,0.03831224672260137,168583,1842,0.051400194328452505,19386,0,0,0,0,64137,0.01838378618992083,23523,0,0,0,0.0,0,9120,0,2151,412,0,11683,6969,0.08382677513567144,383665,215082,
2465,0.0,27,241,2224,2733,35836,42909,634583,0.03831224672260137,168583,1842,0.051400194328452505,19386,0,0,0,0,64137,0.01838378618992083,23523,0,0,0,0.0,0,9120,0,2151,412,0,11683,6969,0.08382677513567144,383665,215082,
2465,0.0,27,241,2224,2733,35836,42909,634583,0.03831224672260137,168583,1842,0.051400194328452505,19386,0,0,0,0,64137,0.01838378618992083,23523,0,0,0,0.0,0,9120,0,2151,412,0,11683,6969,0.08382677513567144,383665,215082,
2465,0.0,27,241,2224,2733,35836,42909,634583,0.03831224672260137,168583,1842,0.051400194328452505,19386,0,0,0,0,64137,0.01838378618992083,23523,0,0,0,0.0,0,9120,0,2151,412,0,11683,6969,0.08382677513567144,383665,215082,
2465,0.0,27,241,2224,2733,35836,42909,634583,0.03831224672260137,168583,1842,0.051400194328452505,19386,0,0,0,0,64137,0.01838378618992083,23523,0,0,0,0.0,0,9120,0,2151,412,0,11683,6969,0.08382677513567144,383665,215082,
2465,0.0,27,241,2224,2733,35836,42909,634583,0.03831224672260137,168583,1842,0.051400194328452505,19386,0,0,0,0,64137,0.01838378618992083,23523,0,0,0,0.0,0,9120,0,2151,412,0,11683,6969,0.08382677513567144,383665,215082,
2465,0.0,27,241,2224,2733,35836,42909,634583,0.03831224672260137,168583,1842,0.051400194328452505,19386,0,0,0,0,64137,0.01838378618992083,23523,0,0,0,0.0,0,9120,0,2151,412,0,11683,6969,0.08382677513567144,383665,215082,
2465,0.0,27,241,2224,2733,35836,42909,634583,0.03831224672260137,168583,1842,0.051400194328452505,19386,0,0,0,0,64137,0.01838378618992083,23523,0,0,0,0.0,0,9120,0,2151,412,0,11683,6969,0.08382677513567144,383665,215082,
2465,0.0,27,241,2224,2733,35836,42909,634583,0.03831224672260137,168583,1842,0.051400194328452505,19386,0,0,0,0,64137,0.01838378618992083,23523,0,0,0,0.0,0,9120,0,2151,412,0,11683,6969,0.08382677513567144,383665,215082,
2465,0.0,27,241,2224,2733,35836,42909,634583,0.03831224672260137,168583,1842,0.051400194328452505,19386,0,0,0,0,64137,0.01838378618992083,23523,0,0,0,0.0,0,9120,0,2151,412,0,11683,6969,0.08382677513567144,383665,215082,
2465,0.0,27,241,2224,2733,35836,42909,634583,0.03831224672260137,168583,1842,0.051400194328452505,19386,0,0,0,0,64137,0.01838378618992083,23523,0,0,0,0.0,0,9120,0,2151,412,0,11683,6969,0.08382677513567144,383665,215082,
2465,0.0,27,241,2224,2733,35836,42909,634583,0.03831224672260137,168583,1842,0.051400194328452505,19386,0,0,0,0,64137,0.01838378618992083,23523,0,0,0,0.0,0,9120,0,2151,412,0,11683,6969,0.08382677513567144,383665,215082,
2465,0.0,27,241,2224,2733,35836,42909,634583,0.03831224672260137,168583,1842,0.051400194328452505,19386,0,0,0,0,64137,0.01838378618992083,23523,0,0,0,0.0,0,9120,0,2151,412,0,11683,6969,0.08382677513567144,383665,215082,
2465,0.0,27,241,2224,2733,35836,42909,634583,0.03831224672260137,168583,1842,0.051400194328452505,19386,0,0,0,0,64137,0.01838378618992083,23523,0,0,0,0.0,0,9120,0,2151,412,0,11683,6969,0.08382677513567144,383665,215082,
2465,0.0,27,241,2224,2733,35836,42909,634583,0.03831224672260137,168583,1842,0.051400194328452505,19386,0,0,0,0,64137,0.01838378618992083,23523,0,0,0,0.0,0,9120,0,2151,412,0,11683,6969,0.08382677513567144,383665,215082,
2465,0.0,27,241,2224,2733,35836,42909,634583,0.03831224672260137,168583,1842,0.051400194328452505,19386,0,0,0,0,64137,0.01838378618992083,23523,0,0,0,0.0,0,9120,0,2151,412,0,11683,6969,0.08382677513567144,383665,215082,
2465,0.0,27,241,2224,2733,35836,42909,634583,0.03831224672260137,168583,1842,0.051400194328452505,19386,0,0,0,0,64137,0.01838378618992083,23523,0,0,0,0.0,0,9120,0,2151,412,0,11683,6969,0.08382677513567144,383665,215082,
2465,0.0,27,241,2224,2733,35836,42909,634583,0.03831224672260137,168583,1842,0.051400194328452505,19386,0,0,0,0,64137,0.01838378618992083,23523,0,0,0,0.0,0,9120,0,2151,412,0,11683,6969,0.08382677513567144,383665,215082,
2465,0.0,27,241,2224,2733,35836,42909,634583,0.03831224672260137,168583,1842,0.051400194328452505,19386,0,0,0,0,64137,0.01838378618992083,23523,0,0,0,0.0,0,9120,0,2151,412,0,11683,6969,0.08382677513567144,383665,215082,
2465,0.0,27,241,2224,2733,35836,42909,634583,0.03831224672260137,168583,1842,0.051400194328452505,19386,0,0,0,0,64137,0.01838378618992083,23523,0,0,0,0.0,0,9120,0,2151,412,0,11683,6969,0.08382677513567144,383665,215082,
2465,0.0,27,241,2224,2733,35836,42909,634583,0.03831224672260137,168583,1842,0.051400194328452505,19386,0,0,0,0,64137,0.01838378618992083,23523,0,0,0,0.0,0,9120,0,2151,412,0,11683,6969,0.08382677513567144,383665,215082,
2465,0.0,27,241,2224,2733,35836,42909,634583,0.03831224672260137,168583,1842,0.051400194328452505,19386,0,0,0,0,64137,0.01838378618992083,23523,0,0,0,0.0,0,9120,0,2151,412,0,11683,6969,0.08382677513567144,383665,215082,
2465,0.0,27,241,2224,2733,35836,42909,634583,0.03831224672260137,168583,1842,0.051400194328452505,19386,0,0,0,0,64137,0.01838378618992083,23523,0,0,0,0.0,0,9120,0,2151,412,0,11683,6969,0.08382677513567144,383665,215082,
2465,0.0,27,241,2224,2733,35836,42909,634583,0.03831224672260137,168583,1842,0.051400194328452505,19386,0,0,0,0,64137,0.01838378618992083,23523,0,0,0,0.0,0,9120,0,2151,412,0,11683,6969,0.08382677513567144,383665,215082,
2465,0.0,27,241,2224,2733,35836,42909,634583,0.03831224672260137,168583,1842,0.051400194328452505,19386,0,0,0,0,64137,0.01838378618992083,23523,0,0,0,0.0,0,9120,0,2151,412,0,11683,6969,0.08382677513567144,383665,215082,
2465,0.0,27,241,2224,2733,35836,42909,634583,0.03831224672260137,168583,1842,0.051400194328452505,19386,0,0,0,0,64137,0.01838378618992083,23523,0,0,0,0.0,0,9120,0,2151,412,0,11683,6969,0.08382677513567144,383665,215082,
2465,0.0,27,241,2224,2733,35836,42909,634583,0.03831224672260137,168583,1842,0.051400194328452505,19386,0,0,0,0,64137,0.01838378618992083,23523,0,0,0,0.0,0,9120,0,2151,412,0,11683,6969,0.08382677513567144,383665,215082,
2465,0.0,27,241,2224,2733,35836,42909,634583,0.03831224672260137,168583,1842,0.051400194328452505,19386,0,0,0,0,64137,0.01838378618992083,23523,0,0,0,0.0,0,9120,0,2151,412,0,11683,6969,0.08382677513567144,383665,215082,
2465,0.0,27,241,2224,2733,35836,42909,634583,0.03831224672260137,168583,1842,0.051400194328452505,19386,0,0,0,0,64137,0.01838378618992083,23523,0,0,0,0.0,0,9120,0,2151,412,0,11683,6969,0.08382677513567144,383665,215082,
2465,0.0,27,241,2224,2733,35836,42909,634583,0.03831224672260137,168583,1842,0.051400194328452505,19386,0,0,0,0,64137,0.01838378618992083,23523,0,0,0,0.0,0,9120,0,2151,412,0,11683,6969,0.08382677513567144,383665,215082,
2465,0.0,27,241,2224,2733,35836,42909,634583,0.03831224672260137,168583,1842,0.051400194328452505,19386,0,0,0,0,64137,0.01838378618992083,23523,0,0,0,0.0,0,9120,0,2151,412,0,11683,6969,0.08382677513567144,383665,215082,
2465,0.0,27,241,2224,2733,35836,42909,634583,0.03831224672260137,168583,1842,0.051400194328452505,19386,0,0,0,0,64137,0.01838378618992083,23523,0,0,0,0.0,0,9120,0,2151,412,0,11683,6969,0.08382677513567144,383665,215082,
2465,0.0,27,241,2224,2733,35836,42909,634583,0.03831224672260137,168583,1842,0.051400194328452505,19386,0,0,0,0,64137,0.01838378618992083,23523,0,0,0,0.0,0,9120,0,2151,412,0,11683,6969,0.08382677513567144,383665,215082,
2465,0.0,27,241,2224,2733,35836,42909,634583,0.03831224672260137,168583,1842,0.051400194328452505,19386,0,0,0,0,64137,0.01838378618992083,23523,0,0,0,0.0,0,9120,0,2151,412,0,11683,6969,0.08382677513567144,383665,215082,
2465,0.0,27,241,2224,2733,35836,42909,634583,0.03831224672260137,168583,1842,0.051400194328452505,19386,0,0,0,0,64137,0.01838378618992083,23523,0,0,0,0.0,0,9120,0,2151,412,0,11683,6969,0.08382677513567144,383665,215082,
2465,0.0,27,241,2224,2733,35836,42909,634583,0.03831224672260137,168583,1842,0.051400194328452505,19386,0,0,0,0,64137,0.01838378618992083,23523,0,0,0,0.0,0,9120,0,2151,412,0,11683,6969,0.08382677513567144,383665,215082,
2465,0.0,27,241,2224,2733,35836,42909,634583,0.03831224672260137,168583,1842,0.051400194328452505,19386,0,0,0,0,64137,0.01838378618992083,23523,0,0,0,0.0,0,9120,0,2151,412,0,11683,6969,0.08382677513567144,383665,215082,
2465,0.0,27,241,2224,2733,35836,42909,634583,0.03831224672260137,168583,1842,0.051400194328452505,19386,0,0,0,0,64137,0.01838378618992083,23523,0,0,0,0.0,0,9120,0,2151,412,0,11683,6969,0.08382677513567144,383665,215082,
2465,0.0,27,241,2224,2733,35836,42909,634583,0.03831224672260137,168583,1842,0.051400194328452505,19386,0,0,0,0,64137,0.01838378618992083,23523,0,0,0,0.0,0,9120,0,2151,412,0,11683,6969,0.08382677513567144,383665,215082,
2465,0.0,27,241,2224,2733,35836,42909,634583,0.03831224672260137,168583,1842,0.051400194328452505,19386,0,0,0,0,64137,0.01838378618992083,23523,0,0,0,0.0,0,9120,0,2151,412,0,11683,6969,0.08382677513567144,383665,215082,
2465,0.0,27,241,2224,2733,35836,42909,634583,0.03831224672260137,168583,1842,0.051400194328452505,19386,0,0,0,0,64137,0.01838378618992083,23523,0,0,0,0.0,0,9120,0,2151,412,0,11683,6969,0.08382677513567144,383665,215082,
2465,0.0,27,241,2224,2733,35836,42909,634583,0.03831224672260137,168583,1842,0.051400194328452505,19386,0,0,0,0,64137,0.01838378618992083,23523,0,0,0,0.0,0,9120,0,2151,412,0,11683,6969,0.08382677513567144,383665,215082,
2465,0.0,27,241,2224,2733,35836,42909,634583,0.03831224672260137,168583,1842,0.051400194328452505,19386,0,0,0,0,64137,0.01838378618992083,23523,0,0,0,0.0,0,9120,0,2151,412,0,11683,6969,0.08382677513567144,383665,215082,
2465,0.0,27,241,2224,2733,35836,42909,634583,0.03831224672260137,168583,1842,0.051400194328452505,19386,0,0,0,0,64137,0.01838378618992083,23523,0,0,0,0.0,0,9120,0,2151,412,0,11683,6969,0.08382677513567144,383665,215082,
2465,0.0,27,241,2224,2733,35836,42909,634583,0.03831224672260137,168583,1842,0.051400194328452505,19386,0,0,0,0,64137,0.01838378618992083,23523,0,0,0,0.0,0,9120,0,2151,412,0,11683,6969,0.08382677513567144,383665,215082,
2465,0.0,27,241,2224,2733,35836,42909,634583,0.03831224672260137,168583,1842,0.051400194328452505,19386,0,0,0,0,64137,0.01838378618992083,23523,0,0,0,0.0,0,9120,0,2151,412,0,11683,6969,0.08382677513567144,383665,215082,
2465,0.0,27,241,2224,2733,35836,42909,634583,0.03831224672260137,168583,1842,0.051400194328452505,19386,0,0,0,0,64137,0.01838378618992083,23523,0,0,0,0.0,0,9120,0,2151,412,0,11683,6969,0.08382677513567144,383665,215082,
2465,0.0,27,241,2224,2733,35836,42909,634583,0.03831224672260137,168583,1842,0.051400194328452505,19386,0,0,0,0,64137,0.01838378618992083,23523,0,0,0,0.0,0,9120,0,2151,412,0,11683,6969,0.08382677513567144,383665,215082,
2465,0.0,27,241,2224,2733,35836,42909,634583,0.03831224672260137,168583,1842,0.051400194328452505,19386,0,0,0,0,64137,0.01838378618992083,23523,0,0,0,0.0,0,9120,0,2151,412,0,11683,6969,0.08382677513567144,383665,215082,
2465,0.0,27,241,2224,2733,35836,42909,634583,0.03831224672260137,168583,1842,0.051400194328452505,19386,0,0,0,0,64137,0.01838378618992083,23523,0,0,0,0.0,0,9120,0,2151,412,0,11683,6969,0.08382677513567144,383665,215082,
2465,0.0,27,241,2224,2733,35836,42909,634583,0.03831224672260137,168583,1842,0.051400194328452505,19386,0,0,0,0,64137,0.01838378618992083,23523,0,0,0,0.0,0,9120,0,2151,412,0,11683,6969,0.08382677513567144,383665,215082,
2465,0.0,27,241,2224,2733,35836,42909,634583,0.03831224672260137,168583,1842,0.051400194328452505,19386,0,0,0,0,64137,0.01838378618992083,23523,0,0,0,0.0,0,9120,0,2151,412,0,11683,6969,0.08382677513567144,383665,215082,
2465,0.0,27,241,2224,2733,35836,42909,634583,0.03831224672260137,168583,1842,0.051400194328452505,19386,0,0,0,0,64137,0.01838378618992083,23523,0,0,0,0.0,0,9120,0,2151,412,0,11683,6969,0.08382677513567144,383665,215082,
2465,0.0,27,241,2224,2733,35836,42909,634583,0.03831224672260137,168583,1842,0.051400194328452505,19386,0,0,0,0,64137,0.01838378618992083,23523,0,0,0,0.0,0,9120,0,2151,412,0,11683,6969,0.08382677513567144,383665,215082,
2465,0.0,27,241,2224,2733,35836,42909,634583,0.03831224672260137,168583,1842,0.051400194328452505,19386,0,0,0,0,64137,0.01838378618992083,23523,0,0,0,0.0,0,9120,0,2151,412,0,11683,6969,0.08382677513567144,383665,215082,
2465,0.0,27,241,2224,2733,35836,42909,634583,0.03831224672260137,168583,1842,0.051400194328452505,19386,0,0,0,0,64137,0.01838378618992083,23523,0,0,0,0.0,0,9120,0,2151,412,0,11683,6969,0.08382677513567144,383665,215082,
2465,0.0,27,241,2224,2733,35836,42909,634583,0.03831224672260137,168583,1842,0.051400194328452505,19386,0,0,0,0,64137,0.01838378618992083,23523,0,0,0,0.0,0,9120,0,2151,412,0,11683,6969,0.08382677513567144,383665,215082,
2465,0.0,27,241,2224,2733,35836,42909,634583,0.03831224672260137,168583,1842,0.051400194328452505,19386,0,0,0,0,64137,0.01838378618992083,23523,0,0,0,0.0,0,9120,0,2151,412,0,11683,6969,0.08382677513567144,383665,215082,
2465,0.0,27,241,2224,2733,35836,42909,634583,0.03831224672260137,168583,1842,0.051400194328452505,19386,0,0,0,0,64137,0.01838378618992083,23523,0,0,0,0.0,0,9120,0,2151,412,0,11683,6969,0.08382677513567144,383665,215082,
2465,0.0,27,241,2224,2733,35836,42909,634583,0.03831224672260137,168583,1842,0.051400194328452505,19386,0,0,0,0,64137,0.01838378618992083,23523,0,0,0,0.0,0,9120,0,2151,412,0,11683,6969,0.08382677513567144,383665,215082,
2465,0.0,27,241,2224,2733,35836,42909,634583,0.03831224672260137,168583,1842,0.051400194328452505,19386,0,0,0,0,64137,0.01838378618992083,23523,0,0,0,0.0,0,9120,0,2151,412,0,11683,6969,0.08382677513567144,383665,215082,
2465,0.0,27,241,2224,2733,35836,42909,634583,0.03831224672260137,168583,1842,0.051400194328452505,19386,0,0,0,0,64137,0.01838378618992083,23523,0,0,0,0.0,0,9120,0,2151,412,0,11683,6969,0.08382677513567144,383665,215082,
2465,0.0,27,241,2224,2733,35836,42909,634583,0.03831224672260137,168583,1842,0.051400194328452505,19386,0,0,0,0,64137,0.01838378618992083,23523,0,0,0,0.0,0,9120,0,2151,412,0,11683,6969,0.08382677513567144,383665,215082,
2465,0.0,27,241,2224,2733,35836,42909,634583,0.03831224672260137,168583,1842,0.051400194328452505,19386,0,0,0,0,64137,0.01838378618992083,23523,0,0,0,0.0,0,9120,0,2151,412,0,11683,6969,0.08382677513567144,383665,215082,
2465,0.0,27,241,2224,2733,35836,42909,634583,0.03831224672260137,168583,1842,0.051400194328452505,19386,0,0,0,0,64137,0.01838378618992083,23523,0,0,0,0.0,0,9120,0,2151,412,0,11683,6969,0.08382677513567144,383665,215082,
2465,0.0,27,241,2224,2733,35836,42909,634583,0.03831224672260137,168583,1842,0.051400194328452505,19386,0,0,0,0,64137,0.01838378618992083,23523,0,0,0,0.0,0,9120,0,2151,412,0,11683,6969,0.08382677513567144,383665,215082,
2465,0.0,27,241,2224,2733,35836,42909,634583,0.03831224672260137,168583,1842,0.051400194328452505,19386,0,0,0,0,64137,0.01838378618992083,23523,0,0,0,0.0,0,9120,0,2151,412,0,11683,6969,0.08382677513567144,383665,215082,
2465,0.0,27,241,2224,2733,35836,42909,634583,0.03831224672260137,168583,1842,0.051400194328452505,19386,0,0,0,0,64137,0.01838378618992083,23523,0,0,0,0.0,0,9120,0,2151,412,0,11683,6969,0.08382677513567144,383665,215082,
2465,0.0,27,241,2224,2733,35836,42909,634583,0.03831224672260137,168583,1842,0.051400194328452505,19386,0,0,0,0,64137,0.01838378618992083,23523,0,0,0,0.0,0,9120,0,2151,412,0,11683,6969,0.08382677513567144,383665,215082,
2465,0.0,27,241,2224,2733,35836,42909,634583,0.03831224672260137,168583,1842,0.051400194328452505,19386,0,0,0,0,64137,0.01838378618992083,23523,0,0,0,0.0,0,9120,0,2151,412,0,11683,6969,0.08382677513567144,383665,215082,
2465,0.0,27,241,2224,2733,35836,42909,634583,0.03831224672260137,168583,1842,0.051400194328452505,19386,0,0,0,0,64137,0.01838378618992083,23523,0,0,0,0.0,0,9120,0,2151,412,0,11683,6969,0.08382677513567144,383665,215082,
2465,0.0,27,241,2224,2733,35836,42909,634583,0.03831224672260137,168583,1842,0.051400194328452505,19386,0,0,0,0,64137,0.01838378618992083,23523,0,0,0,0.0,0,9120,0,2151,412,0,11683,6969,0.08382677513567144,383665,215082,
2465,0.0,27,241,2224,2733,35836,42909,634583,0.03831224672260137,168583,1842,0.051400194328452505,19386,0,0,0,0,64137,0.01838378618992083,23523,0,0,0,0.0,0,9120,0,2151,412,0,11683,6969,0.08382677513567144,383665,215082,
2465,0.0,27,241,2224,2733,35836,42909,634583,0.03831224672260137,168583,1842,0.051400194328452505,19386,0,0,0,0,64137,0.01838378618992083,23523,0,0,0,0.0,0,9120,0,2151,412,0,11683,6969,0.08382677513567144,383665,215082,
2465,0.0,27,241,2224,2733,35836,42909,634583,0.03831224672260137,168583,1842,0.051400194328452505,19386,0,0,0,0,64137,0.01838378618992083,23523,0,0,0,0.0,0,9120,0,2151,412,0,11683,6969,0.08382677513567144,383665,215082,
2465,0.0,27,241,2224,2733,35836,42909,634583,0.03831224672260137,168583,1842,0.051400194328452505,19386,0,0,0,0,64137,0.01838378618992083,23523,0,0,0,0.0,0,9120,0,2151,412,0,11683,6969,0.08382677513567144,383665,215082,
2465,0.0,27,241,2224,2733,35836,42909,634583,0.03831224672260137,168583,1842,0.051400194328452505,19386,0,0,0,0,64137,0.01838378618992083,23523,0,0,0,0.0,0,9120,0,2151,412,0,11683,6969,0.08382677513567144,383665,215082,
2465,0.0,27,241,2224,2733,35836,42909,634583,0.03831224672260137,168583,1842,0.051400194328452505,19386,0,0,0,0,64137,0.01838378618992083,23523,0,0,0,0.0,0,9120,0,2151,412,0,11683,6969,0.08382677513567144,383665,215082,
2465,0.0,27,241,2224,2733,35836,42909,634583,0.03831224672260137,168583,1842,0.051400194328452505,19386,0,0,0,0,64137,0.01838378618992083,23523,0,0,0,0.0,0,9120,0,2151,412,0,11683,6969,0.08382677513567144,383665,215082,
2465,0.0,27,241,2224,2733,35836,42909,634583,0.03831224672260137,168583,1842,0.051400194328452505,19386,0,0,0,0,64137,0.01838378618992083,23523,0,0,0,0.0,0,9120,0,2151,412,0,11683,6969,0.08382677513567144,383665,215082,
2465,0.0,27,241,2224,2733,35836,42909,634583,0.03831224672260137,168583,1842,0.051400194328452505,19386,0,0,0,0,64137,0.01838378618992083,23523,0,0,0,0.0,0,9120,0,2151,412,0,11683,6969,0.08382677513567144,383665,215082,
2465,0.0,27,241,2224,2733,35836,42909,634583,0.03831224672260137,168583,1842,0.051400194328452505,19386,0,0,0,0,64137,0.01838378618992083,23523,0,0,0,0.0,0,9120,0,2151,412,0,11683,6969,0.08382677513567144,383665,215082,
2465,0.0,27,241,2224,2733,35836,42909,634583,0.03831224672260137,168583,1842,0.051400194328452505,19386,0,0,0,0,64137,0.01838378618992083,23523,0,0,0,0.0,0,9120,0,2151,412,0,11683,6969,0.08382677513567144,383665,215082,
2465,0.0,27,241,2224,2733,35836,42909,634583,0.03831224672260137,168583,1842,0.051400194328452505,19386,0,0,0,0,64137,0.01838378618992083,23523,0,0,0,0.0,0,9120,0,2151,412,0,11683,6969,0.08382677513567144,383665,215082,
2465,0.0,27,241,2224,2733,35836,42909,634583,0.03831224672260137,168583,1842,0.051400194328452505,19386,0,0,0,0,64137,0.01838378618992083,23523,0,0,0,0.0,0,9120,0,2151,412,0,11683,6969,0.08382677513567144,383665,215082,
2465,0.0,27,241,2224,2733,35836,42909,634583,0.03831224672260137,168583,1842,0.051400194328452505,19386,0,0,0,0,64137,0.01838378618992083,23523,0,0,0,0.0,0,9120,0,2151,412,0,11683,6969,0.08382677513567144,383665,215082,
2465,0.0,27,241,2224,2733,35836,42909,634583,0.03831224672260137,168583,1842,0.051400194328452505,19386,0,0,0,0,64137,0.01838378618992083,23523,0,0,0,0.0,0,9120,0,2151,412,0,11683,6969,0.08382677513567144,383665,215082,
2465,0.0,27,241,2224,2733,35836,42909,634583,0.03831224672260137,168583,1842,0.051400194328452505,19386,0,0,0,0,64137,0.01838378618992083,23523,0,0,0,0.0,0,9120,0,2151,412,0,11683,6969,0.08382677513567144,383665,215082,
2465,0.0,27,241,2224,2733,35836,42909,634583,0.03831224672260137,168583,1842,0.051400194328452505,19386,0,0,0,0,64137,0.01838378618992083,23523,0,0,0,0.0,0,9120,0,2151,412,0,11683,6969,0.08382677513567144,383665,215082,
2465,0.0,27,241,2224,2733,35836,42909,634583,0.03831224672260137,168583,1842,0.051400194328452505,19386,0,0,0,0,64137,0.01838378618992083,23523,0,0,0,0.0,0,9120,0,2151,412,0,11683,6969,0.08382677513567144,383665,215082,
2465,0.0,27,241,2224,2733,35836,42909,634583,0.03831224672260137,168583,1842,0.051400194328452505,19386,0,0,0,0,64137,0.01838378618992083,23523,0,0,0,0.0,0,9120,0,2151,412,0,11683,6969,0.08382677513567144,383665,215082,
2465,0.0,27,241,2224,2733,35836,42909,634583,0.03831224672260137,168583,1842,0.051400194328452505,19386,0,0,0,0,64137,0.01838378618992083,23523,0,0,0,0.0,0,9120,0,2151,412,0,11683,6969,0.08382677513567144,383665,215082,
2465,0.0,27,241,2224,2733,35836,42909,634583,0.03831224672260137,168583,1842,0.051400194328452505,19386,0,0,0,0,64137,0.01838378618992083,23523,0,0,0,0.0,0,9120,0,2151,412,0,11683,6969,0.08382677513567144,383665,215082,
2465,0.0,27,241,2224,2733,35836,42909,634583,0.03831224672260137,168583,1842,0.051400194328452505,19386,0,0,0,0,64137,0.01838378618992083,23523,0,0,0,0.0,0,9120,0,2151,412,0,11683,6969,0.08382677513567144,383665,215082,
2465,0.06957708049113233,27,241,2224,2733,35836,42909,634583,0.03831224672260137,168583,1842,0.051400194328452505,19386,124,19,10,153,64137,0.01838378618992083,23523,9,105,42,0.14541760749068547,51,9120,0,2151,412,33,11683,6969,0.08382677513567144,383665,215082,
2465,0.06957708049113233,27,241,2224,2733,35836,42909,634583,0.03831224672260137,168583,1842,0.051400194328452505,19386,124,19,10,153,64137,0.01838378618992083,23523,9,105,42,0.14541760749068547,51,9120,0,2151,412,33,11683,6969,0.08382677513567144,383665,215082,
2465,0.06957708049113233,27,241,2224,2733,35836,42909,634583,0.03831224672260137,168583,1842,0.051400194328452505,19386,124,19,10,153,64137,0.01838378618992083,23523,9,105,42,0.14541760749068547,51,9120,0,2151,412,33,11683,6969,0.08382677513567144,383665,215082,
2465,0.02258064516129032,27,241,2224,2733,35836,42909,634583,0.03831224672260137,168583,1842,0.051400194328452505,19386,107,0,0,107,64137,0.01838378618992083,23523,0,107,28,0.17937542896362388,28,9120,0,2151,412,28,11683,6969,0.08382677513567144,383665,215082,
2465,0.02258064516129032,27,241,2224,2733,35836,42909,634583,0.03831224672260137,168583,1842,0.051400194328452505,19386,107,0,0,107,64137,0.01838378618992083,23523,0,107,28,0.17937542896362388,28,9120,0,2151,412,28,11683,6969,0.08382677513567144,383665,215082,
2465,0.019109055501460567,27,241,2224,2733,35836,42909,634583,0.03831224672260137,168583,1842,0.051400194328452505,19386,574,302,72,948,64137,0.01838378618992083,23523,4,272,4,0.11127699946528642,8,9120,0,2151,412,0,11683,6969,0.08382677513567144,383665,215082,
2465,0.019886363636363636,27,241,2224,2733,35836,42909,634583,0.03831224672260137,168583,1842,0.051400194328452505,19386,38,35,0,73,64137,0.01838378618992083,23523,16,3,5,0.064640253639496,21,9120,0,2151,412,-11,11683,6969,0.08382677513567144,383665,215082,
2465,0.0,27,241,2224,2733,35836,42909,634583,0.03831224672260137,168583,1842,0.051400194328452505,19386,0,43,0,43,64137,0.01838378618992083,23523,0,-43,0,0.010396518375241779,0,9120,0,2151,412,0,11683,6969,0.08382677513567144,383665,215082,
1001,0.018604651162790697,9,55,946,1065,35836,42909,634583,0.04882613648474521,168583,1842,0.051400194328452505,19386,263,387,3,653,64137,0.01838378618992083,23523,0,-124,4,0.08768923702479402,4,3345,0,808,35,4,4188,2537,0.083320623442431,383665,215082,
1001,0.018604651162790697,9,55,946,1065,35836,42909,634583,0.04882613648474521,168583,1842,0.051400194328452505,19386,263,387,3,653,64137,0.01838378618992083,23523,0,-124,4,0.08768923702479402,4,3345,0,808,35,4,4188,2537,0.083320623442431,383665,215082,
1365,0.036966319005299446,135,1137,228,2637,35836,42909,634583,0.03532561387870077,168583,1842,0.051400194328452505,19386,363,408,11,782,64137,0.01838378618992083,23523,139,-45,69,0.07288707619094789,209,12833,1,8795,944,-70,22572,4038,0.057937499865417394,383665,215082,
1365,0.07022705809203438,135,1137,228,2637,35836,42909,634583,0.03532561387870077,168583,1842,0.051400194328452505,19386,615,354,25,994,64137,0.01838378618992083,23523,75,261,50,0.09095881669133331,125,12833,0,8795,944,-25,22572,4038,0.057937499865417394,383665,215082,
1365,0.11796610169491525,135,1137,228,2637,35836,42909,634583,0.03532561387870077,168583,1842,0.051400194328452505,19386,24,189,0,213,64137,0.01838378618992083,23523,174,-165,0,0.05666011698267091,174,12833,0,8795,944,-174,22572,4038,0.057937499865417394,383665,215082,
1365,0.11796610169491525,135,1137,228,2637,35836,42909,634583,0.03532561387870077,168583,1842,0.051400194328452505,19386,24,189,0,213,64137,0.01838378618992083,23523,174,-165,0,0.05666011698267091,174,12833,0,8795,944,-174,22572,4038,0.057937499865417394,383665,215082,
1365,0.0567647729865389,135,1137,228,2637,35836,42909,634583,0.03532561387870077,168583,1842,0.051400194328452505,19386,509,230,39,778,64137,0.01838378618992083,23523,37,279,19,0.07123148006405314,56,12833,0,8795,944,-18,22572,4038,0.057937499865417394,383665,215082,
1365,0.0567647729865389,135,1137,228,2637,35836,42909,634583,0.03532561387870077,168583,1842,0.051400194328452505,19386,509,230,39,778,64137,0.01838378618992083,23523,37,279,19,0.07123148006405314,56,12833,0,8795,944,-18,22572,4038,0.057937499865417394,383665,215082,
1365,0.0136986301369863,135,1137,228,2637,35836,42909,634583,0.03532561387870077,168583,1842,0.051400194328452505,19386,52,0,0,52,64137,0.01838378618992083,23523,0,52,3,0.0979273819829913,3,12833,0,8795,944,3,22572,4038,0.057937499865417394,383665,215082,
1365,0.0136986301369863,135,1137,228,2637,35836,42909,634583,0.03532561387870077,168583,1842,0.051400194328452505,19386,52,0,0,52,64137,0.01838378618992083,23523,0,52,3,0.0979273819829913,3,12833,0,8795,944,3,22572,4038,0.057937499865417394,383665,215082,
1365,0.0,135,1137,228,2637,35836,42909,634583,0.03532561387870077,168583,1842,0.051400194328452505,19386,0,67,0,67,64137,0.01838378618992083,23523,0,-67,0,0.09809663250366032,0,12833,0,8795,944,0,22572,4038,0.057937499865417394,383665,215082,
1365,0.0,135,1137,228,2637,35836,42909,634583,0.03532561387870077,168583,1842,0.051400194328452505,19386,0,67,0,67,64137,0.01838378618992083,23523,0,-67,0,0.09809663250366032,0,12833,0,8795,944,0,22572,4038,0.057937499865417394,383665,215082,
1365,0.0,135,1137,228,2637,35836,42909,634583,0.03532561387870077,168583,1842,0.051400194328452505,19386,103,15,7,125,64137,0.01838378618992083,23523,0,88,0,0.015333854706276422,0,12833,0,8795,944,0,22572,4038,0.057937499865417394,383665,215082,
1365,0.033357619176365094,135,1137,228,2637,35836,42909,634583,0.03532561387870077,168583,1842,0.051400194328452505,19386,1571,1077,175,2823,64137,0.01838378618992083,23523,338,494,250,0.07937040919068357,661,12833,73,8795,944,-88,22572,4038,0.057937499865417394,383665,215082,
1365,0.0,135,1137,228,2637,35836,42909,634583,0.03532561387870077,168583,1842,0.051400194328452505,19386,118,1,0,119,64137,0.01838378618992083,23523,0,117,0,0.13137905604719763,0,12833,0,8795,944,0,22572,4038,0.057937499865417394,383665,215082,
1365,0.09125543818295358,135,1137,228,2637,35836,42909,634583,0.03532561387870077,168583,1842,0.051400194328452505,19386,2803,2497,394,5694,64137,0.01838378618992083,23523,42,306,104,0.13181291574437787,151,12833,5,8795,944,62,22572,4038,0.057937499865417394,383665,215082,
1365,0.09125543818295358,135,1137,228,2637,35836,42909,634583,0.03532561387870077,168583,1842,0.051400194328452505,19386,2803,2497,394,5694,64137,0.01838378618992083,23523,42,306,104,0.13181291574437787,151,12833,5,8795,944,62,22572,4038,0.057937499865417394,383665,215082,
1365,0.09125543818295358,135,1137,228,2637,35836,42909,634583,0.03532561387870077,168583,1842,0.051400194328452505,19386,2803,2497,394,5694,64137,0.01838378618992083,23523,42,306,104,0.13181291574437787,151,12833,5,8795,944,62,22572,4038,0.057937499865417394,383665,215082,
1365,0.09125543818295358,135,1137,228,2637,35836,42909,634583,0.03532561387870077,168583,1842,0.051400194328452505,19386,2803,2497,394,5694,64137,0.01838378618992083,23523,42,306,104,0.13181291574437787,151,12833,5,8795,944,62,22572,4038,0.057937499865417394,383665,215082,
1365,0.09125543818295358,135,1137,228,2637,35836,42909,634583,0.03532561387870077,168583,1842,0.051400194328452505,19386,2803,2497,394,5694,64137,0.01838378618992083,23523,42,306,104,0.13181291574437787,151,12833,5,8795,944,62,22572,4038,0.057937499865417394,383665,215082,
1365,0.25146198830409355,135,1137,228,2637,35836,42909,634583,0.03532561387870077,168583,1842,0.051400194328452505,19386,781,812,10,1603,64137,0.01838378618992083,23523,12,-31,31,0.09676726654398769,43,12833,0,8795,944,19,22572,4038,0.057937499865417394,383665,215082,
1365,0.14864864864864866,135,1137,228,2637,35836,42909,634583,0.03532561387870077,168583,1842,0.051400194328452505,19386,35,8,1,44,64137,0.01838378618992083,23523,8,27,35,0.14864864864864866,44,12833,1,8795,944,27,22572,4038,0.057937499865417394,383665,215082,
1365,0.14864864864864866,135,1137,228,2637,35836,42909,634583,0.03532561387870077,168583,1842,0.051400194328452505,19386,35,8,1,44,64137,0.01838378618992083,23523,8,27,35,0.14864864864864866,44,12833,1,8795,944,27,22572,4038,0.057937499865417394,383665,215082,
1365,0.14864864864864866,135,1137,228,2637,35836,42909,634583,0.03532561387870077,168583,1842,0.051400194328452505,19386,35,8,1,44,64137,0.01838378618992083,23523,8,27,35,0.14864864864864866,44,12833,1,8795,944,27,22572,4038,0.057937499865417394,383665,215082,
537,0.019612135144557896,4,49,488,590,35836,42909,634583,0.04948083230041288,168583,1842,0.051400194328452505,19386,568,1,1,570,64137,0.01838378618992083,23523,1,567,56,0.02285396067472016,58,5912,1,67,4,55,5983,5845,0.04925466154376603,383665,215082,
537,0.0,4,49,488,590,35836,42909,634583,0.04948083230041288,168583,1842,0.051400194328452505,19386,51,0,0,51,64137,0.01838378618992083,23523,0,51,0,0.00283695833565111,0,5912,0,67,4,0,5983,5845,0.04925466154376603,383665,215082,
171,0.022374145431945307,7,45,126,223,35836,42909,634583,0.09603454552942758,168583,1842,0.051400194328452505,19386,157,18,0,175,64137,0.01838378618992083,23523,18,139,18,0.014183149794905274,36,861,0,46,7,0,914,815,0.09599289681357297,383665,215082,
171,0.022374145431945307,7,45,126,223,35836,42909,634583,0.09603454552942758,168583,1842,0.051400194328452505,19386,157,18,0,175,64137,0.01838378618992083,23523,18,139,18,0.014183149794905274,36,861,0,46,7,0,914,815,0.09599289681357297,383665,215082,
171,0.022374145431945307,7,45,126,223,35836,42909,634583,0.09603454552942758,168583,1842,0.051400194328452505,19386,157,18,0,175,64137,0.01838378618992083,23523,18,139,18,0.014183149794905274,36,861,0,46,7,0,914,815,0.09599289681357297,383665,215082,
2283,0.03250051330819024,1,130,2153,2414,35836,42909,634583,0.08678278456928315,168583,1842,0.051400194328452505,19386,405,34,1,440,64137,0.01838378618992083,23523,34,371,31,0.02652049585595719,66,7325,1,133,1,-3,7459,7192,0.06215498977086444,383665,215082,
2283,0.03250051330819024,1,130,2153,2414,35836,42909,634583,0.08678278456928315,168583,1842,0.051400194328452505,19386,405,34,1,440,64137,0.01838378618992083,23523,34,371,31,0.02652049585595719,66,7325,1,133,1,-3,7459,7192,0.06215498977086444,383665,215082,
2283,0.03250051330819024,1,130,2153,2414,35836,42909,634583,0.08678278456928315,168583,1842,0.051400194328452505,19386,405,34,1,440,64137,0.01838378618992083,23523,34,371,31,0.02652049585595719,66,7325,1,133,1,-3,7459,7192,0.06215498977086444,383665,215082,
4447,0.0,416,3015,1432,7878,35836,42909,634583,0.027744243162502492,168583,1842,0.051400194328452505,19386,2,598,1,601,64137,0.01838378618992083,23523,0,-596,0,0.0753643605585353,0,44687,0,29623,4562,0,78872,15064,0.06625303832127065,383665,215082,
4447,0.0,416,3015,1432,7878,35836,42909,634583,0.027744243162502492,168583,1842,0.051400194328452505,19386,643,1008,69,1720,64137,0.01838378618992083,23523,0,-365,0,0.2328511488941252,0,44687,0,29623,4562,0,78872,15064,0.06625303832127065,383665,215082,
4447,0.0,416,3015,1432,7878,35836,42909,634583,0.027744243162502492,168583,1842,0.051400194328452505,19386,643,1008,69,1720,64137,0.01838378618992083,23523,0,-365,0,0.2328511488941252,0,44687,0,29623,4562,0,78872,15064,0.06625303832127065,383665,215082,
4447,0.0,416,3015,1432,7878,35836,42909,634583,0.027744243162502492,168583,1842,0.051400194328452505,19386,643,1008,69,1720,64137,0.01838378618992083,23523,0,-365,0,0.2328511488941252,0,44687,0,29623,4562,0,78872,15064,0.06625303832127065,383665,215082,
4447,0.0,416,3015,1432,7878,35836,42909,634583,0.027744243162502492,168583,1842,0.051400194328452505,19386,643,1008,69,1720,64137,0.01838378618992083,23523,0,-365,0,0.2328511488941252,0,44687,0,29623,4562,0,78872,15064,0.06625303832127065,383665,215082,
4447,0.08,416,3015,1432,7878,35836,42909,634583,0.027744243162502492,168583,1842,0.051400194328452505,19386,580,93,37,710,64137,0.01838378618992083,23523,1,487,1,0.17557041620540872,2,44687,0,29623,4562,0,78872,15064,0.06625303832127065,383665,215082,
4447,0.041171791434460876,416,3015,1432,7878,35836,42909,634583,0.027744243162502492,168583,1842,0.051400194328452505,19386,559,177,75,811,64137,0.01838378618992083,23523,40,382,63,0.1352227257201658,103,44687,0,29623,4562,23,78872,15064,0.06625303832127065,383665,215082,
4447,0.041171791434460876,416,3015,1432,7878,35836,42909,634583,0.027744243162502492,168583,1842,0.051400194328452505,19386,559,177,75,811,64137,0.01838378618992083,23523,40,382,63,0.1352227257201658,103,44687,0,29623,4562,23,78872,15064,0.06625303832127065,383665,215082,
4447,0.0,416,3015,1432,7878,35836,42909,634583,0.027744243162502492,168583,1842,0.051400194328452505,19386,2,139,0,141,64137,0.01838378618992083,23523,0,-137,0,0.01871178810720268,0,44687,0,29623,4562,0,78872,15064,0.06625303832127065,383665,215082,
4447,0.0,416,3015,1432,7878,35836,42909,634583,0.027744243162502492,168583,1842,0.051400194328452505,19386,155,151,0,306,64137,0.01838378618992083,23523,0,4,0,0.09718216983476984,0,44687,0,29623,4562,0,78872,15064,0.06625303832127065,383665,215082,
4447,0.0,416,3015,1432,7878,35836,42909,634583,0.027744243162502492,168583,1842,0.051400194328452505,19386,3,3,0,6,64137,0.01838378618992083,23523,0,0,0,0.00452147701582517,0,44687,0,29623,4562,0,78872,15064,0.06625303832127065,383665,215082,
4447,0.0,416,3015,1432,7878,35836,42909,634583,0.027744243162502492,168583,1842,0.051400194328452505,19386,426,454,80,960,64137,0.01838378618992083,23523,0,-28,0,0.11534897404403903,0,44687,0,29623,4562,0,78872,15064,0.06625303832127065,383665,215082,
4447,0.0,416,3015,1432,7878,35836,42909,634583,0.027744243162502492,168583,1842,0.051400194328452505,19386,426,454,80,960,64137,0.01838378618992083,23523,0,-28,0,0.11534897404403903,0,44687,0,29623,4562,0,78872,15064,0.06625303832127065,383665,215082,
4447,0.16393922917328146,416,3015,1432,7878,35836,42909,634583,0.027744243162502492,168583,1842,0.051400194328452505,19386,6839,4920,1169,12928,64137,0.01838378618992083,23523,330,1919,224,0.18242148980652337,577,44687,23,29623,4562,-106,78872,15064,0.06625303832127065,383665,215082,
4447,0.16393922917328146,416,3015,1432,7878,35836,42909,634583,0.027744243162502492,168583,1842,0.051400194328452505,19386,6839,4920,1169,12928,64137,0.01838378618992083,23523,330,1919,224,0.18242148980652337,577,44687,23,29623,4562,-106,78872,15064,0.06625303832127065,383665,215082,
4447,0.16393922917328146,416,3015,1432,7878,35836,42909,634583,0.027744243162502492,168583,1842,0.051400194328452505,19386,6839,4920,1169,12928,64137,0.01838378618992083,23523,330,1919,224,0.18242148980652337,577,44687,23,29623,4562,-106,78872,15064,0.06625303832127065,383665,215082,
4447,0.16393922917328146,416,3015,1432,7878,35836,42909,634583,0.027744243162502492,168583,1842,0.051400194328452505,19386,6839,4920,1169,12928,64137,0.01838378618992083,23523,330,1919,224,0.18242148980652337,577,44687,23,29623,4562,-106,78872,15064,0.06625303832127065,383665,215082,
4447,0.16393922917328146,416,3015,1432,7878,35836,42909,634583,0.027744243162502492,168583,1842,0.051400194328452505,19386,6839,4920,1169,12928,64137,0.01838378618992083,23523,330,1919,224,0.18242148980652337,577,44687,23,29623,4562,-106,78872,15064,0.06625303832127065,383665,215082,
4447,0.16393922917328146,416,3015,1432,7878,35836,42909,634583,0.027744243162502492,168583,1842,0.051400194328452505,19386,6839,4920,1169,12928,64137,0.01838378618992083,23523,330,1919,224,0.18242148980652337,577,44687,23,29623,4562,-106,78872,15064,0.06625303832127065,383665,215082,
4447,0.16393922917328146,416,3015,1432,7878,35836,42909,634583,0.027744243162502492,168583,1842,0.051400194328452505,19386,6839,4920,1169,12928,64137,0.01838378618992083,23523,330,1919,224,0.18242148980652337,577,44687,23,29623,4562,-106,78872,15064,0.06625303832127065,383665,215082,
4447,0.16393922917328146,416,3015,1432,7878,35836,42909,634583,0.027744243162502492,168583,1842,0.051400194328452505,19386,6839,4920,1169,12928,64137,0.01838378618992083,23523,330,1919,224,0.18242148980652337,577,44687,23,29623,4562,-106,78872,15064,0.06625303832127065,383665,215082,
4447,0.16393922917328146,416,3015,1432,7878,35836,42909,634583,0.027744243162502492,168583,1842,0.051400194328452505,19386,6839,4920,1169,12928,64137,0.01838378618992083,23523,330,1919,224,0.18242148980652337,577,44687,23,29623,4562,-106,78872,15064,0.06625303832127065,383665,215082,
4447,0.0017495459470825165,416,3015,1432,7878,35836,42909,634583,0.027744243162502492,168583,1842,0.051400194328452505,19386,2376,1704,36,4116,64137,0.01838378618992083,23523,8,672,26,0.09987124140613782,34,44687,0,29623,4562,18,78872,15064,0.06625303832127065,383665,215082,
4447,0.0017495459470825165,416,3015,1432,7878,35836,42909,634583,0.027744243162502492,168583,1842,0.051400194328452505,19386,2376,1704,36,4116,64137,0.01838378618992083,23523,8,672,26,0.09987124140613782,34,44687,0,29623,4562,18,78872,15064,0.06625303832127065,383665,215082,
4447,0.0017495459470825165,416,3015,1432,7878,35836,42909,634583,0.027744243162502492,168583,1842,0.051400194328452505,19386,2376,1704,36,4116,64137,0.01838378618992083,23523,8,672,26,0.09987124140613782,34,44687,0,29623,4562,18,78872,15064,0.06625303832127065,383665,215082,
4447,0.0017495459470825165,416,3015,1432,7878,35836,42909,634583,0.027744243162502492,168583,1842,0.051400194328452505,19386,2376,1704,36,4116,64137,0.01838378618992083,23523,8,672,26,0.09987124140613782,34,44687,0,29623,4562,18,78872,15064,0.06625303832127065,383665,215082,
4447,0.0017495459470825165,416,3015,1432,7878,35836,42909,634583,0.027744243162502492,168583,1842,0.051400194328452505,19386,2376,1704,36,4116,64137,0.01838378618992083,23523,8,672,26,0.09987124140613782,34,44687,0,29623,4562,18,78872,15064,0.06625303832127065,383665,215082,
4447,0.0017495459470825165,416,3015,1432,7878,35836,42909,634583,0.027744243162502492,168583,1842,0.051400194328452505,19386,2376,1704,36,4116,64137,0.01838378618992083,23523,8,672,26,0.09987124140613782,34,44687,0,29623,4562,18,78872,15064,0.06625303832127065,383665,215082,
4447,0.0017495459470825165,416,3015,1432,7878,35836,42909,634583,0.027744243162502492,168583,1842,0.051400194328452505,19386,2376,1704,36,4116,64137,0.01838378618992083,23523,8,672,26,0.09987124140613782,34,44687,0,29623,4562,18,78872,15064,0.06625303832127065,383665,215082,
4447,0.0017495459470825165,416,3015,1432,7878,35836,42909,634583,0.027744243162502492,168583,1842,0.051400194328452505,19386,2376,1704,36,4116,64137,0.01838378618992083,23523,8,672,26,0.09987124140613782,34,44687,0,29623,4562,18,78872,15064,0.06625303832127065,383665,215082,
4447,0.0017495459470825165,416,3015,1432,7878,35836,42909,634583,0.027744243162502492,168583,1842,0.051400194328452505,19386,2376,1704,36,4116,64137,0.01838378618992083,23523,8,672,26,0.09987124140613782,34,44687,0,29623,4562,18,78872,15064,0.06625303832127065,383665,215082,
4447,0.0017495459470825165,416,3015,1432,7878,35836,42909,634583,0.027744243162502492,168583,1842,0.051400194328452505,19386,2376,1704,36,4116,64137,0.01838378618992083,23523,8,672,26,0.09987124140613782,34,44687,0,29623,4562,18,78872,15064,0.06625303832127065,383665,215082,
4447,0.0017495459470825165,416,3015,1432,7878,35836,42909,634583,0.027744243162502492,168583,1842,0.051400194328452505,19386,2376,1704,36,4116,64137,0.01838378618992083,23523,8,672,26,0.09987124140613782,34,44687,0,29623,4562,18,78872,15064,0.06625303832127065,383665,215082,
4447,0.0017495459470825165,416,3015,1432,7878,35836,42909,634583,0.027744243162502492,168583,1842,0.051400194328452505,19386,2376,1704,36,4116,64137,0.01838378618992083,23523,8,672,26,0.09987124140613782,34,44687,0,29623,4562,18,78872,15064,0.06625303832127065,383665,215082,
4447,0.0017495459470825165,416,3015,1432,7878,35836,42909,634583,0.027744243162502492,168583,1842,0.051400194328452505,19386,2376,1704,36,4116,64137,0.01838378618992083,23523,8,672,26,0.09987124140613782,34,44687,0,29623,4562,18,78872,15064,0.06625303832127065,383665,215082,
4447,0.0017495459470825165,416,3015,1432,7878,35836,42909,634583,0.027744243162502492,168583,1842,0.051400194328452505,19386,2376,1704,36,4116,64137,0.01838378618992083,23523,8,672,26,0.09987124140613782,34,44687,0,29623,4562,18,78872,15064,0.06625303832127065,383665,215082,
4447,0.0017495459470825165,416,3015,1432,7878,35836,42909,634583,0.027744243162502492,168583,1842,0.051400194328452505,19386,2376,1704,36,4116,64137,0.01838378618992083,23523,8,672,26,0.09987124140613782,34,44687,0,29623,4562,18,78872,15064,0.06625303832127065,383665,215082,
4447,0.0017495459470825165,416,3015,1432,7878,35836,42909,634583,0.027744243162502492,168583,1842,0.051400194328452505,19386,2376,1704,36,4116,64137,0.01838378618992083,23523,8,672,26,0.09987124140613782,34,44687,0,29623,4562,18,78872,15064,0.06625303832127065,383665,215082,
4447,0.0017495459470825165,416,3015,1432,7878,35836,42909,634583,0.027744243162502492,168583,1842,0.051400194328452505,19386,2376,1704,36,4116,64137,0.01838378618992083,23523,8,672,26,0.09987124140613782,34,44687,0,29623,4562,18,78872,15064,0.06625303832127065,383665,215082,
4447,0.0017495459470825165,416,3015,1432,7878,35836,42909,634583,0.027744243162502492,168583,1842,0.051400194328452505,19386,2376,1704,36,4116,64137,0.01838378618992083,23523,8,672,26,0.09987124140613782,34,44687,0,29623,4562,18,78872,15064,0.06625303832127065,383665,215082,
4447,0.0017495459470825165,416,3015,1432,7878,35836,42909,634583,0.027744243162502492,168583,1842,0.051400194328452505,19386,2376,1704,36,4116,64137,0.01838378618992083,23523,8,672,26,0.09987124140613782,34,44687,0,29623,4562,18,78872,15064,0.06625303832127065,383665,215082,
4447,0.0017495459470825165,416,3015,1432,7878,35836,42909,634583,0.027744243162502492,168583,1842,0.051400194328452505,19386,2376,1704,36,4116,64137,0.01838378618992083,23523,8,672,26,0.09987124140613782,34,44687,0,29623,4562,18,78872,15064,0.06625303832127065,383665,215082,
4447,0.0,416,3015,1432,7878,35836,42909,634583,0.027744243162502492,168583,1842,0.051400194328452505,19386,190,434,0,624,64137,0.01838378618992083,23523,0,-244,0,0.04347816437396483,0,44687,0,29623,4562,0,78872,15064,0.06625303832127065,383665,215082,
4447,0.2243689832473105,416,3015,1432,7878,35836,42909,634583,0.027744243162502492,168583,1842,0.051400194328452505,19386,451,809,6,1266,64137,0.01838378618992083,23523,481,-358,13,0.08332979295554929,496,44687,2,29623,4562,-468,78872,15064,0.06625303832127065,383665,215082,
4447,0.2243689832473105,416,3015,1432,7878,35836,42909,634583,0.027744243162502492,168583,1842,0.051400194328452505,19386,451,809,6,1266,64137,0.01838378618992083,23523,481,-358,13,0.08332979295554929,496,44687,2,29623,4562,-468,78872,15064,0.06625303832127065,383665,215082,
4447,0.006048292032629057,416,3015,1432,7878,35836,42909,634583,0.027744243162502492,168583,1842,0.051400194328452505,19386,378,303,38,719,64137,0.01838378618992083,23523,7,75,7,0.07302864961095608,14,44687,0,29623,4562,0,78872,15064,0.06625303832127065,383665,215082,
4447,0.003048780487804878,416,3015,1432,7878,35836,42909,634583,0.027744243162502492,168583,1842,0.051400194328452505,19386,38,42,19,99,64137,0.01838378618992083,23523,1,-4,1,0.0671509661964724,2,44687,0,29623,4562,0,78872,15064,0.06625303832127065,383665,215082,
4447,0.0606924198305372,416,3015,1432,7878,35836,42909,634583,0.027744243162502492,168583,1842,0.051400194328452505,19386,109,19,1,129,64137,0.01838378618992083,23523,5,90,26,0.1199301456536977,31,44687,0,29623,4562,21,78872,15064,0.06625303832127065,383665,215082,
4447,0.0606924198305372,416,3015,1432,7878,35836,42909,634583,0.027744243162502492,168583,1842,0.051400194328452505,19386,109,19,1,129,64137,0.01838378618992083,23523,5,90,26,0.1199301456536977,31,44687,0,29623,4562,21,78872,15064,0.06625303832127065,383665,215082,
4447,0.21679197994987467,416,3015,1432,7878,35836,42909,634583,0.027744243162502492,168583,1842,0.051400194328452505,19386,766,506,48,1320,64137,0.01838378618992083,23523,2,260,8,0.13327176230751156,10,44687,0,29623,4562,6,78872,15064,0.06625303832127065,383665,215082,
4447,0.21679197994987467,416,3015,1432,7878,35836,42909,634583,0.027744243162502492,168583,1842,0.051400194328452505,19386,766,506,48,1320,64137,0.01838378618992083,23523,2,260,8,0.13327176230751156,10,44687,0,29623,4562,6,78872,15064,0.06625303832127065,383665,215082,
4447,0.21679197994987467,416,3015,1432,7878,35836,42909,634583,0.027744243162502492,168583,1842,0.051400194328452505,19386,766,506,48,1320,64137,0.01838378618992083,23523,2,260,8,0.13327176230751156,10,44687,0,29623,4562,6,78872,15064,0.06625303832127065,383665,215082,
4447,0.0,416,3015,1432,7878,35836,42909,634583,0.027744243162502492,168583,1842,0.051400194328452505,19386,26,0,0,26,64137,0.01838378618992083,23523,0,26,0,0.3561643835616438,0,44687,0,29623,4562,0,78872,15064,0.06625303832127065,383665,215082,
4447,0.0,416,3015,1432,7878,35836,42909,634583,0.027744243162502492,168583,1842,0.051400194328452505,19386,160,83,6,249,64137,0.01838378618992083,23523,0,77,0,0.20887128720186238,0,44687,0,29623,4562,0,78872,15064,0.06625303832127065,383665,215082,
4447,0.0,416,3015,1432,7878,35836,42909,634583,0.027744243162502492,168583,1842,0.051400194328452505,19386,160,83,6,249,64137,0.01838378618992083,23523,0,77,0,0.20887128720186238,0,44687,0,29623,4562,0,78872,15064,0.06625303832127065,383665,215082,
4447,0.0029895366218236174,416,3015,1432,7878,35836,42909,634583,0.027744243162502492,168583,1842,0.051400194328452505,19386,79,46,2,127,64137,0.01838378618992083,23523,1,33,1,0.023875652158712107,2,44687,0,29623,4562,0,78872,15064,0.06625303832127065,383665,215082,
4447,0.1862115134758846,416,3015,1432,7878,35836,42909,634583,0.027744243162502492,168583,1842,0.051400194328452505,19386,658,426,86,1170,64137,0.01838378618992083,23523,93,232,163,0.20896676977304188,297,44687,41,29623,4562,70,78872,15064,0.06625303832127065,383665,215082,
4447,0.1862115134758846,416,3015,1432,7878,35836,42909,634583,0.027744243162502492,168583,1842,0.051400194328452505,19386,658,426,86,1170,64137,0.01838378618992083,23523,93,232,163,0.20896676977304188,297,44687,41,29623,4562,70,78872,15064,0.06625303832127065,383665,215082,
4447,0.1862115134758846,416,3015,1432,7878,35836,42909,634583,0.027744243162502492,168583,1842,0.051400194328452505,19386,658,426,86,1170,64137,0.01838378618992083,23523,93,232,163,0.20896676977304188,297,44687,41,29623,4562,70,78872,15064,0.06625303832127065,383665,215082,
4447,0.1862115134758846,416,3015,1432,7878,35836,42909,634583,0.027744243162502492,168583,1842,0.051400194328452505,19386,658,426,86,1170,64137,0.01838378618992083,23523,93,232,163,0.20896676977304188,297,44687,41,29623,4562,70,78872,15064,0.06625303832127065,383665,215082,
4447,0.04432285471765452,416,3015,1432,7878,35836,42909,634583,0.027744243162502492,168583,1842,0.051400194328452505,19386,465,80,8,553,64137,0.01838378618992083,23523,9,385,78,0.09135287279927887,93,44687,6,29623,4562,69,78872,15064,0.06625303832127065,383665,215082,
4447,0.04432285471765452,416,3015,1432,7878,35836,42909,634583,0.027744243162502492,168583,1842,0.051400194328452505,19386,465,80,8,553,64137,0.01838378618992083,23523,9,385,78,0.09135287279927887,93,44687,6,29623,4562,69,78872,15064,0.06625303832127065,383665,215082,
4447,0.04432285471765452,416,3015,1432,7878,35836,42909,634583,0.027744243162502492,168583,1842,0.051400194328452505,19386,465,80,8,553,64137,0.01838378618992083,23523,9,385,78,0.09135287279927887,93,44687,6,29623,4562,69,78872,15064,0.06625303832127065,383665,215082,
4447,0.04432285471765452,416,3015,1432,7878,35836,42909,634583,0.027744243162502492,168583,1842,0.051400194328452505,19386,465,80,8,553,64137,0.01838378618992083,23523,9,385,78,0.09135287279927887,93,44687,6,29623,4562,69,78872,15064,0.06625303832127065,383665,215082,
4447,0.04432285471765452,416,3015,1432,7878,35836,42909,634583,0.027744243162502492,168583,1842,0.051400194328452505,19386,465,80,8,553,64137,0.01838378618992083,23523,9,385,78,0.09135287279927887,93,44687,6,29623,4562,69,78872,15064,0.06625303832127065,383665,215082,
4447,0.04432285471765452,416,3015,1432,7878,35836,42909,634583,0.027744243162502492,168583,1842,0.051400194328452505,19386,465,80,8,553,64137,0.01838378618992083,23523,9,385,78,0.09135287279927887,93,44687,6,29623,4562,69,78872,15064,0.06625303832127065,383665,215082,
4447,0.04432285471765452,416,3015,1432,7878,35836,42909,634583,0.027744243162502492,168583,1842,0.051400194328452505,19386,465,80,8,553,64137,0.01838378618992083,23523,9,385,78,0.09135287279927887,93,44687,6,29623,4562,69,78872,15064,0.06625303832127065,383665,215082,
4447,0.04432285471765452,416,3015,1432,7878,35836,42909,634583,0.027744243162502492,168583,1842,0.051400194328452505,19386,465,80,8,553,64137,0.01838378618992083,23523,9,385,78,0.09135287279927887,93,44687,6,29623,4562,69,78872,15064,0.06625303832127065,383665,215082,
4447,0.04432285471765452,416,3015,1432,7878,35836,42909,634583,0.027744243162502492,168583,1842,0.051400194328452505,19386,465,80,8,553,64137,0.01838378618992083,23523,9,385,78,0.09135287279927887,93,44687,6,29623,4562,69,78872,15064,0.06625303832127065,383665,215082,
4447,0.04432285471765452,416,3015,1432,7878,35836,42909,634583,0.027744243162502492,168583,1842,0.051400194328452505,19386,465,80,8,553,64137,0.01838378618992083,23523,9,385,78,0.09135287279927887,93,44687,6,29623,4562,69,78872,15064,0.06625303832127065,383665,215082,
4447,0.04432285471765452,416,3015,1432,7878,35836,42909,634583,0.027744243162502492,168583,1842,0.051400194328452505,19386,465,80,8,553,64137,0.01838378618992083,23523,9,385,78,0.09135287279927887,93,44687,6,29623,4562,69,78872,15064,0.06625303832127065,383665,215082,
4447,0.02815281194442255,416,3015,1432,7878,35836,42909,634583,0.027744243162502492,168583,1842,0.051400194328452505,19386,1190,839,368,2397,64137,0.01838378618992083,23523,41,351,36,0.12178902277803925,78,44687,1,29623,4562,-5,78872,15064,0.06625303832127065,383665,215082,
4447,0.02815281194442255,416,3015,1432,7878,35836,42909,634583,0.027744243162502492,168583,1842,0.051400194328452505,19386,1190,839,368,2397,64137,0.01838378618992083,23523,41,351,36,0.12178902277803925,78,44687,1,29623,4562,-5,78872,15064,0.06625303832127065,383665,215082,
4447,0.02815281194442255,416,3015,1432,7878,35836,42909,634583,0.027744243162502492,168583,1842,0.051400194328452505,19386,1190,839,368,2397,64137,0.01838378618992083,23523,41,351,36,0.12178902277803925,78,44687,1,29623,4562,-5,78872,15064,0.06625303832127065,383665,215082,
4447,0.02815281194442255,416,3015,1432,7878,35836,42909,634583,0.027744243162502492,168583,1842,0.051400194328452505,19386,1190,839,368,2397,64137,0.01838378618992083,23523,41,351,36,0.12178902277803925,78,44687,1,29623,4562,-5,78872,15064,0.06625303832127065,383665,215082,
4447,0.08845758178249517,416,3015,1432,7878,35836,42909,634583,0.027744243162502492,168583,1842,0.051400194328452505,19386,704,124,10,838,64137,0.01838378618992083,23523,73,580,189,0.06996573351310262,266,44687,4,29623,4562,116,78872,15064,0.06625303832127065,383665,215082,
4447,0.0034227039361095267,416,3015,1432,7878,35836,42909,634583,0.027744243162502492,168583,1842,0.051400194328452505,19386,396,547,42,985,64137,0.01838378618992083,23523,3,-151,3,0.006753119603043637,6,44687,0,29623,4562,0,78872,15064,0.06625303832127065,383665,215082,
4447,0.0034227039361095267,416,3015,1432,7878,35836,42909,634583,0.027744243162502492,168583,1842,0.051400194328452505,19386,396,547,42,985,64137,0.01838378618992083,23523,3,-151,3,0.006753119603043637,6,44687,0,29623,4562,0,78872,15064,0.06625303832127065,383665,215082,
4447,0.0034227039361095267,416,3015,1432,7878,35836,42909,634583,0.027744243162502492,168583,1842,0.051400194328452505,19386,396,547,42,985,64137,0.01838378618992083,23523,3,-151,3,0.006753119603043637,6,44687,0,29623,4562,0,78872,15064,0.06625303832127065,383665,215082,
4447,0.0034227039361095267,416,3015,1432,7878,35836,42909,634583,0.027744243162502492,168583,1842,0.051400194328452505,19386,396,547,42,985,64137,0.01838378618992083,23523,3,-151,3,0.006753119603043637,6,44687,0,29623,4562,0,78872,15064,0.06625303832127065,383665,215082,
4447,0.0034227039361095267,416,3015,1432,7878,35836,42909,634583,0.027744243162502492,168583,1842,0.051400194328452505,19386,396,547,42,985,64137,0.01838378618992083,23523,3,-151,3,0.006753119603043637,6,44687,0,29623,4562,0,78872,15064,0.06625303832127065,383665,215082,
4447,0.0034227039361095267,416,3015,1432,7878,35836,42909,634583,0.027744243162502492,168583,1842,0.051400194328452505,19386,396,547,42,985,64137,0.01838378618992083,23523,3,-151,3,0.006753119603043637,6,44687,0,29623,4562,0,78872,15064,0.06625303832127065,383665,215082,
4447,0.0034227039361095267,416,3015,1432,7878,35836,42909,634583,0.027744243162502492,168583,1842,0.051400194328452505,19386,396,547,42,985,64137,0.01838378618992083,23523,3,-151,3,0.006753119603043637,6,44687,0,29623,4562,0,78872,15064,0.06625303832127065,383665,215082,
4447,0.0,416,3015,1432,7878,35836,42909,634583,0.027744243162502492,168583,1842,0.051400194328452505,19386,3,64,0,67,64137,0.01838378618992083,23523,0,-61,0,0.0016767716565400973,0,44687,0,29623,4562,0,78872,15064,0.06625303832127065,383665,215082,
4447,0.04230206770069424,416,3015,1432,7878,35836,42909,634583,0.027744243162502492,168583,1842,0.051400194328452505,19386,1896,922,206,3024,64137,0.01838378618992083,23523,26,974,23,0.08373948686990883,54,44687,5,29623,4562,-3,78872,15064,0.06625303832127065,383665,215082,
4447,0.0,416,3015,1432,7878,35836,42909,634583,0.027744243162502492,168583,1842,0.051400194328452505,19386,77,62,2,141,64137,0.01838378618992083,23523,0,15,0,0.008239910277157097,0,44687,0,29623,4562,0,78872,15064,0.06625303832127065,383665,215082,
4447,0.0,416,3015,1432,7878,35836,42909,634583,0.027744243162502492,168583,1842,0.051400194328452505,19386,77,62,2,141,64137,0.01838378618992083,23523,0,15,0,0.008239910277157097,0,44687,0,29623,4562,0,78872,15064,0.06625303832127065,383665,215082,
4447,0.0,416,3015,1432,7878,35836,42909,634583,0.027744243162502492,168583,1842,0.051400194328452505,19386,77,62,2,141,64137,0.01838378618992083,23523,0,15,0,0.008239910277157097,0,44687,0,29623,4562,0,78872,15064,0.06625303832127065,383665,215082,
4447,0.0,416,3015,1432,7878,35836,42909,634583,0.027744243162502492,168583,1842,0.051400194328452505,19386,4,152,0,156,64137,0.01838378618992083,23523,0,-148,0,0.050727137430827594,0,44687,0,29623,4562,0,78872,15064,0.06625303832127065,383665,215082,
4447,0.0,416,3015,1432,7878,35836,42909,634583,0.027744243162502492,168583,1842,0.051400194328452505,19386,139,156,0,295,64137,0.01838378618992083,23523,0,-17,0,0.030112096769095348,0,44687,0,29623,4562,0,78872,15064,0.06625303832127065,383665,215082,
4447,0.170128924546294,416,3015,1432,7878,35836,42909,634583,0.027744243162502492,168583,1842,0.051400194328452505,19386,854,188,98,1140,64137,0.01838378618992083,23523,74,666,173,0.07076529246727359,259,44687,12,29623,4562,99,78872,15064,0.06625303832127065,383665,215082,
4447,0.0022871832892365006,416,3015,1432,7878,35836,42909,634583,0.027744243162502492,168583,1842,0.051400194328452505,19386,254,204,7,465,64137,0.01838378618992083,23523,4,50,3,0.029745156450353246,7,44687,0,29623,4562,-1,78872,15064,0.06625303832127065,383665,215082,
4447,0.0022871832892365006,416,3015,1432,7878,35836,42909,634583,0.027744243162502492,168583,1842,0.051400194328452505,19386,254,204,7,465,64137,0.01838378618992083,23523,4,50,3,0.029745156450353246,7,44687,0,29623,4562,-1,78872,15064,0.06625303832127065,383665,215082,
4447,0.0,416,3015,1432,7878,35836,42909,634583,0.027744243162502492,168583,1842,0.051400194328452505,19386,49,86,4,139,64137,0.01838378618992083,23523,0,-37,0,0.009533511590815611,0,44687,0,29623,4562,0,78872,15064,0.06625303832127065,383665,215082,
4447,1.5955325089748703E-4,416,3015,1432,7878,35836,42909,634583,0.027744243162502492,168583,1842,0.051400194328452505,19386,190,111,1,302,64137,0.01838378618992083,23523,2,79,2,0.06257767219687095,4,44687,0,29623,4562,0,78872,15064,0.06625303832127065,383665,215082,
4447,1.5955325089748703E-4,416,3015,1432,7878,35836,42909,634583,0.027744243162502492,168583,1842,0.051400194328452505,19386,190,111,1,302,64137,0.01838378618992083,23523,2,79,2,0.06257767219687095,4,44687,0,29623,4562,0,78872,15064,0.06625303832127065,383665,215082,
4447,1.5955325089748703E-4,416,3015,1432,7878,35836,42909,634583,0.027744243162502492,168583,1842,0.051400194328452505,19386,190,111,1,302,64137,0.01838378618992083,23523,2,79,2,0.06257767219687095,4,44687,0,29623,4562,0,78872,15064,0.06625303832127065,383665,215082,
4447,1.5955325089748703E-4,416,3015,1432,7878,35836,42909,634583,0.027744243162502492,168583,1842,0.051400194328452505,19386,190,111,1,302,64137,0.01838378618992083,23523,2,79,2,0.06257767219687095,4,44687,0,29623,4562,0,78872,15064,0.06625303832127065,383665,215082,
4447,0.0,416,3015,1432,7878,35836,42909,634583,0.027744243162502492,168583,1842,0.051400194328452505,19386,144,10,1,155,64137,0.01838378618992083,23523,0,134,0,0.029382653765482974,0,44687,0,29623,4562,0,78872,15064,0.06625303832127065,383665,215082,
4447,0.005384803129964168,416,3015,1432,7878,35836,42909,634583,0.027744243162502492,168583,1842,0.051400194328452505,19386,235,68,4,307,64137,0.01838378618992083,23523,13,167,46,0.04822403108031826,59,44687,0,29623,4562,33,78872,15064,0.06625303832127065,383665,215082,
4447,0.005384803129964168,416,3015,1432,7878,35836,42909,634583,0.027744243162502492,168583,1842,0.051400194328452505,19386,235,68,4,307,64137,0.01838378618992083,23523,13,167,46,0.04822403108031826,59,44687,0,29623,4562,33,78872,15064,0.06625303832127065,383665,215082,
4447,0.005384803129964168,416,3015,1432,7878,35836,42909,634583,0.027744243162502492,168583,1842,0.051400194328452505,19386,235,68,4,307,64137,0.01838378618992083,23523,13,167,46,0.04822403108031826,59,44687,0,29623,4562,33,78872,15064,0.06625303832127065,383665,215082,
4447,0.0,416,3015,1432,7878,35836,42909,634583,0.027744243162502492,168583,1842,0.051400194328452505,19386,103,264,25,392,64137,0.01838378618992083,23523,0,-161,0,0.08469864409910545,0,44687,0,29623,4562,0,78872,15064,0.06625303832127065,383665,215082,
4447,0.0,416,3015,1432,7878,35836,42909,634583,0.027744243162502492,168583,1842,0.051400194328452505,19386,103,264,25,392,64137,0.01838378618992083,23523,0,-161,0,0.08469864409910545,0,44687,0,29623,4562,0,78872,15064,0.06625303832127065,383665,215082,
4447,0.0,416,3015,1432,7878,35836,42909,634583,0.027744243162502492,168583,1842,0.051400194328452505,19386,106,114,4,224,64137,0.01838378618992083,23523,0,-8,0,0.05350866841141993,0,44687,0,29623,4562,0,78872,15064,0.06625303832127065,383665,215082,
4447,0.0,416,3015,1432,7878,35836,42909,634583,0.027744243162502492,168583,1842,0.051400194328452505,19386,106,114,4,224,64137,0.01838378618992083,23523,0,-8,0,0.05350866841141993,0,44687,0,29623,4562,0,78872,15064,0.06625303832127065,383665,215082,
4447,0.0013607534541523322,416,3015,1432,7878,35836,42909,634583,0.027744243162502492,168583,1842,0.051400194328452505,19386,261,181,0,442,64137,0.01838378618992083,23523,28,80,19,0.02125980740633173,47,44687,0,29623,4562,-9,78872,15064,0.06625303832127065,383665,215082,
4447,0.03367174891388112,416,3015,1432,7878,35836,42909,634583,0.027744243162502492,168583,1842,0.051400194328452505,19386,563,106,50,719,64137,0.01838378618992083,23523,44,457,79,0.04478261079772937,155,44687,32,29623,4562,35,78872,15064,0.06625303832127065,383665,215082,
4447,0.0,416,3015,1432,7878,35836,42909,634583,0.027744243162502492,168583,1842,0.051400194328452505,19386,505,572,9,1086,64137,0.01838378618992083,23523,0,-67,0,0.050665720370538125,0,44687,0,29623,4562,0,78872,15064,0.06625303832127065,383665,215082,
4447,0.0,416,3015,1432,7878,35836,42909,634583,0.027744243162502492,168583,1842,0.051400194328452505,19386,505,572,9,1086,64137,0.01838378618992083,23523,0,-67,0,0.050665720370538125,0,44687,0,29623,4562,0,78872,15064,0.06625303832127065,383665,215082,
4447,0.0,416,3015,1432,7878,35836,42909,634583,0.027744243162502492,168583,1842,0.051400194328452505,19386,505,572,9,1086,64137,0.01838378618992083,23523,0,-67,0,0.050665720370538125,0,44687,0,29623,4562,0,78872,15064,0.06625303832127065,383665,215082,
4447,0.0,416,3015,1432,7878,35836,42909,634583,0.027744243162502492,168583,1842,0.051400194328452505,19386,505,572,9,1086,64137,0.01838378618992083,23523,0,-67,0,0.050665720370538125,0,44687,0,29623,4562,0,78872,15064,0.06625303832127065,383665,215082,
4447,0.0,416,3015,1432,7878,35836,42909,634583,0.027744243162502492,168583,1842,0.051400194328452505,19386,505,572,9,1086,64137,0.01838378618992083,23523,0,-67,0,0.050665720370538125,0,44687,0,29623,4562,0,78872,15064,0.06625303832127065,383665,215082,
4447,0.0,416,3015,1432,7878,35836,42909,634583,0.027744243162502492,168583,1842,0.051400194328452505,19386,247,197,8,452,64137,0.01838378618992083,23523,0,50,0,0.022471551197014234,0,44687,0,29623,4562,0,78872,15064,0.06625303832127065,383665,215082,
4447,0.0,416,3015,1432,7878,35836,42909,634583,0.027744243162502492,168583,1842,0.051400194328452505,19386,247,197,8,452,64137,0.01838378618992083,23523,0,50,0,0.022471551197014234,0,44687,0,29623,4562,0,78872,15064,0.06625303832127065,383665,215082,
4447,0.0021008403361344537,416,3015,1432,7878,35836,42909,634583,0.027744243162502492,168583,1842,0.051400194328452505,19386,261,315,94,670,64137,0.01838378618992083,23523,1,-54,1,0.03952870715682563,2,44687,0,29623,4562,0,78872,15064,0.06625303832127065,383665,215082,
4447,0.0021008403361344537,416,3015,1432,7878,35836,42909,634583,0.027744243162502492,168583,1842,0.051400194328452505,19386,261,315,94,670,64137,0.01838378618992083,23523,1,-54,1,0.03952870715682563,2,44687,0,29623,4562,0,78872,15064,0.06625303832127065,383665,215082,
4447,0.0,416,3015,1432,7878,35836,42909,634583,0.027744243162502492,168583,1842,0.051400194328452505,19386,498,500,2,1000,64137,0.01838378618992083,23523,0,-2,0,0.1278141235110874,0,44687,0,29623,4562,0,78872,15064,0.06625303832127065,383665,215082,
1494,0.09375,75,667,827,2236,35836,42909,634583,0.028000899175463834,168583,1842,0.051400194328452505,19386,291,446,31,768,64137,0.01838378618992083,23523,0,-155,3,0.07677623818442826,6,20753,3,11868,3736,3,36357,8885,0.08099588858691166,383665,215082,
4447,0.07520481310803892,416,3015,1432,7878,35836,42909,634583,0.027744243162502492,168583,1842,0.051400194328452505,19386,115,23,1,139,64137,0.01838378618992083,23523,6,92,46,0.0768116027722283,53,44687,1,29623,4562,40,78872,15064,0.06625303832127065,383665,215082,
4447,0.07520481310803892,416,3015,1432,7878,35836,42909,634583,0.027744243162502492,168583,1842,0.051400194328452505,19386,115,23,1,139,64137,0.01838378618992083,23523,6,92,46,0.0768116027722283,53,44687,1,29623,4562,40,78872,15064,0.06625303832127065,383665,215082,
872,0.10521739130434782,4,138,734,1014,35836,42909,634583,0.02817466944485037,168583,1842,0.051400194328452505,19386,130,6,0,136,64137,0.01838378618992083,23523,2,124,3,0.1291565286844614,5,3649,0,1549,508,1,5706,2100,0.040789375972902546,383665,215082,
872,0.16274539722202774,4,138,734,1014,35836,42909,634583,0.02817466944485037,168583,1842,0.051400194328452505,19386,444,648,140,1232,64137,0.01838378618992083,23523,20,-204,32,0.0949533995308115,55,3649,3,1549,508,12,5706,2100,0.040789375972902546,383665,215082,
872,0.16274539722202774,4,138,734,1014,35836,42909,634583,0.02817466944485037,168583,1842,0.051400194328452505,19386,444,648,140,1232,64137,0.01838378618992083,23523,20,-204,32,0.0949533995308115,55,3649,3,1549,508,12,5706,2100,0.040789375972902546,383665,215082,
872,0.16274539722202774,4,138,734,1014,35836,42909,634583,0.02817466944485037,168583,1842,0.051400194328452505,19386,444,648,140,1232,64137,0.01838378618992083,23523,20,-204,32,0.0949533995308115,55,3649,3,1549,508,12,5706,2100,0.040789375972902546,383665,215082,
872,0.16274539722202774,4,138,734,1014,35836,42909,634583,0.02817466944485037,168583,1842,0.051400194328452505,19386,444,648,140,1232,64137,0.01838378618992083,23523,20,-204,32,0.0949533995308115,55,3649,3,1549,508,12,5706,2100,0.040789375972902546,383665,215082,
872,0.13122935923691445,4,138,734,1014,35836,42909,634583,0.02817466944485037,168583,1842,0.051400194328452505,19386,174,30,4,208,64137,0.01838378618992083,23523,14,144,29,0.11223605610258992,43,3649,0,1549,508,15,5706,2100,0.040789375972902546,383665,215082,
872,0.0,4,138,734,1014,35836,42909,634583,0.02817466944485037,168583,1842,0.051400194328452505,19386,154,28,9,191,64137,0.01838378618992083,23523,0,126,0,0.096285100524729,0,3649,0,1549,508,0,5706,2100,0.040789375972902546,383665,215082,
872,0.09834193065297923,4,138,734,1014,35836,42909,634583,0.02817466944485037,168583,1842,0.051400194328452505,19386,270,213,8,491,64137,0.01838378618992083,23523,49,57,123,0.07703358662321934,173,3649,1,1549,508,74,5706,2100,0.040789375972902546,383665,215082,
872,0.09834193065297923,4,138,734,1014,35836,42909,634583,0.02817466944485037,168583,1842,0.051400194328452505,19386,270,213,8,491,64137,0.01838378618992083,23523,49,57,123,0.07703358662321934,173,3649,1,1549,508,74,5706,2100,0.040789375972902546,383665,215082,
872,0.09834193065297923,4,138,734,1014,35836,42909,634583,0.02817466944485037,168583,1842,0.051400194328452505,19386,270,213,8,491,64137,0.01838378618992083,23523,49,57,123,0.07703358662321934,173,3649,1,1549,508,74,5706,2100,0.040789375972902546,383665,215082,
872,0.009560229445506692,4,138,734,1014,35836,42909,634583,0.02817466944485037,168583,1842,0.051400194328452505,19386,631,378,283,1292,64137,0.01838378618992083,23523,5,253,5,0.08061419031048328,10,3649,0,1549,508,0,5706,2100,0.040789375972902546,383665,215082,
872,0.009560229445506692,4,138,734,1014,35836,42909,634583,0.02817466944485037,168583,1842,0.051400194328452505,19386,631,378,283,1292,64137,0.01838378618992083,23523,5,253,5,0.08061419031048328,10,3649,0,1549,508,0,5706,2100,0.040789375972902546,383665,215082,
872,0.02167368696604079,4,138,734,1014,35836,42909,634583,0.02817466944485037,168583,1842,0.051400194328452505,19386,73,36,40,149,64137,0.01838378618992083,23523,12,37,10,0.06715404634299757,22,3649,0,1549,508,-2,5706,2100,0.040789375972902546,383665,215082,
872,0.02167368696604079,4,138,734,1014,35836,42909,634583,0.02817466944485037,168583,1842,0.051400194328452505,19386,73,36,40,149,64137,0.01838378618992083,23523,12,37,10,0.06715404634299757,22,3649,0,1549,508,-2,5706,2100,0.040789375972902546,383665,215082,
872,0.02167368696604079,4,138,734,1014,35836,42909,634583,0.02817466944485037,168583,1842,0.051400194328452505,19386,73,36,40,149,64137,0.01838378618992083,23523,12,37,10,0.06715404634299757,22,3649,0,1549,508,-2,5706,2100,0.040789375972902546,383665,215082,
872,0.02167368696604079,4,138,734,1014,35836,42909,634583,0.02817466944485037,168583,1842,0.051400194328452505,19386,73,36,40,149,64137,0.01838378618992083,23523,12,37,10,0.06715404634299757,22,3649,0,1549,508,-2,5706,2100,0.040789375972902546,383665,215082,
872,0.02167368696604079,4,138,734,1014,35836,42909,634583,0.02817466944485037,168583,1842,0.051400194328452505,19386,73,36,40,149,64137,0.01838378618992083,23523,12,37,10,0.06715404634299757,22,3649,0,1549,508,-2,5706,2100,0.040789375972902546,383665,215082,
872,0.003462204270051933,4,138,734,1014,35836,42909,634583,0.02817466944485037,168583,1842,0.051400194328452505,19386,124,22,2,148,64137,0.01838378618992083,23523,3,102,3,0.018468350000711255,6,3649,0,1549,508,0,5706,2100,0.040789375972902546,383665,215082,
872,0.003462204270051933,4,138,734,1014,35836,42909,634583,0.02817466944485037,168583,1842,0.051400194328452505,19386,124,22,2,148,64137,0.01838378618992083,23523,3,102,3,0.018468350000711255,6,3649,0,1549,508,0,5706,2100,0.040789375972902546,383665,215082,
872,0.003462204270051933,4,138,734,1014,35836,42909,634583,0.02817466944485037,168583,1842,0.051400194328452505,19386,124,22,2,148,64137,0.01838378618992083,23523,3,102,3,0.018468350000711255,6,3649,0,1549,508,0,5706,2100,0.040789375972902546,383665,215082,
508,0.012408341349805393,31,398,110,937,35836,42909,634583,0.021652113550659418,168583,1842,0.051400194328452505,19386,233,55,41,329,64137,0.01838378618992083,23523,23,178,26,0.05309730333398643,49,9318,0,6138,1160,3,16616,3180,0.06895284306152513,383665,215082,
508,0.012408341349805393,31,398,110,937,35836,42909,634583,0.021652113550659418,168583,1842,0.051400194328452505,19386,233,55,41,329,64137,0.01838378618992083,23523,23,178,26,0.05309730333398643,49,9318,0,6138,1160,3,16616,3180,0.06895284306152513,383665,215082,
508,0.012408341349805393,31,398,110,937,35836,42909,634583,0.021652113550659418,168583,1842,0.051400194328452505,19386,233,55,41,329,64137,0.01838378618992083,23523,23,178,26,0.05309730333398643,49,9318,0,6138,1160,3,16616,3180,0.06895284306152513,383665,215082,
508,2.2071806945261918E-4,31,398,110,937,35836,42909,634583,0.021652113550659418,168583,1842,0.051400194328452505,19386,44,16,0,60,64137,0.01838378618992083,23523,2,28,1,0.0042058082648771655,3,9318,0,6138,1160,-1,16616,3180,0.06895284306152513,383665,215082,
508,2.2071806945261918E-4,31,398,110,937,35836,42909,634583,0.021652113550659418,168583,1842,0.051400194328452505,19386,44,16,0,60,64137,0.01838378618992083,23523,2,28,1,0.0042058082648771655,3,9318,0,6138,1160,-1,16616,3180,0.06895284306152513,383665,215082,
842,0.1754814842388477,36,739,103,1617,35836,42909,634583,0.09918009443655847,168583,1842,0.051400194328452505,19386,3566,2369,299,6234,64137,0.01838378618992083,23523,232,1197,218,0.1805553994154673,473,11420,23,7160,1945,-14,20525,4260,0.09379802968443353,383665,215082,
508,0.06496885036081418,31,398,110,937,35836,42909,634583,0.021652113550659418,168583,1842,0.051400194328452505,19386,1311,1210,388,2909,64137,0.01838378618992083,23523,71,101,41,0.11426122948046818,118,9318,6,6138,1160,-30,16616,3180,0.06895284306152513,383665,215082,
508,0.06496885036081418,31,398,110,937,35836,42909,634583,0.021652113550659418,168583,1842,0.051400194328452505,19386,1311,1210,388,2909,64137,0.01838378618992083,23523,71,101,41,0.11426122948046818,118,9318,6,6138,1160,-30,16616,3180,0.06895284306152513,383665,215082,
508,0.06496885036081418,31,398,110,937,35836,42909,634583,0.021652113550659418,168583,1842,0.051400194328452505,19386,1311,1210,388,2909,64137,0.01838378618992083,23523,71,101,41,0.11426122948046818,118,9318,6,6138,1160,-30,16616,3180,0.06895284306152513,383665,215082,
508,0.06496885036081418,31,398,110,937,35836,42909,634583,0.021652113550659418,168583,1842,0.051400194328452505,19386,1311,1210,388,2909,64137,0.01838378618992083,23523,71,101,41,0.11426122948046818,118,9318,6,6138,1160,-30,16616,3180,0.06895284306152513,383665,215082,
508,0.06496885036081418,31,398,110,937,35836,42909,634583,0.021652113550659418,168583,1842,0.051400194328452505,19386,1311,1210,388,2909,64137,0.01838378618992083,23523,71,101,41,0.11426122948046818,118,9318,6,6138,1160,-30,16616,3180,0.06895284306152513,383665,215082,
508,0.06496885036081418,31,398,110,937,35836,42909,634583,0.021652113550659418,168583,1842,0.051400194328452505,19386,1311,1210,388,2909,64137,0.01838378618992083,23523,71,101,41,0.11426122948046818,118,9318,6,6138,1160,-30,16616,3180,0.06895284306152513,383665,215082,
508,0.0869514472455649,31,398,110,937,35836,42909,634583,0.021652113550659418,168583,1842,0.051400194328452505,19386,496,327,194,1017,64137,0.01838378618992083,23523,6,169,14,0.08141414072950595,20,9318,0,6138,1160,8,16616,3180,0.06895284306152513,383665,215082,
508,0.004547936224220217,31,398,110,937,35836,42909,634583,0.021652113550659418,168583,1842,0.051400194328452505,19386,545,341,94,980,64137,0.01838378618992083,23523,28,204,12,0.08000470837241937,53,9318,13,6138,1160,-16,16616,3180,0.06895284306152513,383665,215082,
508,0.004547936224220217,31,398,110,937,35836,42909,634583,0.021652113550659418,168583,1842,0.051400194328452505,19386,545,341,94,980,64137,0.01838378618992083,23523,28,204,12,0.08000470837241937,53,9318,13,6138,1160,-16,16616,3180,0.06895284306152513,383665,215082,
508,0.046149738700760994,31,398,110,937,35836,42909,634583,0.021652113550659418,168583,1842,0.051400194328452505,19386,42,16,1,59,64137,0.01838378618992083,23523,11,26,17,0.08978269061016839,29,9318,1,6138,1160,6,16616,3180,0.06895284306152513,383665,215082,
508,0.011527430504485955,31,398,110,937,35836,42909,634583,0.021652113550659418,168583,1842,0.051400194328452505,19386,80,20,4,104,64137,0.01838378618992083,23523,6,60,6,0.09710154382833239,12,9318,0,6138,1160,0,16616,3180,0.06895284306152513,383665,215082,
508,0.0,31,398,110,937,35836,42909,634583,0.021652113550659418,168583,1842,0.051400194328452505,19386,459,469,32,960,64137,0.01838378618992083,23523,0,-10,0,0.07083727313455988,0,9318,0,6138,1160,0,16616,3180,0.06895284306152513,383665,215082,
508,0.01172771806682752,31,398,110,937,35836,42909,634583,0.021652113550659418,168583,1842,0.051400194328452505,19386,372,246,54,672,64137,0.01838378618992083,23523,2,126,6,0.10646205100285251,8,9318,0,6138,1160,4,16616,3180,0.06895284306152513,383665,215082,
508,0.01172771806682752,31,398,110,937,35836,42909,634583,0.021652113550659418,168583,1842,0.051400194328452505,19386,372,246,54,672,64137,0.01838378618992083,23523,2,126,6,0.10646205100285251,8,9318,0,6138,1160,4,16616,3180,0.06895284306152513,383665,215082,
508,0.09754691576836608,31,398,110,937,35836,42909,634583,0.021652113550659418,168583,1842,0.051400194328452505,19386,320,148,4,472,64137,0.01838378618992083,23523,18,172,16,0.05572750224784591,35,9318,1,6138,1160,-2,16616,3180,0.06895284306152513,383665,215082,
508,0.09754691576836608,31,398,110,937,35836,42909,634583,0.021652113550659418,168583,1842,0.051400194328452505,19386,320,148,4,472,64137,0.01838378618992083,23523,18,172,16,0.05572750224784591,35,9318,1,6138,1160,-2,16616,3180,0.06895284306152513,383665,215082,
508,0.09754691576836608,31,398,110,937,35836,42909,634583,0.021652113550659418,168583,1842,0.051400194328452505,19386,320,148,4,472,64137,0.01838378618992083,23523,18,172,16,0.05572750224784591,35,9318,1,6138,1160,-2,16616,3180,0.06895284306152513,383665,215082,
508,4.784688995215311E-4,31,398,110,937,35836,42909,634583,0.021652113550659418,168583,1842,0.051400194328452505,19386,16,31,6,53,64137,0.01838378618992083,23523,2,-15,1,0.02583698191186074,3,9318,0,6138,1160,-1,16616,3180,0.06895284306152513,383665,215082,
508,0.0,31,398,110,937,35836,42909,634583,0.021652113550659418,168583,1842,0.051400194328452505,19386,0,0,0,0,64137,0.01838378618992083,23523,0,0,0,0.0,0,9318,0,6138,1160,0,16616,3180,0.06895284306152513,383665,215082,
508,0.004895752895752895,31,398,110,937,35836,42909,634583,0.021652113550659418,168583,1842,0.051400194328452505,19386,9,10,0,19,64137,0.01838378618992083,23523,3,-1,6,0.039241347860154735,9,9318,0,6138,1160,3,16616,3180,0.06895284306152513,383665,215082,
508,0.09667307140136872,31,398,110,937,35836,42909,634583,0.021652113550659418,168583,1842,0.051400194328452505,19386,538,146,35,719,64137,0.01838378618992083,23523,32,392,40,0.07670214788959676,74,9318,2,6138,1160,8,16616,3180,0.06895284306152513,383665,215082,
508,0.09667307140136872,31,398,110,937,35836,42909,634583,0.021652113550659418,168583,1842,0.051400194328452505,19386,538,146,35,719,64137,0.01838378618992083,23523,32,392,40,0.07670214788959676,74,9318,2,6138,1160,8,16616,3180,0.06895284306152513,383665,215082,
508,0.09667307140136872,31,398,110,937,35836,42909,634583,0.021652113550659418,168583,1842,0.051400194328452505,19386,538,146,35,719,64137,0.01838378618992083,23523,32,392,40,0.07670214788959676,74,9318,2,6138,1160,8,16616,3180,0.06895284306152513,383665,215082,
508,0.09667307140136872,31,398,110,937,35836,42909,634583,0.021652113550659418,168583,1842,0.051400194328452505,19386,538,146,35,719,64137,0.01838378618992083,23523,32,392,40,0.07670214788959676,74,9318,2,6138,1160,8,16616,3180,0.06895284306152513,383665,215082,
508,0.025513080547017165,31,398,110,937,35836,42909,634583,0.021652113550659418,168583,1842,0.051400194328452505,19386,558,301,34,893,64137,0.01838378618992083,23523,14,257,12,0.13574560507629568,26,9318,0,6138,1160,-2,16616,3180,0.06895284306152513,383665,215082,
508,7.172572084349448E-4,31,398,110,937,35836,42909,634583,0.021652113550659418,168583,1842,0.051400194328452505,19386,117,125,0,242,64137,0.01838378618992083,23523,4,-8,1,0.046292071777490486,5,9318,0,6138,1160,-3,16616,3180,0.06895284306152513,383665,215082,
508,0.06730687153222364,31,398,110,937,35836,42909,634583,0.021652113550659418,168583,1842,0.051400194328452505,19386,314,319,5,638,64137,0.01838378618992083,23523,2,-5,2,0.15866174951879236,4,9318,0,6138,1160,0,16616,3180,0.06895284306152513,383665,215082,
0,0.0,0,0,0,0,35836,42909,634583,0.0,168583,1842,0.051400194328452505,19386,72,365,20,457,64137,0.01838378618992083,23523,0,-293,0,0.15711125988801194,0,1887,0,3302,32,0,5221,-1415,0.03837760873943936,383665,215082,
0,0.0,0,0,0,0,35836,42909,634583,0.0,168583,1842,0.051400194328452505,19386,72,365,20,457,64137,0.01838378618992083,23523,0,-293,0,0.15711125988801194,0,1887,0,3302,32,0,5221,-1415,0.03837760873943936,383665,215082,
0,0.0,0,0,0,0,35836,42909,634583,0.0,168583,1842,0.051400194328452505,19386,72,365,20,457,64137,0.01838378618992083,23523,0,-293,0,0.15711125988801194,0,1887,0,3302,32,0,5221,-1415,0.03837760873943936,383665,215082,
0,0.0,0,0,0,0,35836,42909,634583,0.0,168583,1842,0.051400194328452505,19386,72,365,20,457,64137,0.01838378618992083,23523,0,-293,0,0.15711125988801194,0,1887,0,3302,32,0,5221,-1415,0.03837760873943936,383665,215082,
0,0.0,0,0,0,0,35836,42909,634583,0.0,168583,1842,0.051400194328452505,19386,320,385,0,705,64137,0.01838378618992083,23523,0,-65,0,0.09648240242865258,0,1887,0,3302,32,0,5221,-1415,0.03837760873943936,383665,215082,
0,0.0,0,0,0,0,35836,42909,634583,0.0,168583,1842,0.051400194328452505,19386,68,174,6,248,64137,0.01838378618992083,23523,0,-106,0,0.07272559986443546,0,1887,0,3302,32,0,5221,-1415,0.03837760873943936,383665,215082,
0,0.0,0,0,0,0,35836,42909,634583,0.0,168583,1842,0.051400194328452505,19386,68,174,6,248,64137,0.01838378618992083,23523,0,-106,0,0.07272559986443546,0,1887,0,3302,32,0,5221,-1415,0.03837760873943936,383665,215082,
0,0.0,0,0,0,0,35836,42909,634583,0.0,168583,1842,0.051400194328452505,19386,122,139,0,261,64137,0.01838378618992083,23523,0,-17,0,0.007351393432889418,0,1887,0,3302,32,0,5221,-1415,0.03837760873943936,383665,215082,
0,0.0,0,0,0,0,35836,42909,634583,0.0,168583,1842,0.051400194328452505,19386,5,67,0,72,64137,0.01838378618992083,23523,0,-62,0,0.08760462755254732,0,1887,0,3302,32,0,5221,-1415,0.03837760873943936,383665,215082,
0,0.0,0,0,0,0,35836,42909,634583,0.0,168583,1842,0.051400194328452505,19386,229,266,0,495,64137,0.01838378618992083,23523,0,-37,0,0.08917179981183236,0,1887,0,3302,32,0,5221,-1415,0.03837760873943936,383665,215082,
0,0.0,0,0,0,0,35836,42909,634583,0.0,168583,1842,0.051400194328452505,19386,229,266,0,495,64137,0.01838378618992083,23523,0,-37,0,0.08917179981183236,0,1887,0,3302,32,0,5221,-1415,0.03837760873943936,383665,215082,
0,0.0,0,0,0,0,35836,42909,634583,0.0,168583,1842,0.051400194328452505,19386,23,134,1,158,64137,0.01838378618992083,23523,0,-111,0,0.026867342403928504,0,1887,0,3302,32,0,5221,-1415,0.03837760873943936,383665,215082,
0,0.0,0,0,0,0,35836,42909,634583,0.0,168583,1842,0.051400194328452505,19386,23,134,1,158,64137,0.01838378618992083,23523,0,-111,0,0.026867342403928504,0,1887,0,3302,32,0,5221,-1415,0.03837760873943936,383665,215082,
0,0.0,0,0,0,0,35836,42909,634583,0.0,168583,1842,0.051400194328452505,19386,58,58,0,116,64137,0.01838378618992083,23523,0,0,0,0.003138878459784811,0,1887,0,3302,32,0,5221,-1415,0.03837760873943936,383665,215082,
0,0.0,0,0,0,0,35836,42909,634583,0.0,168583,1842,0.051400194328452505,19386,1,73,0,74,64137,0.01838378618992083,23523,0,-72,0,0.0010632027881532142,0,1887,0,3302,32,0,5221,-1415,0.03837760873943936,383665,215082,
180,0.0,4,162,18,346,35836,42909,634583,0.023111225994100242,168583,1842,0.051400194328452505,19386,274,277,0,551,64137,0.01838378618992083,23523,0,-3,0,0.13430676211294001,0,2628,0,2264,74,0,4966,364,0.050610582430038895,383665,215082,
180,0.0,4,162,18,346,35836,42909,634583,0.023111225994100242,168583,1842,0.051400194328452505,19386,119,130,0,249,64137,0.01838378618992083,23523,0,-11,0,0.019416356646992313,0,2628,0,2264,74,0,4966,364,0.050610582430038895,383665,215082,
180,0.0,4,162,18,346,35836,42909,634583,0.023111225994100242,168583,1842,0.051400194328452505,19386,119,130,0,249,64137,0.01838378618992083,23523,0,-11,0,0.019416356646992313,0,2628,0,2264,74,0,4966,364,0.050610582430038895,383665,215082,
180,0.1702127659574468,4,162,18,346,35836,42909,634583,0.023111225994100242,168583,1842,0.051400194328452505,19386,483,225,28,736,64137,0.01838378618992083,23523,6,258,8,0.05827169203218484,16,2628,2,2264,74,2,4966,364,0.050610582430038895,383665,215082,
180,0.1702127659574468,4,162,18,346,35836,42909,634583,0.023111225994100242,168583,1842,0.051400194328452505,19386,483,225,28,736,64137,0.01838378618992083,23523,6,258,8,0.05827169203218484,16,2628,2,2264,74,2,4966,364,0.050610582430038895,383665,215082,
62,0.018433179723502304,1,968,-906,1031,35836,42909,634583,0.026333267111206985,168583,1842,0.051400194328452505,19386,205,254,1,460,64137,0.01838378618992083,23523,216,-49,0,0.055260739251108644,216,1323,0,1669,161,-216,3153,-346,0.0488189096944863,383665,215082,
62,0.018433179723502304,1,968,-906,1031,35836,42909,634583,0.026333267111206985,168583,1842,0.051400194328452505,19386,205,254,1,460,64137,0.01838378618992083,23523,216,-49,0,0.055260739251108644,216,1323,0,1669,161,-216,3153,-346,0.0488189096944863,383665,215082,
62,0.018433179723502304,1,968,-906,1031,35836,42909,634583,0.026333267111206985,168583,1842,0.051400194328452505,19386,205,254,1,460,64137,0.01838378618992083,23523,216,-49,0,0.055260739251108644,216,1323,0,1669,161,-216,3153,-346,0.0488189096944863,383665,215082,
62,0.018433179723502304,1,968,-906,1031,35836,42909,634583,0.026333267111206985,168583,1842,0.051400194328452505,19386,205,254,1,460,64137,0.01838378618992083,23523,216,-49,0,0.055260739251108644,216,1323,0,1669,161,-216,3153,-346,0.0488189096944863,383665,215082,
62,0.018433179723502304,1,968,-906,1031,35836,42909,634583,0.026333267111206985,168583,1842,0.051400194328452505,19386,205,254,1,460,64137,0.01838378618992083,23523,216,-49,0,0.055260739251108644,216,1323,0,1669,161,-216,3153,-346,0.0488189096944863,383665,215082,
62,0.018433179723502304,1,968,-906,1031,35836,42909,634583,0.026333267111206985,168583,1842,0.051400194328452505,19386,205,254,1,460,64137,0.01838378618992083,23523,216,-49,0,0.055260739251108644,216,1323,0,1669,161,-216,3153,-346,0.0488189096944863,383665,215082,
62,0.018433179723502304,1,968,-906,1031,35836,42909,634583,0.026333267111206985,168583,1842,0.051400194328452505,19386,205,254,1,460,64137,0.01838378618992083,23523,216,-49,0,0.055260739251108644,216,1323,0,1669,161,-216,3153,-346,0.0488189096944863,383665,215082,
29,0.0026903549586454866,4,420,-391,453,35836,42909,634583,0.010042513207589617,168583,1842,0.051400194328452505,19386,526,375,68,969,64137,0.01838378618992083,23523,33,151,9,0.06107225989874462,46,1066,4,1064,90,-24,2220,2,0.02142170512195268,383665,215082,
1339,0.0,15,97,1242,1451,35836,42909,634583,0.08120925474758037,168583,1842,0.051400194328452505,19386,0,0,0,0,64137,0.01838378618992083,23523,0,0,0,0.0,0,2428,0,135,15,0,2578,2293,0.08354850866973504,383665,215082,
278,0.05309734513274336,4,279,-1,561,35836,42909,634583,0.014472640900790142,168583,1842,0.051400194328452505,19386,330,40,0,370,64137,0.01838378618992083,23523,1,290,5,0.10866116943629087,6,5704,0,2903,227,4,8834,2801,0.04576198678055428,383665,215082,
278,0.03225806451612903,4,279,-1,561,35836,42909,634583,0.014472640900790142,168583,1842,0.051400194328452505,19386,100,61,4,165,64137,0.01838378618992083,23523,9,39,1,0.06046227387149002,10,5704,0,2903,227,-8,8834,2801,0.04576198678055428,383665,215082,
278,0.03225806451612903,4,279,-1,561,35836,42909,634583,0.014472640900790142,168583,1842,0.051400194328452505,19386,100,61,4,165,64137,0.01838378618992083,23523,9,39,1,0.06046227387149002,10,5704,0,2903,227,-8,8834,2801,0.04576198678055428,383665,215082,
278,0.012084592145015106,4,279,-1,561,35836,42909,634583,0.014472640900790142,168583,1842,0.051400194328452505,19386,25,47,0,72,64137,0.01838378618992083,23523,2,-22,2,0.04016127323217273,4,5704,0,2903,227,0,8834,2801,0.04576198678055428,383665,215082,
278,0.026525198938992044,4,279,-1,561,35836,42909,634583,0.014472640900790142,168583,1842,0.051400194328452505,19386,142,35,0,177,64137,0.01838378618992083,23523,9,107,1,0.040928718340388776,10,5704,0,2903,227,-8,8834,2801,0.04576198678055428,383665,215082,
278,0.025492784497337006,4,279,-1,561,35836,42909,634583,0.014472640900790142,168583,1842,0.051400194328452505,19386,88,98,27,213,64137,0.01838378618992083,23523,17,-10,3,0.05437853345842774,21,5704,1,2903,227,-14,8834,2801,0.04576198678055428,383665,215082,
278,0.025492784497337006,4,279,-1,561,35836,42909,634583,0.014472640900790142,168583,1842,0.051400194328452505,19386,88,98,27,213,64137,0.01838378618992083,23523,17,-10,3,0.05437853345842774,21,5704,1,2903,227,-14,8834,2801,0.04576198678055428,383665,215082,
278,0.025492784497337006,4,279,-1,561,35836,42909,634583,0.014472640900790142,168583,1842,0.051400194328452505,19386,88,98,27,213,64137,0.01838378618992083,23523,17,-10,3,0.05437853345842774,21,5704,1,2903,227,-14,8834,2801,0.04576198678055428,383665,215082,
278,0.025492784497337006,4,279,-1,561,35836,42909,634583,0.014472640900790142,168583,1842,0.051400194328452505,19386,88,98,27,213,64137,0.01838378618992083,23523,17,-10,3,0.05437853345842774,21,5704,1,2903,227,-14,8834,2801,0.04576198678055428,383665,215082,
278,0.0,4,279,-1,561,35836,42909,634583,0.014472640900790142,168583,1842,0.051400194328452505,19386,98,11,0,109,64137,0.01838378618992083,23523,0,87,0,0.024148000885323147,0,5704,0,2903,227,0,8834,2801,0.04576198678055428,383665,215082,
278,0.0,4,279,-1,561,35836,42909,634583,0.014472640900790142,168583,1842,0.051400194328452505,19386,98,11,0,109,64137,0.01838378618992083,23523,0,87,0,0.024148000885323147,0,5704,0,2903,227,0,8834,2801,0.04576198678055428,383665,215082,
278,0.0,4,279,-1,561,35836,42909,634583,0.014472640900790142,168583,1842,0.051400194328452505,19386,98,11,0,109,64137,0.01838378618992083,23523,0,87,0,0.024148000885323147,0,5704,0,2903,227,0,8834,2801,0.04576198678055428,383665,215082,
278,0.0,4,279,-1,561,35836,42909,634583,0.014472640900790142,168583,1842,0.051400194328452505,19386,98,11,0,109,64137,0.01838378618992083,23523,0,87,0,0.024148000885323147,0,5704,0,2903,227,0,8834,2801,0.04576198678055428,383665,215082,
278,0.007334963325183374,4,279,-1,561,35836,42909,634583,0.014472640900790142,168583,1842,0.051400194328452505,19386,16,4,0,20,64137,0.01838378618992083,23523,1,12,2,0.007437657340695665,3,5704,0,2903,227,1,8834,2801,0.04576198678055428,383665,215082,
278,0.07298835815784968,4,279,-1,561,35836,42909,634583,0.014472640900790142,168583,1842,0.051400194328452505,19386,497,80,21,598,64137,0.01838378618992083,23523,0,417,33,0.09454673278797704,33,5704,0,2903,227,33,8834,2801,0.04576198678055428,383665,215082,
278,3.572704537334762E-4,4,279,-1,561,35836,42909,634583,0.014472640900790142,168583,1842,0.051400194328452505,19386,94,41,2,137,64137,0.01838378618992083,23523,1,53,1,0.015699926886989755,2,5704,0,2903,227,0,8834,2801,0.04576198678055428,383665,215082,
278,3.572704537334762E-4,4,279,-1,561,35836,42909,634583,0.014472640900790142,168583,1842,0.051400194328452505,19386,94,41,2,137,64137,0.01838378618992083,23523,1,53,1,0.015699926886989755,2,5704,0,2903,227,0,8834,2801,0.04576198678055428,383665,215082,
278,0.02242152466367713,4,279,-1,561,35836,42909,634583,0.014472640900790142,168583,1842,0.051400194328452505,19386,146,73,6,225,64137,0.01838378618992083,23523,9,73,1,0.040684988602980275,10,5704,0,2903,227,-8,8834,2801,0.04576198678055428,383665,215082,
278,0.024742268041237112,4,279,-1,561,35836,42909,634583,0.014472640900790142,168583,1842,0.051400194328452505,19386,195,95,7,297,64137,0.01838378618992083,23523,11,100,1,0.08671097608927233,12,5704,0,2903,227,-10,8834,2801,0.04576198678055428,383665,215082,
278,0.007905138339920948,4,279,-1,561,35836,42909,634583,0.014472640900790142,168583,1842,0.051400194328452505,19386,106,36,1,143,64137,0.01838378618992083,23523,2,70,2,0.04891566750784072,4,5704,0,2903,227,0,8834,2801,0.04576198678055428,383665,215082,
278,0.007590132827324478,4,279,-1,561,35836,42909,634583,0.014472640900790142,168583,1842,0.051400194328452505,19386,11,54,4,69,64137,0.01838378618992083,23523,2,-43,2,0.016468761316958673,4,5704,0,2903,227,0,8834,2801,0.04576198678055428,383665,215082,
278,0.012612612612612612,4,279,-1,561,35836,42909,634583,0.014472640900790142,168583,1842,0.051400194328452505,19386,71,77,1,149,64137,0.01838378618992083,23523,5,-6,2,0.06844393204794987,7,5704,0,2903,227,-3,8834,2801,0.04576198678055428,383665,215082,
278,0.012612612612612612,4,279,-1,561,35836,42909,634583,0.014472640900790142,168583,1842,0.051400194328452505,19386,71,77,1,149,64137,0.01838378618992083,23523,5,-6,2,0.06844393204794987,7,5704,0,2903,227,-3,8834,2801,0.04576198678055428,383665,215082,
278,0.012612612612612612,4,279,-1,561,35836,42909,634583,0.014472640900790142,168583,1842,0.051400194328452505,19386,71,77,1,149,64137,0.01838378618992083,23523,5,-6,2,0.06844393204794987,7,5704,0,2903,227,-3,8834,2801,0.04576198678055428,383665,215082,
278,7.106057914372002E-4,4,279,-1,561,35836,42909,634583,0.014472640900790142,168583,1842,0.051400194328452505,19386,56,56,2,114,64137,0.01838378618992083,23523,2,0,2,0.046427219901208835,4,5704,0,2903,227,0,8834,2801,0.04576198678055428,383665,215082,
278,7.106057914372002E-4,4,279,-1,561,35836,42909,634583,0.014472640900790142,168583,1842,0.051400194328452505,19386,56,56,2,114,64137,0.01838378618992083,23523,2,0,2,0.046427219901208835,4,5704,0,2903,227,0,8834,2801,0.04576198678055428,383665,215082,
278,7.106057914372002E-4,4,279,-1,561,35836,42909,634583,0.014472640900790142,168583,1842,0.051400194328452505,19386,56,56,2,114,64137,0.01838378618992083,23523,2,0,2,0.046427219901208835,4,5704,0,2903,227,0,8834,2801,0.04576198678055428,383665,215082,
278,0.0070052539404553416,4,279,-1,561,35836,42909,634583,0.014472640900790142,168583,1842,0.051400194328452505,19386,60,3,0,63,64137,0.01838378618992083,23523,2,57,2,0.00694779582142451,4,5704,0,2903,227,0,8834,2801,0.04576198678055428,383665,215082,
278,0.006756756756756757,4,279,-1,561,35836,42909,634583,0.014472640900790142,168583,1842,0.051400194328452505,19386,25,37,11,73,64137,0.01838378618992083,23523,2,-12,2,0.01254690850946541,4,5704,0,2903,227,0,8834,2801,0.04576198678055428,383665,215082,
278,0.00967741935483871,4,279,-1,561,35836,42909,634583,0.014472640900790142,168583,1842,0.051400194328452505,19386,44,2,2,48,64137,0.01838378618992083,23523,2,42,2,0.012097610472441823,6,5704,2,2903,227,0,8834,2801,0.04576198678055428,383665,215082,
278,0.01529051987767584,4,279,-1,561,35836,42909,634583,0.014472640900790142,168583,1842,0.051400194328452505,19386,36,36,2,74,64137,0.01838378618992083,23523,9,0,1,0.011854250499985283,10,5704,0,2903,227,-8,8834,2801,0.04576198678055428,383665,215082,
278,0.0044444444444444444,4,279,-1,561,35836,42909,634583,0.014472640900790142,168583,1842,0.051400194328452505,19386,91,24,6,121,64137,0.01838378618992083,23523,1,67,2,0.008124572107449055,3,5704,0,2903,227,1,8834,2801,0.04576198678055428,383665,215082,
278,0.005747126436781609,4,279,-1,561,35836,42909,634583,0.014472640900790142,168583,1842,0.051400194328452505,19386,114,92,0,206,64137,0.01838378618992083,23523,2,22,2,0.025628712871003868,4,5704,0,2903,227,0,8834,2801,0.04576198678055428,383665,215082,
278,0.0041841004184100415,4,279,-1,561,35836,42909,634583,0.014472640900790142,168583,1842,0.051400194328452505,19386,86,41,4,131,64137,0.01838378618992083,23523,1,45,2,0.036272367442101626,3,5704,0,2903,227,1,8834,2801,0.04576198678055428,383665,215082,
278,0.056179775280898875,4,279,-1,561,35836,42909,634583,0.014472640900790142,168583,1842,0.051400194328452505,19386,149,210,10,369,64137,0.01838378618992083,23523,0,-61,5,0.04556155803710149,5,5704,0,2903,227,5,8834,2801,0.04576198678055428,383665,215082,
278,0.056179775280898875,4,279,-1,561,35836,42909,634583,0.014472640900790142,168583,1842,0.051400194328452505,19386,149,210,10,369,64137,0.01838378618992083,23523,0,-61,5,0.04556155803710149,5,5704,0,2903,227,5,8834,2801,0.04576198678055428,383665,215082,
278,0.056179775280898875,4,279,-1,561,35836,42909,634583,0.014472640900790142,168583,1842,0.051400194328452505,19386,149,210,10,369,64137,0.01838378618992083,23523,0,-61,5,0.04556155803710149,5,5704,0,2903,227,5,8834,2801,0.04576198678055428,383665,215082,
278,0.042875174674355324,4,279,-1,561,35836,42909,634583,0.014472640900790142,168583,1842,0.051400194328452505,19386,89,151,2,242,64137,0.01838378618992083,23523,136,-62,0,0.009902910065685179,136,5704,0,2903,227,-136,8834,2801,0.04576198678055428,383665,215082,
278,0.005263157894736842,4,279,-1,561,35836,42909,634583,0.014472640900790142,168583,1842,0.051400194328452505,19386,136,47,2,185,64137,0.01838378618992083,23523,2,89,2,0.02177407064542937,4,5704,0,2903,227,0,8834,2801,0.04576198678055428,383665,215082,
278,0.04990069513406157,4,279,-1,561,35836,42909,634583,0.014472640900790142,168583,1842,0.051400194328452505,19386,94,109,11,214,64137,0.01838378618992083,23523,1,-15,6,0.03683129996401236,7,5704,0,2903,227,5,8834,2801,0.04576198678055428,383665,215082,
278,0.04990069513406157,4,279,-1,561,35836,42909,634583,0.014472640900790142,168583,1842,0.051400194328452505,19386,94,109,11,214,64137,0.01838378618992083,23523,1,-15,6,0.03683129996401236,7,5704,0,2903,227,5,8834,2801,0.04576198678055428,383665,215082,
278,0.04990069513406157,4,279,-1,561,35836,42909,634583,0.014472640900790142,168583,1842,0.051400194328452505,19386,94,109,11,214,64137,0.01838378618992083,23523,1,-15,6,0.03683129996401236,7,5704,0,2903,227,5,8834,2801,0.04576198678055428,383665,215082,
278,0.01818770099615656,4,279,-1,561,35836,42909,634583,0.014472640900790142,168583,1842,0.051400194328452505,19386,47,57,0,104,64137,0.01838378618992083,23523,1,-10,6,0.06552124811663726,7,5704,0,2903,227,5,8834,2801,0.04576198678055428,383665,215082,
278,0.0,4,279,-1,561,35836,42909,634583,0.014472640900790142,168583,1842,0.051400194328452505,19386,49,22,5,76,64137,0.01838378618992083,23523,0,27,0,0.030520319908360263,0,5704,0,2903,227,0,8834,2801,0.04576198678055428,383665,215082,
278,0.03759345464804627,4,279,-1,561,35836,42909,634583,0.014472640900790142,168583,1842,0.051400194328452505,19386,159,65,10,234,64137,0.01838378618992083,23523,1,94,6,0.015527714065078175,7,5704,0,2903,227,5,8834,2801,0.04576198678055428,383665,215082,
278,0.03759345464804627,4,279,-1,561,35836,42909,634583,0.014472640900790142,168583,1842,0.051400194328452505,19386,159,65,10,234,64137,0.01838378618992083,23523,1,94,6,0.015527714065078175,7,5704,0,2903,227,5,8834,2801,0.04576198678055428,383665,215082,
278,0.003115264797507788,4,279,-1,561,35836,42909,634583,0.014472640900790142,168583,1842,0.051400194328452505,19386,205,170,12,387,64137,0.01838378618992083,23523,1,35,2,0.05529772817190136,3,5704,0,2903,227,1,8834,2801,0.04576198678055428,383665,215082,
278,0.0040650406504065045,4,279,-1,561,35836,42909,634583,0.014472640900790142,168583,1842,0.051400194328452505,19386,29,38,0,67,64137,0.01838378618992083,23523,2,-9,2,0.038075427979896825,4,5704,0,2903,227,0,8834,2801,0.04576198678055428,383665,215082,
278,0.058823529411764705,4,279,-1,561,35836,42909,634583,0.014472640900790142,168583,1842,0.051400194328452505,19386,275,3,0,278,64137,0.01838378618992083,23523,0,272,10,0.05180896098608868,10,5704,0,2903,227,10,8834,2801,0.04576198678055428,383665,215082,
278,0.00966183574879227,4,279,-1,561,35836,42909,634583,0.014472640900790142,168583,1842,0.051400194328452505,19386,234,198,11,443,64137,0.01838378618992083,23523,9,36,1,0.034340541317880446,10,5704,0,2903,227,-8,8834,2801,0.04576198678055428,383665,215082,
278,0.002840909090909091,4,279,-1,561,35836,42909,634583,0.014472640900790142,168583,1842,0.051400194328452505,19386,244,65,13,322,64137,0.01838378618992083,23523,1,179,2,0.07526772935203165,3,5704,0,2903,227,1,8834,2801,0.04576198678055428,383665,215082,
278,0.0,4,279,-1,561,35836,42909,634583,0.014472640900790142,168583,1842,0.051400194328452505,19386,167,12,2,181,64137,0.01838378618992083,23523,0,155,0,0.061274601738996466,0,5704,0,2903,227,0,8834,2801,0.04576198678055428,383665,215082,
278,0.0,4,279,-1,561,35836,42909,634583,0.014472640900790142,168583,1842,0.051400194328452505,19386,167,12,2,181,64137,0.01838378618992083,23523,0,155,0,0.061274601738996466,0,5704,0,2903,227,0,8834,2801,0.04576198678055428,383665,215082,
120,0.07787631136613922,3,360,-240,483,35836,42909,634583,0.0049520011837220195,168583,1842,0.051400194328452505,19386,279,136,19,434,64137,0.01838378618992083,23523,1,143,23,0.1471267883617998,24,4807,0,2470,339,22,7616,2337,0.04953383561652067,383665,215082,
120,0.0,3,360,-240,483,35836,42909,634583,0.0049520011837220195,168583,1842,0.051400194328452505,19386,225,195,1,421,64137,0.01838378618992083,23523,0,30,0,0.11484772397769075,0,4807,0,2470,339,0,7616,2337,0.04953383561652067,383665,215082,
120,0.0,3,360,-240,483,35836,42909,634583,0.0049520011837220195,168583,1842,0.051400194328452505,19386,225,195,1,421,64137,0.01838378618992083,23523,0,30,0,0.11484772397769075,0,4807,0,2470,339,0,7616,2337,0.04953383561652067,383665,215082,
120,0.0,3,360,-240,483,35836,42909,634583,0.0049520011837220195,168583,1842,0.051400194328452505,19386,225,195,1,421,64137,0.01838378618992083,23523,0,30,0,0.11484772397769075,0,4807,0,2470,339,0,7616,2337,0.04953383561652067,383665,215082,
120,0.0,3,360,-240,483,35836,42909,634583,0.0049520011837220195,168583,1842,0.051400194328452505,19386,225,195,1,421,64137,0.01838378618992083,23523,0,30,0,0.11484772397769075,0,4807,0,2470,339,0,7616,2337,0.04953383561652067,383665,215082,
120,0.0,3,360,-240,483,35836,42909,634583,0.0049520011837220195,168583,1842,0.051400194328452505,19386,225,195,1,421,64137,0.01838378618992083,23523,0,30,0,0.11484772397769075,0,4807,0,2470,339,0,7616,2337,0.04953383561652067,383665,215082,
120,0.0,3,360,-240,483,35836,42909,634583,0.0049520011837220195,168583,1842,0.051400194328452505,19386,225,195,1,421,64137,0.01838378618992083,23523,0,30,0,0.11484772397769075,0,4807,0,2470,339,0,7616,2337,0.04953383561652067,383665,215082,
120,0.002455327783979733,3,360,-240,483,35836,42909,634583,0.0049520011837220195,168583,1842,0.051400194328452505,19386,445,422,157,1024,64137,0.01838378618992083,23523,7,23,7,0.09987908108953118,15,4807,1,2470,339,0,7616,2337,0.04953383561652067,383665,215082,
120,0.002455327783979733,3,360,-240,483,35836,42909,634583,0.0049520011837220195,168583,1842,0.051400194328452505,19386,445,422,157,1024,64137,0.01838378618992083,23523,7,23,7,0.09987908108953118,15,4807,1,2470,339,0,7616,2337,0.04953383561652067,383665,215082,
120,0.002455327783979733,3,360,-240,483,35836,42909,634583,0.0049520011837220195,168583,1842,0.051400194328452505,19386,445,422,157,1024,64137,0.01838378618992083,23523,7,23,7,0.09987908108953118,15,4807,1,2470,339,0,7616,2337,0.04953383561652067,383665,215082,
120,0.0022021582217463245,3,360,-240,483,35836,42909,634583,0.0049520011837220195,168583,1842,0.051400194328452505,19386,199,119,16,334,64137,0.01838378618992083,23523,10,80,8,0.02814531534656207,20,4807,2,2470,339,-2,7616,2337,0.04953383561652067,383665,215082,
120,0.012903225806451613,3,360,-240,483,35836,42909,634583,0.0049520011837220195,168583,1842,0.051400194328452505,19386,115,39,58,212,64137,0.01838378618992083,23523,1,76,1,0.06406304133793023,2,4807,0,2470,339,0,7616,2337,0.04953383561652067,383665,215082,
120,0.012903225806451613,3,360,-240,483,35836,42909,634583,0.0049520011837220195,168583,1842,0.051400194328452505,19386,115,39,58,212,64137,0.01838378618992083,23523,1,76,1,0.06406304133793023,2,4807,0,2470,339,0,7616,2337,0.04953383561652067,383665,215082,
120,0.001198620226643979,3,360,-240,483,35836,42909,634583,0.0049520011837220195,168583,1842,0.051400194328452505,19386,227,11,1,239,64137,0.01838378618992083,23523,5,216,1,0.036764036366207876,6,4807,0,2470,339,-4,7616,2337,0.04953383561652067,383665,215082,
120,0.0,3,360,-240,483,35836,42909,634583,0.0049520011837220195,168583,1842,0.051400194328452505,19386,27,74,14,115,64137,0.01838378618992083,23523,0,-47,0,0.05258172577029906,0,4807,0,2470,339,0,7616,2337,0.04953383561652067,383665,215082,
120,0.0,3,360,-240,483,35836,42909,634583,0.0049520011837220195,168583,1842,0.051400194328452505,19386,27,74,14,115,64137,0.01838378618992083,23523,0,-47,0,0.05258172577029906,0,4807,0,2470,339,0,7616,2337,0.04953383561652067,383665,215082,
120,0.011904761904761904,3,360,-240,483,35836,42909,634583,0.0049520011837220195,168583,1842,0.051400194328452505,19386,25,8,0,33,64137,0.01838378618992083,23523,1,17,1,0.023378679032389275,2,4807,0,2470,339,0,7616,2337,0.04953383561652067,383665,215082,
120,0.011904761904761904,3,360,-240,483,35836,42909,634583,0.0049520011837220195,168583,1842,0.051400194328452505,19386,25,8,0,33,64137,0.01838378618992083,23523,1,17,1,0.023378679032389275,2,4807,0,2470,339,0,7616,2337,0.04953383561652067,383665,215082,
120,0.011049723756906077,3,360,-240,483,35836,42909,634583,0.0049520011837220195,168583,1842,0.051400194328452505,19386,96,14,0,110,64137,0.01838378618992083,23523,1,82,1,0.04593318047863939,2,4807,0,2470,339,0,7616,2337,0.04953383561652067,383665,215082,
120,0.011049723756906077,3,360,-240,483,35836,42909,634583,0.0049520011837220195,168583,1842,0.051400194328452505,19386,96,14,0,110,64137,0.01838378618992083,23523,1,82,1,0.04593318047863939,2,4807,0,2470,339,0,7616,2337,0.04953383561652067,383665,215082,
120,0.021803557285242657,3,360,-240,483,35836,42909,634583,0.0049520011837220195,168583,1842,0.051400194328452505,19386,29,211,7,247,64137,0.01838378618992083,23523,202,-182,4,0.015490811299266674,206,4807,0,2470,339,-198,7616,2337,0.04953383561652067,383665,215082,
120,0.021803557285242657,3,360,-240,483,35836,42909,634583,0.0049520011837220195,168583,1842,0.051400194328452505,19386,29,211,7,247,64137,0.01838378618992083,23523,202,-182,4,0.015490811299266674,206,4807,0,2470,339,-198,7616,2337,0.04953383561652067,383665,215082,
120,0.021803557285242657,3,360,-240,483,35836,42909,634583,0.0049520011837220195,168583,1842,0.051400194328452505,19386,29,211,7,247,64137,0.01838378618992083,23523,202,-182,4,0.015490811299266674,206,4807,0,2470,339,-198,7616,2337,0.04953383561652067,383665,215082,
120,0.021803557285242657,3,360,-240,483,35836,42909,634583,0.0049520011837220195,168583,1842,0.051400194328452505,19386,29,211,7,247,64137,0.01838378618992083,23523,202,-182,4,0.015490811299266674,206,4807,0,2470,339,-198,7616,2337,0.04953383561652067,383665,215082,
120,0.021803557285242657,3,360,-240,483,35836,42909,634583,0.0049520011837220195,168583,1842,0.051400194328452505,19386,29,211,7,247,64137,0.01838378618992083,23523,202,-182,4,0.015490811299266674,206,4807,0,2470,339,-198,7616,2337,0.04953383561652067,383665,215082,
120,0.021250890927923028,3,360,-240,483,35836,42909,634583,0.0049520011837220195,168583,1842,0.051400194328452505,19386,44,20,2,66,64137,0.01838378618992083,23523,5,24,24,0.010046181612088737,29,4807,0,2470,339,19,7616,2337,0.04953383561652067,383665,215082,
120,0.021250890927923028,3,360,-240,483,35836,42909,634583,0.0049520011837220195,168583,1842,0.051400194328452505,19386,44,20,2,66,64137,0.01838378618992083,23523,5,24,24,0.010046181612088737,29,4807,0,2470,339,19,7616,2337,0.04953383561652067,383665,215082,
278,0.04731423020883924,4,279,-1,561,35836,42909,634583,0.014472640900790142,168583,1842,0.051400194328452505,19386,325,157,20,502,64137,0.01838378618992083,23523,8,168,13,0.0513637846103653,22,5704,1,2903,227,5,8834,2801,0.04576198678055428,383665,215082,
120,0.002441406832076748,3,360,-240,483,35836,42909,634583,0.0049520011837220195,168583,1842,0.051400194328452505,19386,72,13,0,85,64137,0.01838378618992083,23523,0,59,10,0.07289075820451997,10,4807,0,2470,339,10,7616,2337,0.04953383561652067,383665,215082,
120,0.002441406832076748,3,360,-240,483,35836,42909,634583,0.0049520011837220195,168583,1842,0.051400194328452505,19386,72,13,0,85,64137,0.01838378618992083,23523,0,59,10,0.07289075820451997,10,4807,0,2470,339,10,7616,2337,0.04953383561652067,383665,215082,
120,0.002441406832076748,3,360,-240,483,35836,42909,634583,0.0049520011837220195,168583,1842,0.051400194328452505,19386,72,13,0,85,64137,0.01838378618992083,23523,0,59,10,0.07289075820451997,10,4807,0,2470,339,10,7616,2337,0.04953383561652067,383665,215082,
120,0.002441406832076748,3,360,-240,483,35836,42909,634583,0.0049520011837220195,168583,1842,0.051400194328452505,19386,72,13,0,85,64137,0.01838378618992083,23523,0,59,10,0.07289075820451997,10,4807,0,2470,339,10,7616,2337,0.04953383561652067,383665,215082,
120,0.002441406832076748,3,360,-240,483,35836,42909,634583,0.0049520011837220195,168583,1842,0.051400194328452505,19386,72,13,0,85,64137,0.01838378618992083,23523,0,59,10,0.07289075820451997,10,4807,0,2470,339,10,7616,2337,0.04953383561652067,383665,215082,
120,0.0014206397599655354,3,360,-240,483,35836,42909,634583,0.0049520011837220195,168583,1842,0.051400194328452505,19386,362,161,9,532,64137,0.01838378618992083,23523,1,201,9,0.05044827919336608,10,4807,0,2470,339,8,7616,2337,0.04953383561652067,383665,215082,
120,0.0014206397599655354,3,360,-240,483,35836,42909,634583,0.0049520011837220195,168583,1842,0.051400194328452505,19386,362,161,9,532,64137,0.01838378618992083,23523,1,201,9,0.05044827919336608,10,4807,0,2470,339,8,7616,2337,0.04953383561652067,383665,215082,
120,0.0014206397599655354,3,360,-240,483,35836,42909,634583,0.0049520011837220195,168583,1842,0.051400194328452505,19386,362,161,9,532,64137,0.01838378618992083,23523,1,201,9,0.05044827919336608,10,4807,0,2470,339,8,7616,2337,0.04953383561652067,383665,215082,
120,0.0014206397599655354,3,360,-240,483,35836,42909,634583,0.0049520011837220195,168583,1842,0.051400194328452505,19386,362,161,9,532,64137,0.01838378618992083,23523,1,201,9,0.05044827919336608,10,4807,0,2470,339,8,7616,2337,0.04953383561652067,383665,215082,
120,0.0014206397599655354,3,360,-240,483,35836,42909,634583,0.0049520011837220195,168583,1842,0.051400194328452505,19386,362,161,9,532,64137,0.01838378618992083,23523,1,201,9,0.05044827919336608,10,4807,0,2470,339,8,7616,2337,0.04953383561652067,383665,215082,
120,4.07996753005033E-4,3,360,-240,483,35836,42909,634583,0.0049520011837220195,168583,1842,0.051400194328452505,19386,84,37,1,122,64137,0.01838378618992083,23523,2,47,2,0.03637451209944168,4,4807,0,2470,339,0,7616,2337,0.04953383561652067,383665,215082,
120,0.0023900579074928774,3,360,-240,483,35836,42909,634583,0.0049520011837220195,168583,1842,0.051400194328452505,19386,428,124,4,556,64137,0.01838378618992083,23523,0,304,10,0.0764516833114365,10,4807,0,2470,339,10,7616,2337,0.04953383561652067,383665,215082,
120,0.0023900579074928774,3,360,-240,483,35836,42909,634583,0.0049520011837220195,168583,1842,0.051400194328452505,19386,428,124,4,556,64137,0.01838378618992083,23523,0,304,10,0.0764516833114365,10,4807,0,2470,339,10,7616,2337,0.04953383561652067,383665,215082,
120,0.0023900579074928774,3,360,-240,483,35836,42909,634583,0.0049520011837220195,168583,1842,0.051400194328452505,19386,428,124,4,556,64137,0.01838378618992083,23523,0,304,10,0.0764516833114365,10,4807,0,2470,339,10,7616,2337,0.04953383561652067,383665,215082,
120,0.0023900579074928774,3,360,-240,483,35836,42909,634583,0.0049520011837220195,168583,1842,0.051400194328452505,19386,428,124,4,556,64137,0.01838378618992083,23523,0,304,10,0.0764516833114365,10,4807,0,2470,339,10,7616,2337,0.04953383561652067,383665,215082,
120,0.0023900579074928774,3,360,-240,483,35836,42909,634583,0.0049520011837220195,168583,1842,0.051400194328452505,19386,428,124,4,556,64137,0.01838378618992083,23523,0,304,10,0.0764516833114365,10,4807,0,2470,339,10,7616,2337,0.04953383561652067,383665,215082,
120,0.0,3,360,-240,483,35836,42909,634583,0.0049520011837220195,168583,1842,0.051400194328452505,19386,665,297,39,1001,64137,0.01838378618992083,23523,0,368,0,0.12190167985323835,0,4807,0,2470,339,0,7616,2337,0.04953383561652067,383665,215082,
120,0.0,3,360,-240,483,35836,42909,634583,0.0049520011837220195,168583,1842,0.051400194328452505,19386,665,297,39,1001,64137,0.01838378618992083,23523,0,368,0,0.12190167985323835,0,4807,0,2470,339,0,7616,2337,0.04953383561652067,383665,215082,
1625,0.0,71,1084,541,2780,35836,42909,634583,0.025737096813503276,168583,1842,0.051400194328452505,19386,62,1,0,63,64137,0.01838378618992083,23523,0,61,0,0.12176986835689907,0,13305,0,5197,903,0,19405,8108,0.0738011731733765,383665,215082,
97,0.1258741258741259,13,80,17,190,35836,42909,634583,0.014722604709560865,168583,1842,0.051400194328452505,19386,118,15,0,133,64137,0.01838378618992083,23523,11,103,25,0.061404150672524735,36,1983,0,572,117,14,2672,1411,0.09737577693632579,383665,215082,
99,0.19569892473118278,3,69,30,171,35836,42909,634583,0.0175018782563609,168583,1842,0.051400194328452505,19386,768,102,26,896,64137,0.01838378618992083,23523,5,666,5,0.13111414879046354,10,4401,0,1399,416,0,6216,3002,0.05301814362406998,383665,215082,
99,7.952286282306163E-4,3,69,30,171,35836,42909,634583,0.0175018782563609,168583,1842,0.051400194328452505,19386,32,2,0,34,64137,0.01838378618992083,23523,1,30,1,0.20333328878894863,2,4401,0,1399,416,0,6216,3002,0.05301814362406998,383665,215082,
99,7.952286282306163E-4,3,69,30,171,35836,42909,634583,0.0175018782563609,168583,1842,0.051400194328452505,19386,32,2,0,34,64137,0.01838378618992083,23523,1,30,1,0.20333328878894863,2,4401,0,1399,416,0,6216,3002,0.05301814362406998,383665,215082,
99,0.19569892473118278,3,69,30,171,35836,42909,634583,0.0175018782563609,168583,1842,0.051400194328452505,19386,768,102,26,896,64137,0.01838378618992083,23523,5,666,5,0.13111414879046354,10,4401,0,1399,416,0,6216,3002,0.05301814362406998,383665,215082,
99,0.19569892473118278,3,69,30,171,35836,42909,634583,0.0175018782563609,168583,1842,0.051400194328452505,19386,768,102,26,896,64137,0.01838378618992083,23523,5,666,5,0.13111414879046354,10,4401,0,1399,416,0,6216,3002,0.05301814362406998,383665,215082,
99,0.0023192887514495554,3,69,30,171,35836,42909,634583,0.0175018782563609,168583,1842,0.051400194328452505,19386,190,30,2,222,64137,0.01838378618992083,23523,3,160,3,0.010422246512807737,6,4401,0,1399,416,0,6216,3002,0.05301814362406998,383665,215082,
99,0.2245280583146584,3,69,30,171,35836,42909,634583,0.0175018782563609,168583,1842,0.051400194328452505,19386,1879,637,119,2635,64137,0.01838378618992083,23523,34,1242,58,0.13415125652441304,95,4401,3,1399,416,24,6216,3002,0.05301814362406998,383665,215082,
99,0.2245280583146584,3,69,30,171,35836,42909,634583,0.0175018782563609,168583,1842,0.051400194328452505,19386,1879,637,119,2635,64137,0.01838378618992083,23523,34,1242,58,0.13415125652441304,95,4401,3,1399,416,24,6216,3002,0.05301814362406998,383665,215082,
99,0.2245280583146584,3,69,30,171,35836,42909,634583,0.0175018782563609,168583,1842,0.051400194328452505,19386,1879,637,119,2635,64137,0.01838378618992083,23523,34,1242,58,0.13415125652441304,95,4401,3,1399,416,24,6216,3002,0.05301814362406998,383665,215082,
99,0.2245280583146584,3,69,30,171,35836,42909,634583,0.0175018782563609,168583,1842,0.051400194328452505,19386,1879,637,119,2635,64137,0.01838378618992083,23523,34,1242,58,0.13415125652441304,95,4401,3,1399,416,24,6216,3002,0.05301814362406998,383665,215082,
99,0.0014414414414414415,3,69,30,171,35836,42909,634583,0.0175018782563609,168583,1842,0.051400194328452505,19386,119,89,11,219,64137,0.01838378618992083,23523,2,30,2,0.06375374193976772,4,4401,0,1399,416,0,6216,3002,0.05301814362406998,383665,215082,
51,0.12389380530973451,1,12,39,64,35836,42909,634583,0.037608096234617784,168583,1842,0.051400194328452505,19386,204,4,1,209,64137,0.01838378618992083,23523,1,200,12,0.1676704211511232,14,3885,1,2914,341,11,7140,971,0.14371219698255308,383665,215082,
51,0.0,1,12,39,64,35836,42909,634583,0.037608096234617784,168583,1842,0.051400194328452505,19386,410,569,71,1050,64137,0.01838378618992083,23523,0,-159,0,0.07956393737977611,0,3885,0,2914,341,0,7140,971,0.14371219698255308,383665,215082,
121,0.0,3,32,89,156,35836,42909,634583,0.10211785893459091,168583,1842,0.051400194328452505,19386,371,34,1,406,64137,0.01838378618992083,23523,0,337,0,0.07842961016545322,0,2106,0,517,48,0,2671,1589,0.13310219113334643,383665,215082,
51,0.0,1,12,39,64,35836,42909,634583,0.037608096234617784,168583,1842,0.051400194328452505,19386,451,466,32,949,64137,0.01838378618992083,23523,0,-15,0,0.12887113400065137,0,3885,0,2914,341,0,7140,971,0.14371219698255308,383665,215082,
51,0.004081632653061225,1,12,39,64,35836,42909,634583,0.037608096234617784,168583,1842,0.051400194328452505,19386,971,523,155,1649,64137,0.01838378618992083,23523,4,448,4,0.10689567960252953,8,3885,0,2914,341,0,7140,971,0.14371219698255308,383665,215082,
51,0.004081632653061225,1,12,39,64,35836,42909,634583,0.037608096234617784,168583,1842,0.051400194328452505,19386,971,523,155,1649,64137,0.01838378618992083,23523,4,448,4,0.10689567960252953,8,3885,0,2914,341,0,7140,971,0.14371219698255308,383665,215082,
51,0.0,1,12,39,64,35836,42909,634583,0.037608096234617784,168583,1842,0.051400194328452505,19386,59,15,0,74,64137,0.01838378618992083,23523,0,44,0,0.07212096331288963,0,3885,0,2914,341,0,7140,971,0.14371219698255308,383665,215082,
51,0.0,1,12,39,64,35836,42909,634583,0.037608096234617784,168583,1842,0.051400194328452505,19386,59,15,0,74,64137,0.01838378618992083,23523,0,44,0,0.07212096331288963,0,3885,0,2914,341,0,7140,971,0.14371219698255308,383665,215082,
51,0.0,1,12,39,64,35836,42909,634583,0.037608096234617784,168583,1842,0.051400194328452505,19386,263,8,0,271,64137,0.01838378618992083,23523,0,255,0,0.18890681951793062,0,3885,0,2914,341,0,7140,971,0.14371219698255308,383665,215082,
51,0.0,1,12,39,64,35836,42909,634583,0.037608096234617784,168583,1842,0.051400194328452505,19386,263,8,0,271,64137,0.01838378618992083,23523,0,255,0,0.18890681951793062,0,3885,0,2914,341,0,7140,971,0.14371219698255308,383665,215082,
121,0.0,3,32,89,156,35836,42909,634583,0.10211785893459091,168583,1842,0.051400194328452505,19386,981,113,14,1108,64137,0.01838378618992083,23523,0,868,0,0.20572891234665533,0,2106,0,517,48,0,2671,1589,0.13310219113334643,383665,215082,
121,0.0015105740181268882,3,32,89,156,35836,42909,634583,0.10211785893459091,168583,1842,0.051400194328452505,19386,107,245,2,354,64137,0.01838378618992083,23523,3,-138,3,0.10756786193883212,6,2106,0,517,48,0,2671,1589,0.13310219113334643,383665,215082,
121,0.0,3,32,89,156,35836,42909,634583,0.10211785893459091,168583,1842,0.051400194328452505,19386,371,34,1,406,64137,0.01838378618992083,23523,0,337,0,0.07842961016545322,0,2106,0,517,48,0,2671,1589,0.13310219113334643,383665,215082,
121,0.0,3,32,89,156,35836,42909,634583,0.10211785893459091,168583,1842,0.051400194328452505,19386,371,34,1,406,64137,0.01838378618992083,23523,0,337,0,0.07842961016545322,0,2106,0,517,48,0,2671,1589,0.13310219113334643,383665,215082,
121,0.0,3,32,89,156,35836,42909,634583,0.10211785893459091,168583,1842,0.051400194328452505,19386,371,34,1,406,64137,0.01838378618992083,23523,0,337,0,0.07842961016545322,0,2106,0,517,48,0,2671,1589,0.13310219113334643,383665,215082,
121,0.0,3,32,89,156,35836,42909,634583,0.10211785893459091,168583,1842,0.051400194328452505,19386,371,34,1,406,64137,0.01838378618992083,23523,0,337,0,0.07842961016545322,0,2106,0,517,48,0,2671,1589,0.13310219113334643,383665,215082,
121,0.0,3,32,89,156,35836,42909,634583,0.10211785893459091,168583,1842,0.051400194328452505,19386,371,34,1,406,64137,0.01838378618992083,23523,0,337,0,0.07842961016545322,0,2106,0,517,48,0,2671,1589,0.13310219113334643,383665,215082,
2,0.0,0,2,0,4,35836,42909,634583,4.8251379325919505E-4,168583,1842,0.051400194328452505,19386,953,892,24,1869,64137,0.01838378618992083,23523,0,61,0,0.21664518836013366,0,3867,0,3082,314,0,7263,785,0.17104282919406044,383665,215082,
2,0.0,0,2,0,4,35836,42909,634583,4.8251379325919505E-4,168583,1842,0.051400194328452505,19386,953,892,24,1869,64137,0.01838378618992083,23523,0,61,0,0.21664518836013366,0,3867,0,3082,314,0,7263,785,0.17104282919406044,383665,215082,
2,0.0,0,2,0,4,35836,42909,634583,4.8251379325919505E-4,168583,1842,0.051400194328452505,19386,953,892,24,1869,64137,0.01838378618992083,23523,0,61,0,0.21664518836013366,0,3867,0,3082,314,0,7263,785,0.17104282919406044,383665,215082,
2,0.0,0,2,0,4,35836,42909,634583,4.8251379325919505E-4,168583,1842,0.051400194328452505,19386,953,892,24,1869,64137,0.01838378618992083,23523,0,61,0,0.21664518836013366,0,3867,0,3082,314,0,7263,785,0.17104282919406044,383665,215082,
2,9.68054211035818E-4,0,2,0,4,35836,42909,634583,4.8251379325919505E-4,168583,1842,0.051400194328452505,19386,1315,1403,249,2967,64137,0.01838378618992083,23523,1,-88,1,0.1960180620613888,2,3867,0,3082,314,0,7263,785,0.17104282919406044,383665,215082,
2,9.68054211035818E-4,0,2,0,4,35836,42909,634583,4.8251379325919505E-4,168583,1842,0.051400194328452505,19386,1315,1403,249,2967,64137,0.01838378618992083,23523,1,-88,1,0.1960180620613888,2,3867,0,3082,314,0,7263,785,0.17104282919406044,383665,215082,
2,9.68054211035818E-4,0,2,0,4,35836,42909,634583,4.8251379325919505E-4,168583,1842,0.051400194328452505,19386,1315,1403,249,2967,64137,0.01838378618992083,23523,1,-88,1,0.1960180620613888,2,3867,0,3082,314,0,7263,785,0.17104282919406044,383665,215082,
2,9.62000962000962E-4,0,2,0,4,35836,42909,634583,4.8251379325919505E-4,168583,1842,0.051400194328452505,19386,1044,160,36,1240,64137,0.01838378618992083,23523,1,884,1,0.2028791237625682,2,3867,0,3082,314,0,7263,785,0.17104282919406044,383665,215082,
2,9.62000962000962E-4,0,2,0,4,35836,42909,634583,4.8251379325919505E-4,168583,1842,0.051400194328452505,19386,1044,160,36,1240,64137,0.01838378618992083,23523,1,884,1,0.2028791237625682,2,3867,0,3082,314,0,7263,785,0.17104282919406044,383665,215082,
2,9.62000962000962E-4,0,2,0,4,35836,42909,634583,4.8251379325919505E-4,168583,1842,0.051400194328452505,19386,1044,160,36,1240,64137,0.01838378618992083,23523,1,884,1,0.2028791237625682,2,3867,0,3082,314,0,7263,785,0.17104282919406044,383665,215082,
2,9.62000962000962E-4,0,2,0,4,35836,42909,634583,4.8251379325919505E-4,168583,1842,0.051400194328452505,19386,1044,160,36,1240,64137,0.01838378618992083,23523,1,884,1,0.2028791237625682,2,3867,0,3082,314,0,7263,785,0.17104282919406044,383665,215082,
2,9.62000962000962E-4,0,2,0,4,35836,42909,634583,4.8251379325919505E-4,168583,1842,0.051400194328452505,19386,1044,160,36,1240,64137,0.01838378618992083,23523,1,884,1,0.2028791237625682,2,3867,0,3082,314,0,7263,785,0.17104282919406044,383665,215082,
2,9.62000962000962E-4,0,2,0,4,35836,42909,634583,4.8251379325919505E-4,168583,1842,0.051400194328452505,19386,1044,160,36,1240,64137,0.01838378618992083,23523,1,884,1,0.2028791237625682,2,3867,0,3082,314,0,7263,785,0.17104282919406044,383665,215082,
2,9.62000962000962E-4,0,2,0,4,35836,42909,634583,4.8251379325919505E-4,168583,1842,0.051400194328452505,19386,1044,160,36,1240,64137,0.01838378618992083,23523,1,884,1,0.2028791237625682,2,3867,0,3082,314,0,7263,785,0.17104282919406044,383665,215082,
2,9.62000962000962E-4,0,2,0,4,35836,42909,634583,4.8251379325919505E-4,168583,1842,0.051400194328452505,19386,1044,160,36,1240,64137,0.01838378618992083,23523,1,884,1,0.2028791237625682,2,3867,0,3082,314,0,7263,785,0.17104282919406044,383665,215082,
2,9.62000962000962E-4,0,2,0,4,35836,42909,634583,4.8251379325919505E-4,168583,1842,0.051400194328452505,19386,1044,160,36,1240,64137,0.01838378618992083,23523,1,884,1,0.2028791237625682,2,3867,0,3082,314,0,7263,785,0.17104282919406044,383665,215082,
0,0.0,0,0,0,0,35836,42909,634583,0.0,168583,1842,0.051400194328452505,19386,0,0,0,0,64137,0.01838378618992083,23523,0,0,0,0.0,0,0,0,0,0,0,0,0,0.0,383665,215082,
0,0.0,0,0,0,0,35836,42909,634583,0.0,168583,1842,0.051400194328452505,19386,0,0,0,0,64137,0.01838378618992083,23523,0,0,0,0.0,0,0,0,0,0,0,0,0,0.0,383665,215082,
0,0.0,0,0,0,0,35836,42909,634583,0.0,168583,1842,0.051400194328452505,19386,0,0,0,0,64137,0.01838378618992083,23523,0,0,0,0.0,0,0,0,0,0,0,0,0,0.0,383665,215082,
0,0.0,0,0,0,0,35836,42909,634583,0.0,168583,1842,0.051400194328452505,19386,0,0,0,0,64137,0.01838378618992083,23523,0,0,0,0.0,0,0,0,0,0,0,0,0,0.0,383665,215082,
0,0.0,0,0,0,0,35836,42909,634583,0.0,168583,1842,0.051400194328452505,19386,0,0,0,0,64137,0.01838378618992083,23523,0,0,0,0.0,0,0,0,0,0,0,0,0,0.0,383665,215082,
0,0.0,0,0,0,0,35836,42909,634583,0.0,168583,1842,0.051400194328452505,19386,0,0,0,0,64137,0.01838378618992083,23523,0,0,0,0.0,0,0,0,0,0,0,0,0,0.0,383665,215082,
0,0.0,0,0,0,0,35836,42909,634583,0.0,168583,1842,0.051400194328452505,19386,0,0,0,0,64137,0.01838378618992083,23523,0,0,0,0.0,0,0,0,0,0,0,0,0,0.0,383665,215082,
0,0.0,0,0,0,0,35836,42909,634583,0.0,168583,1842,0.051400194328452505,19386,0,0,0,0,64137,0.01838378618992083,23523,0,0,0,0.0,0,0,0,0,0,0,0,0,0.0,383665,215082,
0,0.0,0,0,0,0,35836,42909,634583,0.0,168583,1842,0.051400194328452505,19386,0,0,0,0,64137,0.01838378618992083,23523,0,0,0,0.0,0,0,0,0,0,0,0,0,0.0,383665,215082,
172,0.013423692802622518,81,605,-433,858,35836,42909,634583,0.017600359751189565,168583,1842,0.051400194328452505,19386,257,82,64,403,64137,0.01838378618992083,23523,41,175,69,0.07068477906097048,170,2156,60,1275,219,28,3650,881,0.09403515396438712,383665,215082,
172,0.013423692802622518,81,605,-433,858,35836,42909,634583,0.017600359751189565,168583,1842,0.051400194328452505,19386,257,82,64,403,64137,0.01838378618992083,23523,41,175,69,0.07068477906097048,170,2156,60,1275,219,28,3650,881,0.09403515396438712,383665,215082,
172,0.013423692802622518,81,605,-433,858,35836,42909,634583,0.017600359751189565,168583,1842,0.051400194328452505,19386,257,82,64,403,64137,0.01838378618992083,23523,41,175,69,0.07068477906097048,170,2156,60,1275,219,28,3650,881,0.09403515396438712,383665,215082,
172,0.013423692802622518,81,605,-433,858,35836,42909,634583,0.017600359751189565,168583,1842,0.051400194328452505,19386,257,82,64,403,64137,0.01838378618992083,23523,41,175,69,0.07068477906097048,170,2156,60,1275,219,28,3650,881,0.09403515396438712,383665,215082,
172,0.013423692802622518,81,605,-433,858,35836,42909,634583,0.017600359751189565,168583,1842,0.051400194328452505,19386,257,82,64,403,64137,0.01838378618992083,23523,41,175,69,0.07068477906097048,170,2156,60,1275,219,28,3650,881,0.09403515396438712,383665,215082,
172,0.013423692802622518,81,605,-433,858,35836,42909,634583,0.017600359751189565,168583,1842,0.051400194328452505,19386,257,82,64,403,64137,0.01838378618992083,23523,41,175,69,0.07068477906097048,170,2156,60,1275,219,28,3650,881,0.09403515396438712,383665,215082,
172,0.013423692802622518,81,605,-433,858,35836,42909,634583,0.017600359751189565,168583,1842,0.051400194328452505,19386,257,82,64,403,64137,0.01838378618992083,23523,41,175,69,0.07068477906097048,170,2156,60,1275,219,28,3650,881,0.09403515396438712,383665,215082,
172,0.013423692802622518,81,605,-433,858,35836,42909,634583,0.017600359751189565,168583,1842,0.051400194328452505,19386,257,82,64,403,64137,0.01838378618992083,23523,41,175,69,0.07068477906097048,170,2156,60,1275,219,28,3650,881,0.09403515396438712,383665,215082,
172,0.013423692802622518,81,605,-433,858,35836,42909,634583,0.017600359751189565,168583,1842,0.051400194328452505,19386,257,82,64,403,64137,0.01838378618992083,23523,41,175,69,0.07068477906097048,170,2156,60,1275,219,28,3650,881,0.09403515396438712,383665,215082,
172,0.013423692802622518,81,605,-433,858,35836,42909,634583,0.017600359751189565,168583,1842,0.051400194328452505,19386,257,82,64,403,64137,0.01838378618992083,23523,41,175,69,0.07068477906097048,170,2156,60,1275,219,28,3650,881,0.09403515396438712,383665,215082,
172,0.003063253703941834,81,605,-433,858,35836,42909,634583,0.017600359751189565,168583,1842,0.051400194328452505,19386,274,14,14,302,64137,0.01838378618992083,23523,10,260,9,0.0874759301536683,19,2156,0,1275,219,-1,3650,881,0.09403515396438712,383665,215082,
172,0.003063253703941834,81,605,-433,858,35836,42909,634583,0.017600359751189565,168583,1842,0.051400194328452505,19386,274,14,14,302,64137,0.01838378618992083,23523,10,260,9,0.0874759301536683,19,2156,0,1275,219,-1,3650,881,0.09403515396438712,383665,215082,
172,0.07825442531324885,81,605,-433,858,35836,42909,634583,0.017600359751189565,168583,1842,0.051400194328452505,19386,305,143,76,524,64137,0.01838378618992083,23523,9,162,16,0.13164538945383675,26,2156,1,1275,219,7,3650,881,0.09403515396438712,383665,215082,
172,0.07825442531324885,81,605,-433,858,35836,42909,634583,0.017600359751189565,168583,1842,0.051400194328452505,19386,305,143,76,524,64137,0.01838378618992083,23523,9,162,16,0.13164538945383675,26,2156,1,1275,219,7,3650,881,0.09403515396438712,383665,215082,
172,0.07825442531324885,81,605,-433,858,35836,42909,634583,0.017600359751189565,168583,1842,0.051400194328452505,19386,305,143,76,524,64137,0.01838378618992083,23523,9,162,16,0.13164538945383675,26,2156,1,1275,219,7,3650,881,0.09403515396438712,383665,215082,
172,0.0,81,605,-433,858,35836,42909,634583,0.017600359751189565,168583,1842,0.051400194328452505,19386,112,28,1,141,64137,0.01838378618992083,23523,0,84,0,0.05661807779400831,0,2156,0,1275,219,0,3650,881,0.09403515396438712,383665,215082,
172,0.0,81,605,-433,858,35836,42909,634583,0.017600359751189565,168583,1842,0.051400194328452505,19386,112,28,1,141,64137,0.01838378618992083,23523,0,84,0,0.05661807779400831,0,2156,0,1275,219,0,3650,881,0.09403515396438712,383665,215082,
172,0.0,81,605,-433,858,35836,42909,634583,0.017600359751189565,168583,1842,0.051400194328452505,19386,32,28,1,61,64137,0.01838378618992083,23523,0,4,0,0.021009325310943686,0,2156,0,1275,219,0,3650,881,0.09403515396438712,383665,215082,
172,0.0,81,605,-433,858,35836,42909,634583,0.017600359751189565,168583,1842,0.051400194328452505,19386,58,58,0,116,64137,0.01838378618992083,23523,0,0,0,0.0862243688288247,0,2156,0,1275,219,0,3650,881,0.09403515396438712,383665,215082,
172,0.0,81,605,-433,858,35836,42909,634583,0.017600359751189565,168583,1842,0.051400194328452505,19386,58,58,0,116,64137,0.01838378618992083,23523,0,0,0,0.0862243688288247,0,2156,0,1275,219,0,3650,881,0.09403515396438712,383665,215082,
172,0.0,81,605,-433,858,35836,42909,634583,0.017600359751189565,168583,1842,0.051400194328452505,19386,58,58,0,116,64137,0.01838378618992083,23523,0,0,0,0.0862243688288247,0,2156,0,1275,219,0,3650,881,0.09403515396438712,383665,215082,
1028,0.02110985922183504,199,575,453,1802,35836,42909,634583,0.030291502452967703,168583,1842,0.051400194328452505,19386,197,52,1,250,64137,0.01838378618992083,23523,5,145,12,0.06713558972024837,17,11267,0,7333,1490,7,20090,3934,0.06461674487722241,383665,215082,
1028,0.07116808793304154,199,575,453,1802,35836,42909,634583,0.030291502452967703,168583,1842,0.051400194328452505,19386,127,47,40,214,64137,0.01838378618992083,23523,20,80,30,0.11054762135896924,50,11267,0,7333,1490,10,20090,3934,0.06461674487722241,383665,215082,
1028,4.997700334642636E-4,199,575,453,1802,35836,42909,634583,0.030291502452967703,168583,1842,0.051400194328452505,19386,86,0,0,86,64137,0.01838378618992083,23523,0,86,5,0.09959788590466245,5,11267,0,7333,1490,5,20090,3934,0.06461674487722241,383665,215082,
1028,0.006304558680892337,199,575,453,1802,35836,42909,634583,0.030291502452967703,168583,1842,0.051400194328452505,19386,304,25,56,385,64137,0.01838378618992083,23523,3,279,6,0.09272925894557171,65,11267,56,7333,1490,3,20090,3934,0.06461674487722241,383665,215082,
1028,0.006304558680892337,199,575,453,1802,35836,42909,634583,0.030291502452967703,168583,1842,0.051400194328452505,19386,304,25,56,385,64137,0.01838378618992083,23523,3,279,6,0.09272925894557171,65,11267,56,7333,1490,3,20090,3934,0.06461674487722241,383665,215082,
1028,0.006304558680892337,199,575,453,1802,35836,42909,634583,0.030291502452967703,168583,1842,0.051400194328452505,19386,304,25,56,385,64137,0.01838378618992083,23523,3,279,6,0.09272925894557171,65,11267,56,7333,1490,3,20090,3934,0.06461674487722241,383665,215082,
1028,0.006304558680892337,199,575,453,1802,35836,42909,634583,0.030291502452967703,168583,1842,0.051400194328452505,19386,304,25,56,385,64137,0.01838378618992083,23523,3,279,6,0.09272925894557171,65,11267,56,7333,1490,3,20090,3934,0.06461674487722241,383665,215082,
1028,0.006304558680892337,199,575,453,1802,35836,42909,634583,0.030291502452967703,168583,1842,0.051400194328452505,19386,304,25,56,385,64137,0.01838378618992083,23523,3,279,6,0.09272925894557171,65,11267,56,7333,1490,3,20090,3934,0.06461674487722241,383665,215082,
1028,0.06723548259351261,199,575,453,1802,35836,42909,634583,0.030291502452967703,168583,1842,0.051400194328452505,19386,301,162,83,546,64137,0.01838378618992083,23523,52,139,52,0.08179850793533876,118,11267,14,7333,1490,0,20090,3934,0.06461674487722241,383665,215082,
1028,0.11538461538461539,199,575,453,1802,35836,42909,634583,0.030291502452967703,168583,1842,0.051400194328452505,19386,413,254,107,774,64137,0.01838378618992083,23523,0,159,6,0.15182160735212744,6,11267,0,7333,1490,6,20090,3934,0.06461674487722241,383665,215082,
1028,0.0,199,575,453,1802,35836,42909,634583,0.030291502452967703,168583,1842,0.051400194328452505,19386,291,95,5,391,64137,0.01838378618992083,23523,0,196,0,0.13594561529930063,0,11267,0,7333,1490,0,20090,3934,0.06461674487722241,383665,215082,
1028,0.002306346173267994,199,575,453,1802,35836,42909,634583,0.030291502452967703,168583,1842,0.051400194328452505,19386,116,60,20,196,64137,0.01838378618992083,23523,7,56,7,0.06482653813684011,17,11267,3,7333,1490,0,20090,3934,0.06461674487722241,383665,215082,
1028,0.006430428239157204,199,575,453,1802,35836,42909,634583,0.030291502452967703,168583,1842,0.051400194328452505,19386,70,124,0,194,64137,0.01838378618992083,23523,24,-54,23,0.07277165256303636,47,11267,0,7333,1490,-1,20090,3934,0.06461674487722241,383665,215082,
1028,0.0021048603908853823,199,575,453,1802,35836,42909,634583,0.030291502452967703,168583,1842,0.051400194328452505,19386,112,38,8,158,64137,0.01838378618992083,23523,10,74,12,0.060337764214505325,22,11267,0,7333,1490,2,20090,3934,0.06461674487722241,383665,215082,
1028,0.03755066715931396,199,575,453,1802,35836,42909,634583,0.030291502452967703,168583,1842,0.051400194328452505,19386,288,49,6,343,64137,0.01838378618992083,23523,14,239,183,0.06135006840268303,202,11267,5,7333,1490,169,20090,3934,0.06461674487722241,383665,215082,
1028,0.03755066715931396,199,575,453,1802,35836,42909,634583,0.030291502452967703,168583,1842,0.051400194328452505,19386,288,49,6,343,64137,0.01838378618992083,23523,14,239,183,0.06135006840268303,202,11267,5,7333,1490,169,20090,3934,0.06461674487722241,383665,215082,
1028,0.0041102715019613375,199,575,453,1802,35836,42909,634583,0.030291502452967703,168583,1842,0.051400194328452505,19386,659,209,35,903,64137,0.01838378618992083,23523,14,450,25,0.0696623328231954,39,11267,0,7333,1490,11,20090,3934,0.06461674487722241,383665,215082,
1028,0.12991039769756765,199,575,453,1802,35836,42909,634583,0.030291502452967703,168583,1842,0.051400194328452505,19386,53,126,4,183,64137,0.01838378618992083,23523,106,-73,4,0.11997800212877986,110,11267,0,7333,1490,-102,20090,3934,0.06461674487722241,383665,215082,
1028,0.0021828351238985756,199,575,453,1802,35836,42909,634583,0.030291502452967703,168583,1842,0.051400194328452505,19386,448,247,142,837,64137,0.01838378618992083,23523,3,201,3,0.06355445104348194,6,11267,0,7333,1490,0,20090,3934,0.06461674487722241,383665,215082,
1028,0.0021828351238985756,199,575,453,1802,35836,42909,634583,0.030291502452967703,168583,1842,0.051400194328452505,19386,448,247,142,837,64137,0.01838378618992083,23523,3,201,3,0.06355445104348194,6,11267,0,7333,1490,0,20090,3934,0.06461674487722241,383665,215082,
1028,0.012836084741119748,199,575,453,1802,35836,42909,634583,0.030291502452967703,168583,1842,0.051400194328452505,19386,163,154,69,386,64137,0.01838378618992083,23523,19,9,38,0.09770081310585922,113,11267,56,7333,1490,19,20090,3934,0.06461674487722241,383665,215082,
1028,0.01540436456996149,199,575,453,1802,35836,42909,634583,0.030291502452967703,168583,1842,0.051400194328452505,19386,274,142,2,418,64137,0.01838378618992083,23523,24,132,24,0.02365556167345533,48,11267,0,7333,1490,0,20090,3934,0.06461674487722241,383665,215082,
1028,0.16641628959276017,199,575,453,1802,35836,42909,634583,0.030291502452967703,168583,1842,0.051400194328452505,19386,1712,1148,224,3084,64137,0.01838378618992083,23523,2,564,63,0.09838335077314078,107,11267,42,7333,1490,61,20090,3934,0.06461674487722241,383665,215082,
1028,0.16641628959276017,199,575,453,1802,35836,42909,634583,0.030291502452967703,168583,1842,0.051400194328452505,19386,1712,1148,224,3084,64137,0.01838378618992083,23523,2,564,63,0.09838335077314078,107,11267,42,7333,1490,61,20090,3934,0.06461674487722241,383665,215082,
1028,0.16641628959276017,199,575,453,1802,35836,42909,634583,0.030291502452967703,168583,1842,0.051400194328452505,19386,1712,1148,224,3084,64137,0.01838378618992083,23523,2,564,63,0.09838335077314078,107,11267,42,7333,1490,61,20090,3934,0.06461674487722241,383665,215082,
1028,0.16641628959276017,199,575,453,1802,35836,42909,634583,0.030291502452967703,168583,1842,0.051400194328452505,19386,1712,1148,224,3084,64137,0.01838378618992083,23523,2,564,63,0.09838335077314078,107,11267,42,7333,1490,61,20090,3934,0.06461674487722241,383665,215082,
1028,0.16641628959276017,199,575,453,1802,35836,42909,634583,0.030291502452967703,168583,1842,0.051400194328452505,19386,1712,1148,224,3084,64137,0.01838378618992083,23523,2,564,63,0.09838335077314078,107,11267,42,7333,1490,61,20090,3934,0.06461674487722241,383665,215082,
1028,0.16641628959276017,199,575,453,1802,35836,42909,634583,0.030291502452967703,168583,1842,0.051400194328452505,19386,1712,1148,224,3084,64137,0.01838378618992083,23523,2,564,63,0.09838335077314078,107,11267,42,7333,1490,61,20090,3934,0.06461674487722241,383665,215082,
1028,0.16641628959276017,199,575,453,1802,35836,42909,634583,0.030291502452967703,168583,1842,0.051400194328452505,19386,1712,1148,224,3084,64137,0.01838378618992083,23523,2,564,63,0.09838335077314078,107,11267,42,7333,1490,61,20090,3934,0.06461674487722241,383665,215082,
1028,0.002484103829618037,199,575,453,1802,35836,42909,634583,0.030291502452967703,168583,1842,0.051400194328452505,19386,517,235,5,757,64137,0.01838378618992083,23523,32,282,22,0.0551944436717413,54,11267,0,7333,1490,-10,20090,3934,0.06461674487722241,383665,215082,
1028,0.002484103829618037,199,575,453,1802,35836,42909,634583,0.030291502452967703,168583,1842,0.051400194328452505,19386,517,235,5,757,64137,0.01838378618992083,23523,32,282,22,0.0551944436717413,54,11267,0,7333,1490,-10,20090,3934,0.06461674487722241,383665,215082,
1028,0.002484103829618037,199,575,453,1802,35836,42909,634583,0.030291502452967703,168583,1842,0.051400194328452505,19386,517,235,5,757,64137,0.01838378618992083,23523,32,282,22,0.0551944436717413,54,11267,0,7333,1490,-10,20090,3934,0.06461674487722241,383665,215082,
1028,0.002484103829618037,199,575,453,1802,35836,42909,634583,0.030291502452967703,168583,1842,0.051400194328452505,19386,517,235,5,757,64137,0.01838378618992083,23523,32,282,22,0.0551944436717413,54,11267,0,7333,1490,-10,20090,3934,0.06461674487722241,383665,215082,
1028,0.002484103829618037,199,575,453,1802,35836,42909,634583,0.030291502452967703,168583,1842,0.051400194328452505,19386,517,235,5,757,64137,0.01838378618992083,23523,32,282,22,0.0551944436717413,54,11267,0,7333,1490,-10,20090,3934,0.06461674487722241,383665,215082,
1028,0.002484103829618037,199,575,453,1802,35836,42909,634583,0.030291502452967703,168583,1842,0.051400194328452505,19386,517,235,5,757,64137,0.01838378618992083,23523,32,282,22,0.0551944436717413,54,11267,0,7333,1490,-10,20090,3934,0.06461674487722241,383665,215082,
1028,0.0761904761904762,199,575,453,1802,35836,42909,634583,0.030291502452967703,168583,1842,0.051400194328452505,19386,211,249,83,543,64137,0.01838378618992083,23523,5,-38,9,0.114292406787144,16,11267,2,7333,1490,4,20090,3934,0.06461674487722241,383665,215082,
1028,0.0761904761904762,199,575,453,1802,35836,42909,634583,0.030291502452967703,168583,1842,0.051400194328452505,19386,211,249,83,543,64137,0.01838378618992083,23523,5,-38,9,0.114292406787144,16,11267,2,7333,1490,4,20090,3934,0.06461674487722241,383665,215082,
1028,0.0761904761904762,199,575,453,1802,35836,42909,634583,0.030291502452967703,168583,1842,0.051400194328452505,19386,211,249,83,543,64137,0.01838378618992083,23523,5,-38,9,0.114292406787144,16,11267,2,7333,1490,4,20090,3934,0.06461674487722241,383665,215082,
1028,0.03870704619436769,199,575,453,1802,35836,42909,634583,0.030291502452967703,168583,1842,0.051400194328452505,19386,756,416,143,1315,64137,0.01838378618992083,23523,64,340,83,0.08853739575083015,148,11267,1,7333,1490,19,20090,3934,0.06461674487722241,383665,215082,
1028,0.03870704619436769,199,575,453,1802,35836,42909,634583,0.030291502452967703,168583,1842,0.051400194328452505,19386,756,416,143,1315,64137,0.01838378618992083,23523,64,340,83,0.08853739575083015,148,11267,1,7333,1490,19,20090,3934,0.06461674487722241,383665,215082,
1028,0.03870704619436769,199,575,453,1802,35836,42909,634583,0.030291502452967703,168583,1842,0.051400194328452505,19386,756,416,143,1315,64137,0.01838378618992083,23523,64,340,83,0.08853739575083015,148,11267,1,7333,1490,19,20090,3934,0.06461674487722241,383665,215082,
1028,0.03870704619436769,199,575,453,1802,35836,42909,634583,0.030291502452967703,168583,1842,0.051400194328452505,19386,756,416,143,1315,64137,0.01838378618992083,23523,64,340,83,0.08853739575083015,148,11267,1,7333,1490,19,20090,3934,0.06461674487722241,383665,215082,
1028,0.03870704619436769,199,575,453,1802,35836,42909,634583,0.030291502452967703,168583,1842,0.051400194328452505,19386,756,416,143,1315,64137,0.01838378618992083,23523,64,340,83,0.08853739575083015,148,11267,1,7333,1490,19,20090,3934,0.06461674487722241,383665,215082,
1028,0.03870704619436769,199,575,453,1802,35836,42909,634583,0.030291502452967703,168583,1842,0.051400194328452505,19386,756,416,143,1315,64137,0.01838378618992083,23523,64,340,83,0.08853739575083015,148,11267,1,7333,1490,19,20090,3934,0.06461674487722241,383665,215082,
1028,0.0,199,575,453,1802,35836,42909,634583,0.030291502452967703,168583,1842,0.051400194328452505,19386,274,461,8,743,64137,0.01838378618992083,23523,0,-187,0,0.03585517572272025,0,11267,0,7333,1490,0,20090,3934,0.06461674487722241,383665,215082,
1028,0.0034602076124567475,199,575,453,1802,35836,42909,634583,0.030291502452967703,168583,1842,0.051400194328452505,19386,369,30,4,403,64137,0.01838378618992083,23523,6,339,6,0.0834069528807502,12,11267,0,7333,1490,0,20090,3934,0.06461674487722241,383665,215082,
1028,0.0034602076124567475,199,575,453,1802,35836,42909,634583,0.030291502452967703,168583,1842,0.051400194328452505,19386,369,30,4,403,64137,0.01838378618992083,23523,6,339,6,0.0834069528807502,12,11267,0,7333,1490,0,20090,3934,0.06461674487722241,383665,215082,
1028,0.0034602076124567475,199,575,453,1802,35836,42909,634583,0.030291502452967703,168583,1842,0.051400194328452505,19386,369,30,4,403,64137,0.01838378618992083,23523,6,339,6,0.0834069528807502,12,11267,0,7333,1490,0,20090,3934,0.06461674487722241,383665,215082,
1028,0.0034602076124567475,199,575,453,1802,35836,42909,634583,0.030291502452967703,168583,1842,0.051400194328452505,19386,369,30,4,403,64137,0.01838378618992083,23523,6,339,6,0.0834069528807502,12,11267,0,7333,1490,0,20090,3934,0.06461674487722241,383665,215082,
1028,0.0034602076124567475,199,575,453,1802,35836,42909,634583,0.030291502452967703,168583,1842,0.051400194328452505,19386,369,30,4,403,64137,0.01838378618992083,23523,6,339,6,0.0834069528807502,12,11267,0,7333,1490,0,20090,3934,0.06461674487722241,383665,215082,
1028,0.01038800580988703,199,575,453,1802,35836,42909,634583,0.030291502452967703,168583,1842,0.051400194328452505,19386,242,177,43,462,64137,0.01838378618992083,23523,64,65,20,0.07069067056159592,85,11267,1,7333,1490,-44,20090,3934,0.06461674487722241,383665,215082,
4447,0.0,416,3015,1432,7878,35836,42909,634583,0.027744243162502492,168583,1842,0.051400194328452505,19386,160,83,6,249,64137,0.01838378618992083,23523,0,77,0,0.20887128720186238,0,44687,0,29623,4562,0,78872,15064,0.06625303832127065,383665,215082,
1028,0.01038800580988703,199,575,453,1802,35836,42909,634583,0.030291502452967703,168583,1842,0.051400194328452505,19386,242,177,43,462,64137,0.01838378618992083,23523,64,65,20,0.07069067056159592,85,11267,1,7333,1490,-44,20090,3934,0.06461674487722241,383665,215082,
1028,0.0047534145192760545,199,575,453,1802,35836,42909,634583,0.030291502452967703,168583,1842,0.051400194328452505,19386,260,141,56,457,64137,0.01838378618992083,23523,9,119,12,0.03931310864609932,23,11267,2,7333,1490,3,20090,3934,0.06461674487722241,383665,215082,
1028,0.0047534145192760545,199,575,453,1802,35836,42909,634583,0.030291502452967703,168583,1842,0.051400194328452505,19386,260,141,56,457,64137,0.01838378618992083,23523,9,119,12,0.03931310864609932,23,11267,2,7333,1490,3,20090,3934,0.06461674487722241,383665,215082,
1028,0.0047534145192760545,199,575,453,1802,35836,42909,634583,0.030291502452967703,168583,1842,0.051400194328452505,19386,260,141,56,457,64137,0.01838378618992083,23523,9,119,12,0.03931310864609932,23,11267,2,7333,1490,3,20090,3934,0.06461674487722241,383665,215082,
1028,0.18604651162790697,199,575,453,1802,35836,42909,634583,0.030291502452967703,168583,1842,0.051400194328452505,19386,1282,1467,255,3004,64137,0.01838378618992083,23523,2,-185,14,0.07051638965115645,16,11267,0,7333,1490,12,20090,3934,0.06461674487722241,383665,215082,
1028,0.18604651162790697,199,575,453,1802,35836,42909,634583,0.030291502452967703,168583,1842,0.051400194328452505,19386,1282,1467,255,3004,64137,0.01838378618992083,23523,2,-185,14,0.07051638965115645,16,11267,0,7333,1490,12,20090,3934,0.06461674487722241,383665,215082,
51,0.0,8,56,-5,115,35836,42909,634583,0.006991127002617162,168583,1842,0.051400194328452505,19386,26,0,0,26,64137,0.01838378618992083,23523,0,26,0,0.012109920819748486,0,808,0,190,35,0,1033,618,0.016053135208979843,383665,215082,
2586,0.022230290964278136,88,1333,1253,4007,35836,42909,634583,0.023577161420399735,168583,1842,0.051400194328452505,19386,872,321,135,1328,64137,0.01838378618992083,23523,6,551,10,0.17821234173004025,16,8805,0,4115,425,4,13345,4690,0.05622025343000698,383665,215082,
2586,0.022230290964278136,88,1333,1253,4007,35836,42909,634583,0.023577161420399735,168583,1842,0.051400194328452505,19386,872,321,135,1328,64137,0.01838378618992083,23523,6,551,10,0.17821234173004025,16,8805,0,4115,425,4,13345,4690,0.05622025343000698,383665,215082,
2586,0.022230290964278136,88,1333,1253,4007,35836,42909,634583,0.023577161420399735,168583,1842,0.051400194328452505,19386,872,321,135,1328,64137,0.01838378618992083,23523,6,551,10,0.17821234173004025,16,8805,0,4115,425,4,13345,4690,0.05622025343000698,383665,215082,
2586,0.022230290964278136,88,1333,1253,4007,35836,42909,634583,0.023577161420399735,168583,1842,0.051400194328452505,19386,872,321,135,1328,64137,0.01838378618992083,23523,6,551,10,0.17821234173004025,16,8805,0,4115,425,4,13345,4690,0.05622025343000698,383665,215082,
2586,0.022230290964278136,88,1333,1253,4007,35836,42909,634583,0.023577161420399735,168583,1842,0.051400194328452505,19386,872,321,135,1328,64137,0.01838378618992083,23523,6,551,10,0.17821234173004025,16,8805,0,4115,425,4,13345,4690,0.05622025343000698,383665,215082,
2586,0.022230290964278136,88,1333,1253,4007,35836,42909,634583,0.023577161420399735,168583,1842,0.051400194328452505,19386,872,321,135,1328,64137,0.01838378618992083,23523,6,551,10,0.17821234173004025,16,8805,0,4115,425,4,13345,4690,0.05622025343000698,383665,215082,
2586,0.022230290964278136,88,1333,1253,4007,35836,42909,634583,0.023577161420399735,168583,1842,0.051400194328452505,19386,872,321,135,1328,64137,0.01838378618992083,23523,6,551,10,0.17821234173004025,16,8805,0,4115,425,4,13345,4690,0.05622025343000698,383665,215082,
2586,0.022230290964278136,88,1333,1253,4007,35836,42909,634583,0.023577161420399735,168583,1842,0.051400194328452505,19386,872,321,135,1328,64137,0.01838378618992083,23523,6,551,10,0.17821234173004025,16,8805,0,4115,425,4,13345,4690,0.05622025343000698,383665,215082,
2586,0.022230290964278136,88,1333,1253,4007,35836,42909,634583,0.023577161420399735,168583,1842,0.051400194328452505,19386,872,321,135,1328,64137,0.01838378618992083,23523,6,551,10,0.17821234173004025,16,8805,0,4115,425,4,13345,4690,0.05622025343000698,383665,215082,
2586,0.022230290964278136,88,1333,1253,4007,35836,42909,634583,0.023577161420399735,168583,1842,0.051400194328452505,19386,872,321,135,1328,64137,0.01838378618992083,23523,6,551,10,0.17821234173004025,16,8805,0,4115,425,4,13345,4690,0.05622025343000698,383665,215082,
2586,0.022230290964278136,88,1333,1253,4007,35836,42909,634583,0.023577161420399735,168583,1842,0.051400194328452505,19386,872,321,135,1328,64137,0.01838378618992083,23523,6,551,10,0.17821234173004025,16,8805,0,4115,425,4,13345,4690,0.05622025343000698,383665,215082,
2586,0.022230290964278136,88,1333,1253,4007,35836,42909,634583,0.023577161420399735,168583,1842,0.051400194328452505,19386,872,321,135,1328,64137,0.01838378618992083,23523,6,551,10,0.17821234173004025,16,8805,0,4115,425,4,13345,4690,0.05622025343000698,383665,215082,
2586,0.022230290964278136,88,1333,1253,4007,35836,42909,634583,0.023577161420399735,168583,1842,0.051400194328452505,19386,872,321,135,1328,64137,0.01838378618992083,23523,6,551,10,0.17821234173004025,16,8805,0,4115,425,4,13345,4690,0.05622025343000698,383665,215082,
2586,0.022230290964278136,88,1333,1253,4007,35836,42909,634583,0.023577161420399735,168583,1842,0.051400194328452505,19386,872,321,135,1328,64137,0.01838378618992083,23523,6,551,10,0.17821234173004025,16,8805,0,4115,425,4,13345,4690,0.05622025343000698,383665,215082,
2586,0.022230290964278136,88,1333,1253,4007,35836,42909,634583,0.023577161420399735,168583,1842,0.051400194328452505,19386,872,321,135,1328,64137,0.01838378618992083,23523,6,551,10,0.17821234173004025,16,8805,0,4115,425,4,13345,4690,0.05622025343000698,383665,215082,
2586,0.022230290964278136,88,1333,1253,4007,35836,42909,634583,0.023577161420399735,168583,1842,0.051400194328452505,19386,872,321,135,1328,64137,0.01838378618992083,23523,6,551,10,0.17821234173004025,16,8805,0,4115,425,4,13345,4690,0.05622025343000698,383665,215082,
2586,0.022230290964278136,88,1333,1253,4007,35836,42909,634583,0.023577161420399735,168583,1842,0.051400194328452505,19386,872,321,135,1328,64137,0.01838378618992083,23523,6,551,10,0.17821234173004025,16,8805,0,4115,425,4,13345,4690,0.05622025343000698,383665,215082,
2586,0.022230290964278136,88,1333,1253,4007,35836,42909,634583,0.023577161420399735,168583,1842,0.051400194328452505,19386,872,321,135,1328,64137,0.01838378618992083,23523,6,551,10,0.17821234173004025,16,8805,0,4115,425,4,13345,4690,0.05622025343000698,383665,215082,
2586,0.022230290964278136,88,1333,1253,4007,35836,42909,634583,0.023577161420399735,168583,1842,0.051400194328452505,19386,872,321,135,1328,64137,0.01838378618992083,23523,6,551,10,0.17821234173004025,16,8805,0,4115,425,4,13345,4690,0.05622025343000698,383665,215082,
2586,0.022230290964278136,88,1333,1253,4007,35836,42909,634583,0.023577161420399735,168583,1842,0.051400194328452505,19386,872,321,135,1328,64137,0.01838378618992083,23523,6,551,10,0.17821234173004025,16,8805,0,4115,425,4,13345,4690,0.05622025343000698,383665,215082,
2586,0.022230290964278136,88,1333,1253,4007,35836,42909,634583,0.023577161420399735,168583,1842,0.051400194328452505,19386,872,321,135,1328,64137,0.01838378618992083,23523,6,551,10,0.17821234173004025,16,8805,0,4115,425,4,13345,4690,0.05622025343000698,383665,215082,
2586,0.022230290964278136,88,1333,1253,4007,35836,42909,634583,0.023577161420399735,168583,1842,0.051400194328452505,19386,872,321,135,1328,64137,0.01838378618992083,23523,6,551,10,0.17821234173004025,16,8805,0,4115,425,4,13345,4690,0.05622025343000698,383665,215082,
2586,0.022230290964278136,88,1333,1253,4007,35836,42909,634583,0.023577161420399735,168583,1842,0.051400194328452505,19386,872,321,135,1328,64137,0.01838378618992083,23523,6,551,10,0.17821234173004025,16,8805,0,4115,425,4,13345,4690,0.05622025343000698,383665,215082,
2586,0.01884778920600947,88,1333,1253,4007,35836,42909,634583,0.023577161420399735,168583,1842,0.051400194328452505,19386,111,104,1,216,64137,0.01838378618992083,23523,7,7,15,0.06368001473594255,22,8805,0,4115,425,8,13345,4690,0.05622025343000698,383665,215082,
2586,0.01884778920600947,88,1333,1253,4007,35836,42909,634583,0.023577161420399735,168583,1842,0.051400194328452505,19386,111,104,1,216,64137,0.01838378618992083,23523,7,7,15,0.06368001473594255,22,8805,0,4115,425,8,13345,4690,0.05622025343000698,383665,215082,
2586,0.0,88,1333,1253,4007,35836,42909,634583,0.023577161420399735,168583,1842,0.051400194328452505,19386,1,1,0,2,64137,0.01838378618992083,23523,0,0,0,0.06666666666666667,0,8805,0,4115,425,0,13345,4690,0.05622025343000698,383665,215082,
2586,0.018072289156626505,88,1333,1253,4007,35836,42909,634583,0.023577161420399735,168583,1842,0.051400194328452505,19386,218,13,5,236,64137,0.01838378618992083,23523,2,205,1,0.054718817179371534,3,8805,0,4115,425,-1,13345,4690,0.05622025343000698,383665,215082,
2586,0.018072289156626505,88,1333,1253,4007,35836,42909,634583,0.023577161420399735,168583,1842,0.051400194328452505,19386,218,13,5,236,64137,0.01838378618992083,23523,2,205,1,0.054718817179371534,3,8805,0,4115,425,-1,13345,4690,0.05622025343000698,383665,215082,
2586,0.018072289156626505,88,1333,1253,4007,35836,42909,634583,0.023577161420399735,168583,1842,0.051400194328452505,19386,218,13,5,236,64137,0.01838378618992083,23523,2,205,1,0.054718817179371534,3,8805,0,4115,425,-1,13345,4690,0.05622025343000698,383665,215082,
2586,0.018072289156626505,88,1333,1253,4007,35836,42909,634583,0.023577161420399735,168583,1842,0.051400194328452505,19386,218,13,5,236,64137,0.01838378618992083,23523,2,205,1,0.054718817179371534,3,8805,0,4115,425,-1,13345,4690,0.05622025343000698,383665,215082,
2586,0.018072289156626505,88,1333,1253,4007,35836,42909,634583,0.023577161420399735,168583,1842,0.051400194328452505,19386,218,13,5,236,64137,0.01838378618992083,23523,2,205,1,0.054718817179371534,3,8805,0,4115,425,-1,13345,4690,0.05622025343000698,383665,215082,
2586,0.018072289156626505,88,1333,1253,4007,35836,42909,634583,0.023577161420399735,168583,1842,0.051400194328452505,19386,218,13,5,236,64137,0.01838378618992083,23523,2,205,1,0.054718817179371534,3,8805,0,4115,425,-1,13345,4690,0.05622025343000698,383665,215082,
2586,0.018072289156626505,88,1333,1253,4007,35836,42909,634583,0.023577161420399735,168583,1842,0.051400194328452505,19386,218,13,5,236,64137,0.01838378618992083,23523,2,205,1,0.054718817179371534,3,8805,0,4115,425,-1,13345,4690,0.05622025343000698,383665,215082,
2586,0.018072289156626505,88,1333,1253,4007,35836,42909,634583,0.023577161420399735,168583,1842,0.051400194328452505,19386,218,13,5,236,64137,0.01838378618992083,23523,2,205,1,0.054718817179371534,3,8805,0,4115,425,-1,13345,4690,0.05622025343000698,383665,215082,
2586,0.0,88,1333,1253,4007,35836,42909,634583,0.023577161420399735,168583,1842,0.051400194328452505,19386,12,11,11,34,64137,0.01838378618992083,23523,0,1,0,0.0016405863115435894,0,8805,0,4115,425,0,13345,4690,0.05622025343000698,383665,215082,
2586,0.0,88,1333,1253,4007,35836,42909,634583,0.023577161420399735,168583,1842,0.051400194328452505,19386,12,11,11,34,64137,0.01838378618992083,23523,0,1,0,0.0016405863115435894,0,8805,0,4115,425,0,13345,4690,0.05622025343000698,383665,215082,
2586,0.0,88,1333,1253,4007,35836,42909,634583,0.023577161420399735,168583,1842,0.051400194328452505,19386,17,245,12,274,64137,0.01838378618992083,23523,0,-228,0,0.08290842229171838,0,8805,0,4115,425,0,13345,4690,0.05622025343000698,383665,215082,
2586,0.02328017324087069,88,1333,1253,4007,35836,42909,634583,0.023577161420399735,168583,1842,0.051400194328452505,19386,651,206,10,867,64137,0.01838378618992083,23523,12,445,93,0.11991182739480113,105,8805,0,4115,425,81,13345,4690,0.05622025343000698,383665,215082,
2586,0.02328017324087069,88,1333,1253,4007,35836,42909,634583,0.023577161420399735,168583,1842,0.051400194328452505,19386,651,206,10,867,64137,0.01838378618992083,23523,12,445,93,0.11991182739480113,105,8805,0,4115,425,81,13345,4690,0.05622025343000698,383665,215082,
2586,0.02328017324087069,88,1333,1253,4007,35836,42909,634583,0.023577161420399735,168583,1842,0.051400194328452505,19386,651,206,10,867,64137,0.01838378618992083,23523,12,445,93,0.11991182739480113,105,8805,0,4115,425,81,13345,4690,0.05622025343000698,383665,215082,
2586,0.02328017324087069,88,1333,1253,4007,35836,42909,634583,0.023577161420399735,168583,1842,0.051400194328452505,19386,651,206,10,867,64137,0.01838378618992083,23523,12,445,93,0.11991182739480113,105,8805,0,4115,425,81,13345,4690,0.05622025343000698,383665,215082,
2586,0.0,88,1333,1253,4007,35836,42909,634583,0.023577161420399735,168583,1842,0.051400194328452505,19386,361,26,4,391,64137,0.01838378618992083,23523,0,335,0,0.12743246933340235,0,8805,0,4115,425,0,13345,4690,0.05622025343000698,383665,215082,
2586,0.2387695886831929,88,1333,1253,4007,35836,42909,634583,0.023577161420399735,168583,1842,0.051400194328452505,19386,457,215,19,691,64137,0.01838378618992083,23523,170,242,233,0.05605209073415081,413,8805,10,4115,425,63,13345,4690,0.05622025343000698,383665,215082,
2586,0.2387695886831929,88,1333,1253,4007,35836,42909,634583,0.023577161420399735,168583,1842,0.051400194328452505,19386,457,215,19,691,64137,0.01838378618992083,23523,170,242,233,0.05605209073415081,413,8805,10,4115,425,63,13345,4690,0.05622025343000698,383665,215082,
2586,0.0,88,1333,1253,4007,35836,42909,634583,0.023577161420399735,168583,1842,0.051400194328452505,19386,0,38,0,38,64137,0.01838378618992083,23523,0,-38,0,0.0457280385078219,0,8805,0,4115,425,0,13345,4690,0.05622025343000698,383665,215082,
2586,0.0,88,1333,1253,4007,35836,42909,634583,0.023577161420399735,168583,1842,0.051400194328452505,19386,361,26,4,391,64137,0.01838378618992083,23523,0,335,0,0.12743246933340235,0,8805,0,4115,425,0,13345,4690,0.05622025343000698,383665,215082,
2586,0.0,88,1333,1253,4007,35836,42909,634583,0.023577161420399735,168583,1842,0.051400194328452505,19386,119,66,10,195,64137,0.01838378618992083,23523,0,53,0,0.05136937209341566,0,8805,0,4115,425,0,13345,4690,0.05622025343000698,383665,215082,
362,0.0,3,175,187,540,35836,42909,634583,0.03701575575252991,168583,1842,0.051400194328452505,19386,137,12,1,150,64137,0.01838378618992083,23523,0,125,0,0.17808957575625026,0,4697,0,2421,277,0,7395,2276,0.1082302045586424,383665,215082,
362,0.0,3,175,187,540,35836,42909,634583,0.03701575575252991,168583,1842,0.051400194328452505,19386,137,12,1,150,64137,0.01838378618992083,23523,0,125,0,0.17808957575625026,0,4697,0,2421,277,0,7395,2276,0.1082302045586424,383665,215082,
362,0.0,3,175,187,540,35836,42909,634583,0.03701575575252991,168583,1842,0.051400194328452505,19386,137,12,1,150,64137,0.01838378618992083,23523,0,125,0,0.17808957575625026,0,4697,0,2421,277,0,7395,2276,0.1082302045586424,383665,215082,
362,0.0,3,175,187,540,35836,42909,634583,0.03701575575252991,168583,1842,0.051400194328452505,19386,137,12,1,150,64137,0.01838378618992083,23523,0,125,0,0.17808957575625026,0,4697,0,2421,277,0,7395,2276,0.1082302045586424,383665,215082,
362,0.0,3,175,187,540,35836,42909,634583,0.03701575575252991,168583,1842,0.051400194328452505,19386,71,0,0,71,64137,0.01838378618992083,23523,0,71,0,0.1066066066066066,0,4697,0,2421,277,0,7395,2276,0.1082302045586424,383665,215082,
362,0.0,3,175,187,540,35836,42909,634583,0.03701575575252991,168583,1842,0.051400194328452505,19386,71,0,0,71,64137,0.01838378618992083,23523,0,71,0,0.1066066066066066,0,4697,0,2421,277,0,7395,2276,0.1082302045586424,383665,215082,
362,0.0,3,175,187,540,35836,42909,634583,0.03701575575252991,168583,1842,0.051400194328452505,19386,71,0,0,71,64137,0.01838378618992083,23523,0,71,0,0.1066066066066066,0,4697,0,2421,277,0,7395,2276,0.1082302045586424,383665,215082,
362,0.0,3,175,187,540,35836,42909,634583,0.03701575575252991,168583,1842,0.051400194328452505,19386,64,10,4,78,64137,0.01838378618992083,23523,0,54,0,0.12162075452655073,0,4697,0,2421,277,0,7395,2276,0.1082302045586424,383665,215082,
362,0.0,3,175,187,540,35836,42909,634583,0.03701575575252991,168583,1842,0.051400194328452505,19386,64,10,4,78,64137,0.01838378618992083,23523,0,54,0,0.12162075452655073,0,4697,0,2421,277,0,7395,2276,0.1082302045586424,383665,215082,
362,0.0,3,175,187,540,35836,42909,634583,0.03701575575252991,168583,1842,0.051400194328452505,19386,64,10,4,78,64137,0.01838378618992083,23523,0,54,0,0.12162075452655073,0,4697,0,2421,277,0,7395,2276,0.1082302045586424,383665,215082,
362,0.0,3,175,187,540,35836,42909,634583,0.03701575575252991,168583,1842,0.051400194328452505,19386,133,9,0,142,64137,0.01838378618992083,23523,0,124,0,0.176546460288754,0,4697,0,2421,277,0,7395,2276,0.1082302045586424,383665,215082,
362,0.0,3,175,187,540,35836,42909,634583,0.03701575575252991,168583,1842,0.051400194328452505,19386,133,9,0,142,64137,0.01838378618992083,23523,0,124,0,0.176546460288754,0,4697,0,2421,277,0,7395,2276,0.1082302045586424,383665,215082,
362,0.0,3,175,187,540,35836,42909,634583,0.03701575575252991,168583,1842,0.051400194328452505,19386,133,9,0,142,64137,0.01838378618992083,23523,0,124,0,0.176546460288754,0,4697,0,2421,277,0,7395,2276,0.1082302045586424,383665,215082,
362,0.022097023308059533,3,175,187,540,35836,42909,634583,0.03701575575252991,168583,1842,0.051400194328452505,19386,216,63,13,292,64137,0.01838378618992083,23523,3,153,4,0.07708801249449763,7,4697,0,2421,277,1,7395,2276,0.1082302045586424,383665,215082,
362,0.022097023308059533,3,175,187,540,35836,42909,634583,0.03701575575252991,168583,1842,0.051400194328452505,19386,216,63,13,292,64137,0.01838378618992083,23523,3,153,4,0.07708801249449763,7,4697,0,2421,277,1,7395,2276,0.1082302045586424,383665,215082,
362,0.022097023308059533,3,175,187,540,35836,42909,634583,0.03701575575252991,168583,1842,0.051400194328452505,19386,216,63,13,292,64137,0.01838378618992083,23523,3,153,4,0.07708801249449763,7,4697,0,2421,277,1,7395,2276,0.1082302045586424,383665,215082,
362,0.022097023308059533,3,175,187,540,35836,42909,634583,0.03701575575252991,168583,1842,0.051400194328452505,19386,216,63,13,292,64137,0.01838378618992083,23523,3,153,4,0.07708801249449763,7,4697,0,2421,277,1,7395,2276,0.1082302045586424,383665,215082,
362,0.0,3,175,187,540,35836,42909,634583,0.03701575575252991,168583,1842,0.051400194328452505,19386,54,11,0,65,64137,0.01838378618992083,23523,0,43,0,0.14407313172835493,0,4697,0,2421,277,0,7395,2276,0.1082302045586424,383665,215082,
362,0.1326263083639439,3,175,187,540,35836,42909,634583,0.03701575575252991,168583,1842,0.051400194328452505,19386,1124,585,130,1839,64137,0.01838378618992083,23523,59,539,103,0.1553792451023906,163,4697,1,2421,277,44,7395,2276,0.1082302045586424,383665,215082,
362,0.26910828025477707,3,175,187,540,35836,42909,634583,0.03701575575252991,168583,1842,0.051400194328452505,19386,217,17,0,234,64137,0.01838378618992083,23523,2,200,167,0.15216029161122405,169,4697,0,2421,277,165,7395,2276,0.1082302045586424,383665,215082,
362,0.26910828025477707,3,175,187,540,35836,42909,634583,0.03701575575252991,168583,1842,0.051400194328452505,19386,217,17,0,234,64137,0.01838378618992083,23523,2,200,167,0.15216029161122405,169,4697,0,2421,277,165,7395,2276,0.1082302045586424,383665,215082,
362,0.26910828025477707,3,175,187,540,35836,42909,634583,0.03701575575252991,168583,1842,0.051400194328452505,19386,217,17,0,234,64137,0.01838378618992083,23523,2,200,167,0.15216029161122405,169,4697,0,2421,277,165,7395,2276,0.1082302045586424,383665,215082,
362,0.26910828025477707,3,175,187,540,35836,42909,634583,0.03701575575252991,168583,1842,0.051400194328452505,19386,217,17,0,234,64137,0.01838378618992083,23523,2,200,167,0.15216029161122405,169,4697,0,2421,277,165,7395,2276,0.1082302045586424,383665,215082,
362,0.07272727272727272,3,175,187,540,35836,42909,634583,0.03701575575252991,168583,1842,0.051400194328452505,19386,34,508,25,567,64137,0.01838378618992083,23523,3,-474,4,0.3011585518246096,8,4697,1,2421,277,1,7395,2276,0.1082302045586424,383665,215082,
362,0.0,3,175,187,540,35836,42909,634583,0.03701575575252991,168583,1842,0.051400194328452505,19386,0,93,0,93,64137,0.01838378618992083,23523,0,-93,0,0.08267417097657438,0,4697,0,2421,277,0,7395,2276,0.1082302045586424,383665,215082,
980,0.0,4,762,218,1746,35836,42909,634583,0.03141633183314517,168583,1842,0.051400194328452505,19386,56,8,0,64,64137,0.01838378618992083,23523,0,48,0,0.12721911107072012,0,4820,0,1672,46,0,6538,3148,0.07144561146372085,383665,215082,
980,0.0,4,762,218,1746,35836,42909,634583,0.03141633183314517,168583,1842,0.051400194328452505,19386,1,0,0,1,64137,0.01838378618992083,23523,0,1,0,0.007692307692307693,0,4820,0,1672,46,0,6538,3148,0.07144561146372085,383665,215082,
980,0.0,4,762,218,1746,35836,42909,634583,0.03141633183314517,168583,1842,0.051400194328452505,19386,136,22,0,158,64137,0.01838378618992083,23523,0,114,0,0.20445690772730166,0,4820,0,1672,46,0,6538,3148,0.07144561146372085,383665,215082,
980,0.0,4,762,218,1746,35836,42909,634583,0.03141633183314517,168583,1842,0.051400194328452505,19386,136,22,0,158,64137,0.01838378618992083,23523,0,114,0,0.20445690772730166,0,4820,0,1672,46,0,6538,3148,0.07144561146372085,383665,215082,
980,0.0,4,762,218,1746,35836,42909,634583,0.03141633183314517,168583,1842,0.051400194328452505,19386,136,22,0,158,64137,0.01838378618992083,23523,0,114,0,0.20445690772730166,0,4820,0,1672,46,0,6538,3148,0.07144561146372085,383665,215082,
980,0.0,4,762,218,1746,35836,42909,634583,0.03141633183314517,168583,1842,0.051400194328452505,19386,136,22,0,158,64137,0.01838378618992083,23523,0,114,0,0.20445690772730166,0,4820,0,1672,46,0,6538,3148,0.07144561146372085,383665,215082,
980,0.0,4,762,218,1746,35836,42909,634583,0.03141633183314517,168583,1842,0.051400194328452505,19386,136,22,0,158,64137,0.01838378618992083,23523,0,114,0,0.20445690772730166,0,4820,0,1672,46,0,6538,3148,0.07144561146372085,383665,215082,
980,0.0,4,762,218,1746,35836,42909,634583,0.03141633183314517,168583,1842,0.051400194328452505,19386,136,22,0,158,64137,0.01838378618992083,23523,0,114,0,0.20445690772730166,0,4820,0,1672,46,0,6538,3148,0.07144561146372085,383665,215082,
980,0.0,4,762,218,1746,35836,42909,634583,0.03141633183314517,168583,1842,0.051400194328452505,19386,25,4,0,29,64137,0.01838378618992083,23523,0,21,0,0.2012699564586357,0,4820,0,1672,46,0,6538,3148,0.07144561146372085,383665,215082,
980,0.5268817204301075,4,762,218,1746,35836,42909,634583,0.03141633183314517,168583,1842,0.051400194328452505,19386,1115,1025,8,2148,64137,0.01838378618992083,23523,735,90,0,0.13636921694602286,735,4820,0,1672,46,-735,6538,3148,0.07144561146372085,383665,215082,
980,0.5268817204301075,4,762,218,1746,35836,42909,634583,0.03141633183314517,168583,1842,0.051400194328452505,19386,1115,1025,8,2148,64137,0.01838378618992083,23523,735,90,0,0.13636921694602286,735,4820,0,1672,46,-735,6538,3148,0.07144561146372085,383665,215082,
980,0.5268817204301075,4,762,218,1746,35836,42909,634583,0.03141633183314517,168583,1842,0.051400194328452505,19386,1115,1025,8,2148,64137,0.01838378618992083,23523,735,90,0,0.13636921694602286,735,4820,0,1672,46,-735,6538,3148,0.07144561146372085,383665,215082,
980,0.5268817204301075,4,762,218,1746,35836,42909,634583,0.03141633183314517,168583,1842,0.051400194328452505,19386,1115,1025,8,2148,64137,0.01838378618992083,23523,735,90,0,0.13636921694602286,735,4820,0,1672,46,-735,6538,3148,0.07144561146372085,383665,215082,
980,0.5268817204301075,4,762,218,1746,35836,42909,634583,0.03141633183314517,168583,1842,0.051400194328452505,19386,1115,1025,8,2148,64137,0.01838378618992083,23523,735,90,0,0.13636921694602286,735,4820,0,1672,46,-735,6538,3148,0.07144561146372085,383665,215082,
980,0.5268817204301075,4,762,218,1746,35836,42909,634583,0.03141633183314517,168583,1842,0.051400194328452505,19386,1115,1025,8,2148,64137,0.01838378618992083,23523,735,90,0,0.13636921694602286,735,4820,0,1672,46,-735,6538,3148,0.07144561146372085,383665,215082,
980,0.5268817204301075,4,762,218,1746,35836,42909,634583,0.03141633183314517,168583,1842,0.051400194328452505,19386,1115,1025,8,2148,64137,0.01838378618992083,23523,735,90,0,0.13636921694602286,735,4820,0,1672,46,-735,6538,3148,0.07144561146372085,383665,215082,
980,0.5268817204301075,4,762,218,1746,35836,42909,634583,0.03141633183314517,168583,1842,0.051400194328452505,19386,1115,1025,8,2148,64137,0.01838378618992083,23523,735,90,0,0.13636921694602286,735,4820,0,1672,46,-735,6538,3148,0.07144561146372085,383665,215082,
980,0.5268817204301075,4,762,218,1746,35836,42909,634583,0.03141633183314517,168583,1842,0.051400194328452505,19386,1115,1025,8,2148,64137,0.01838378618992083,23523,735,90,0,0.13636921694602286,735,4820,0,1672,46,-735,6538,3148,0.07144561146372085,383665,215082,
980,0.5268817204301075,4,762,218,1746,35836,42909,634583,0.03141633183314517,168583,1842,0.051400194328452505,19386,1115,1025,8,2148,64137,0.01838378618992083,23523,735,90,0,0.13636921694602286,735,4820,0,1672,46,-735,6538,3148,0.07144561146372085,383665,215082,
980,0.5268817204301075,4,762,218,1746,35836,42909,634583,0.03141633183314517,168583,1842,0.051400194328452505,19386,1115,1025,8,2148,64137,0.01838378618992083,23523,735,90,0,0.13636921694602286,735,4820,0,1672,46,-735,6538,3148,0.07144561146372085,383665,215082,
980,0.5268817204301075,4,762,218,1746,35836,42909,634583,0.03141633183314517,168583,1842,0.051400194328452505,19386,1115,1025,8,2148,64137,0.01838378618992083,23523,735,90,0,0.13636921694602286,735,4820,0,1672,46,-735,6538,3148,0.07144561146372085,383665,215082,
980,0.5268817204301075,4,762,218,1746,35836,42909,634583,0.03141633183314517,168583,1842,0.051400194328452505,19386,1115,1025,8,2148,64137,0.01838378618992083,23523,735,90,0,0.13636921694602286,735,4820,0,1672,46,-735,6538,3148,0.07144561146372085,383665,215082,
980,0.5268817204301075,4,762,218,1746,35836,42909,634583,0.03141633183314517,168583,1842,0.051400194328452505,19386,1115,1025,8,2148,64137,0.01838378618992083,23523,735,90,0,0.13636921694602286,735,4820,0,1672,46,-735,6538,3148,0.07144561146372085,383665,215082,
980,0.5268817204301075,4,762,218,1746,35836,42909,634583,0.03141633183314517,168583,1842,0.051400194328452505,19386,1115,1025,8,2148,64137,0.01838378618992083,23523,735,90,0,0.13636921694602286,735,4820,0,1672,46,-735,6538,3148,0.07144561146372085,383665,215082,
980,0.5268817204301075,4,762,218,1746,35836,42909,634583,0.03141633183314517,168583,1842,0.051400194328452505,19386,1115,1025,8,2148,64137,0.01838378618992083,23523,735,90,0,0.13636921694602286,735,4820,0,1672,46,-735,6538,3148,0.07144561146372085,383665,215082,
980,0.5268817204301075,4,762,218,1746,35836,42909,634583,0.03141633183314517,168583,1842,0.051400194328452505,19386,1115,1025,8,2148,64137,0.01838378618992083,23523,735,90,0,0.13636921694602286,735,4820,0,1672,46,-735,6538,3148,0.07144561146372085,383665,215082,
980,0.5268817204301075,4,762,218,1746,35836,42909,634583,0.03141633183314517,168583,1842,0.051400194328452505,19386,1115,1025,8,2148,64137,0.01838378618992083,23523,735,90,0,0.13636921694602286,735,4820,0,1672,46,-735,6538,3148,0.07144561146372085,383665,215082,
980,0.5268817204301075,4,762,218,1746,35836,42909,634583,0.03141633183314517,168583,1842,0.051400194328452505,19386,1115,1025,8,2148,64137,0.01838378618992083,23523,735,90,0,0.13636921694602286,735,4820,0,1672,46,-735,6538,3148,0.07144561146372085,383665,215082,
980,0.5268817204301075,4,762,218,1746,35836,42909,634583,0.03141633183314517,168583,1842,0.051400194328452505,19386,1115,1025,8,2148,64137,0.01838378618992083,23523,735,90,0,0.13636921694602286,735,4820,0,1672,46,-735,6538,3148,0.07144561146372085,383665,215082,
980,0.5268817204301075,4,762,218,1746,35836,42909,634583,0.03141633183314517,168583,1842,0.051400194328452505,19386,1115,1025,8,2148,64137,0.01838378618992083,23523,735,90,0,0.13636921694602286,735,4820,0,1672,46,-735,6538,3148,0.07144561146372085,383665,215082,
980,0.5268817204301075,4,762,218,1746,35836,42909,634583,0.03141633183314517,168583,1842,0.051400194328452505,19386,1115,1025,8,2148,64137,0.01838378618992083,23523,735,90,0,0.13636921694602286,735,4820,0,1672,46,-735,6538,3148,0.07144561146372085,383665,215082,
980,0.5268817204301075,4,762,218,1746,35836,42909,634583,0.03141633183314517,168583,1842,0.051400194328452505,19386,1115,1025,8,2148,64137,0.01838378618992083,23523,735,90,0,0.13636921694602286,735,4820,0,1672,46,-735,6538,3148,0.07144561146372085,383665,215082,
980,0.5268817204301075,4,762,218,1746,35836,42909,634583,0.03141633183314517,168583,1842,0.051400194328452505,19386,1115,1025,8,2148,64137,0.01838378618992083,23523,735,90,0,0.13636921694602286,735,4820,0,1672,46,-735,6538,3148,0.07144561146372085,383665,215082,
980,0.5268817204301075,4,762,218,1746,35836,42909,634583,0.03141633183314517,168583,1842,0.051400194328452505,19386,1115,1025,8,2148,64137,0.01838378618992083,23523,735,90,0,0.13636921694602286,735,4820,0,1672,46,-735,6538,3148,0.07144561146372085,383665,215082,
980,0.5268817204301075,4,762,218,1746,35836,42909,634583,0.03141633183314517,168583,1842,0.051400194328452505,19386,1115,1025,8,2148,64137,0.01838378618992083,23523,735,90,0,0.13636921694602286,735,4820,0,1672,46,-735,6538,3148,0.07144561146372085,383665,215082,
980,0.5268817204301075,4,762,218,1746,35836,42909,634583,0.03141633183314517,168583,1842,0.051400194328452505,19386,1115,1025,8,2148,64137,0.01838378618992083,23523,735,90,0,0.13636921694602286,735,4820,0,1672,46,-735,6538,3148,0.07144561146372085,383665,215082,
980,0.5268817204301075,4,762,218,1746,35836,42909,634583,0.03141633183314517,168583,1842,0.051400194328452505,19386,1115,1025,8,2148,64137,0.01838378618992083,23523,735,90,0,0.13636921694602286,735,4820,0,1672,46,-735,6538,3148,0.07144561146372085,383665,215082,
980,0.5268817204301075,4,762,218,1746,35836,42909,634583,0.03141633183314517,168583,1842,0.051400194328452505,19386,1115,1025,8,2148,64137,0.01838378618992083,23523,735,90,0,0.13636921694602286,735,4820,0,1672,46,-735,6538,3148,0.07144561146372085,383665,215082,
980,0.5268817204301075,4,762,218,1746,35836,42909,634583,0.03141633183314517,168583,1842,0.051400194328452505,19386,1115,1025,8,2148,64137,0.01838378618992083,23523,735,90,0,0.13636921694602286,735,4820,0,1672,46,-735,6538,3148,0.07144561146372085,383665,215082,
980,0.5268817204301075,4,762,218,1746,35836,42909,634583,0.03141633183314517,168583,1842,0.051400194328452505,19386,1115,1025,8,2148,64137,0.01838378618992083,23523,735,90,0,0.13636921694602286,735,4820,0,1672,46,-735,6538,3148,0.07144561146372085,383665,215082,
980,0.5268817204301075,4,762,218,1746,35836,42909,634583,0.03141633183314517,168583,1842,0.051400194328452505,19386,1115,1025,8,2148,64137,0.01838378618992083,23523,735,90,0,0.13636921694602286,735,4820,0,1672,46,-735,6538,3148,0.07144561146372085,383665,215082,
980,0.5268817204301075,4,762,218,1746,35836,42909,634583,0.03141633183314517,168583,1842,0.051400194328452505,19386,1115,1025,8,2148,64137,0.01838378618992083,23523,735,90,0,0.13636921694602286,735,4820,0,1672,46,-735,6538,3148,0.07144561146372085,383665,215082,
980,0.5268817204301075,4,762,218,1746,35836,42909,634583,0.03141633183314517,168583,1842,0.051400194328452505,19386,1115,1025,8,2148,64137,0.01838378618992083,23523,735,90,0,0.13636921694602286,735,4820,0,1672,46,-735,6538,3148,0.07144561146372085,383665,215082,
980,0.5268817204301075,4,762,218,1746,35836,42909,634583,0.03141633183314517,168583,1842,0.051400194328452505,19386,1115,1025,8,2148,64137,0.01838378618992083,23523,735,90,0,0.13636921694602286,735,4820,0,1672,46,-735,6538,3148,0.07144561146372085,383665,215082,
980,0.5268817204301075,4,762,218,1746,35836,42909,634583,0.03141633183314517,168583,1842,0.051400194328452505,19386,1115,1025,8,2148,64137,0.01838378618992083,23523,735,90,0,0.13636921694602286,735,4820,0,1672,46,-735,6538,3148,0.07144561146372085,383665,215082,
980,0.5268817204301075,4,762,218,1746,35836,42909,634583,0.03141633183314517,168583,1842,0.051400194328452505,19386,1115,1025,8,2148,64137,0.01838378618992083,23523,735,90,0,0.13636921694602286,735,4820,0,1672,46,-735,6538,3148,0.07144561146372085,383665,215082,
980,0.0,4,762,218,1746,35836,42909,634583,0.03141633183314517,168583,1842,0.051400194328452505,19386,68,18,0,86,64137,0.01838378618992083,23523,0,50,0,0.00999938933542834,0,4820,0,1672,46,0,6538,3148,0.07144561146372085,383665,215082,
980,0.0,4,762,218,1746,35836,42909,634583,0.03141633183314517,168583,1842,0.051400194328452505,19386,68,18,0,86,64137,0.01838378618992083,23523,0,50,0,0.00999938933542834,0,4820,0,1672,46,0,6538,3148,0.07144561146372085,383665,215082,
980,0.0,4,762,218,1746,35836,42909,634583,0.03141633183314517,168583,1842,0.051400194328452505,19386,68,18,0,86,64137,0.01838378618992083,23523,0,50,0,0.00999938933542834,0,4820,0,1672,46,0,6538,3148,0.07144561146372085,383665,215082,
980,0.05454545454545454,4,762,218,1746,35836,42909,634583,0.03141633183314517,168583,1842,0.051400194328452505,19386,17,17,0,34,64137,0.01838378618992083,23523,3,0,3,0.017581605995659954,6,4820,0,1672,46,0,6538,3148,0.07144561146372085,383665,215082,
980,0.05454545454545454,4,762,218,1746,35836,42909,634583,0.03141633183314517,168583,1842,0.051400194328452505,19386,17,17,0,34,64137,0.01838378618992083,23523,3,0,3,0.017581605995659954,6,4820,0,1672,46,0,6538,3148,0.07144561146372085,383665,215082,
980,0.44776119402985076,4,762,218,1746,35836,42909,634583,0.03141633183314517,168583,1842,0.051400194328452505,19386,208,59,0,267,64137,0.01838378618992083,23523,0,149,30,0.22547809844106464,30,4820,0,1672,46,30,6538,3148,0.07144561146372085,383665,215082,
980,0.44776119402985076,4,762,218,1746,35836,42909,634583,0.03141633183314517,168583,1842,0.051400194328452505,19386,208,59,0,267,64137,0.01838378618992083,23523,0,149,30,0.22547809844106464,30,4820,0,1672,46,30,6538,3148,0.07144561146372085,383665,215082,
980,0.44776119402985076,4,762,218,1746,35836,42909,634583,0.03141633183314517,168583,1842,0.051400194328452505,19386,208,59,0,267,64137,0.01838378618992083,23523,0,149,30,0.22547809844106464,30,4820,0,1672,46,30,6538,3148,0.07144561146372085,383665,215082,
980,0.44776119402985076,4,762,218,1746,35836,42909,634583,0.03141633183314517,168583,1842,0.051400194328452505,19386,208,59,0,267,64137,0.01838378618992083,23523,0,149,30,0.22547809844106464,30,4820,0,1672,46,30,6538,3148,0.07144561146372085,383665,215082,
980,0.44776119402985076,4,762,218,1746,35836,42909,634583,0.03141633183314517,168583,1842,0.051400194328452505,19386,208,59,0,267,64137,0.01838378618992083,23523,0,149,30,0.22547809844106464,30,4820,0,1672,46,30,6538,3148,0.07144561146372085,383665,215082,
980,0.44776119402985076,4,762,218,1746,35836,42909,634583,0.03141633183314517,168583,1842,0.051400194328452505,19386,208,59,0,267,64137,0.01838378618992083,23523,0,149,30,0.22547809844106464,30,4820,0,1672,46,30,6538,3148,0.07144561146372085,383665,215082,
980,0.44776119402985076,4,762,218,1746,35836,42909,634583,0.03141633183314517,168583,1842,0.051400194328452505,19386,208,59,0,267,64137,0.01838378618992083,23523,0,149,30,0.22547809844106464,30,4820,0,1672,46,30,6538,3148,0.07144561146372085,383665,215082,
980,0.44776119402985076,4,762,218,1746,35836,42909,634583,0.03141633183314517,168583,1842,0.051400194328452505,19386,208,59,0,267,64137,0.01838378618992083,23523,0,149,30,0.22547809844106464,30,4820,0,1672,46,30,6538,3148,0.07144561146372085,383665,215082,
980,0.44776119402985076,4,762,218,1746,35836,42909,634583,0.03141633183314517,168583,1842,0.051400194328452505,19386,208,59,0,267,64137,0.01838378618992083,23523,0,149,30,0.22547809844106464,30,4820,0,1672,46,30,6538,3148,0.07144561146372085,383665,215082,
980,0.44776119402985076,4,762,218,1746,35836,42909,634583,0.03141633183314517,168583,1842,0.051400194328452505,19386,208,59,0,267,64137,0.01838378618992083,23523,0,149,30,0.22547809844106464,30,4820,0,1672,46,30,6538,3148,0.07144561146372085,383665,215082,
980,0.44776119402985076,4,762,218,1746,35836,42909,634583,0.03141633183314517,168583,1842,0.051400194328452505,19386,208,59,0,267,64137,0.01838378618992083,23523,0,149,30,0.22547809844106464,30,4820,0,1672,46,30,6538,3148,0.07144561146372085,383665,215082,
980,0.44776119402985076,4,762,218,1746,35836,42909,634583,0.03141633183314517,168583,1842,0.051400194328452505,19386,208,59,0,267,64137,0.01838378618992083,23523,0,149,30,0.22547809844106464,30,4820,0,1672,46,30,6538,3148,0.07144561146372085,383665,215082,
980,0.44776119402985076,4,762,218,1746,35836,42909,634583,0.03141633183314517,168583,1842,0.051400194328452505,19386,208,59,0,267,64137,0.01838378618992083,23523,0,149,30,0.22547809844106464,30,4820,0,1672,46,30,6538,3148,0.07144561146372085,383665,215082,
980,0.44776119402985076,4,762,218,1746,35836,42909,634583,0.03141633183314517,168583,1842,0.051400194328452505,19386,208,59,0,267,64137,0.01838378618992083,23523,0,149,30,0.22547809844106464,30,4820,0,1672,46,30,6538,3148,0.07144561146372085,383665,215082,
980,0.0,4,762,218,1746,35836,42909,634583,0.03141633183314517,168583,1842,0.051400194328452505,19386,0,92,0,92,64137,0.01838378618992083,23523,0,-92,0,0.09213179391146976,0,4820,0,1672,46,0,6538,3148,0.07144561146372085,383665,215082,
980,0.0,4,762,218,1746,35836,42909,634583,0.03141633183314517,168583,1842,0.051400194328452505,19386,0,92,0,92,64137,0.01838378618992083,23523,0,-92,0,0.09213179391146976,0,4820,0,1672,46,0,6538,3148,0.07144561146372085,383665,215082,
980,0.0,4,762,218,1746,35836,42909,634583,0.03141633183314517,168583,1842,0.051400194328452505,19386,0,92,0,92,64137,0.01838378618992083,23523,0,-92,0,0.09213179391146976,0,4820,0,1672,46,0,6538,3148,0.07144561146372085,383665,215082,
980,4.032258064516129E-4,4,762,218,1746,35836,42909,634583,0.03141633183314517,168583,1842,0.051400194328452505,19386,13,10,0,23,64137,0.01838378618992083,23523,1,3,1,0.011266845383503414,2,4820,0,1672,46,0,6538,3148,0.07144561146372085,383665,215082,
980,0.0,4,762,218,1746,35836,42909,634583,0.03141633183314517,168583,1842,0.051400194328452505,19386,659,202,32,893,64137,0.01838378618992083,23523,0,457,0,0.26838090670649684,0,4820,0,1672,46,0,6538,3148,0.07144561146372085,383665,215082,
980,0.0,4,762,218,1746,35836,42909,634583,0.03141633183314517,168583,1842,0.051400194328452505,19386,659,202,32,893,64137,0.01838378618992083,23523,0,457,0,0.26838090670649684,0,4820,0,1672,46,0,6538,3148,0.07144561146372085,383665,215082,
980,0.0,4,762,218,1746,35836,42909,634583,0.03141633183314517,168583,1842,0.051400194328452505,19386,659,202,32,893,64137,0.01838378618992083,23523,0,457,0,0.26838090670649684,0,4820,0,1672,46,0,6538,3148,0.07144561146372085,383665,215082,
980,0.0,4,762,218,1746,35836,42909,634583,0.03141633183314517,168583,1842,0.051400194328452505,19386,659,202,32,893,64137,0.01838378618992083,23523,0,457,0,0.26838090670649684,0,4820,0,1672,46,0,6538,3148,0.07144561146372085,383665,215082,
980,0.0,4,762,218,1746,35836,42909,634583,0.03141633183314517,168583,1842,0.051400194328452505,19386,659,202,32,893,64137,0.01838378618992083,23523,0,457,0,0.26838090670649684,0,4820,0,1672,46,0,6538,3148,0.07144561146372085,383665,215082,
980,0.0,4,762,218,1746,35836,42909,634583,0.03141633183314517,168583,1842,0.051400194328452505,19386,659,202,32,893,64137,0.01838378618992083,23523,0,457,0,0.26838090670649684,0,4820,0,1672,46,0,6538,3148,0.07144561146372085,383665,215082,
980,0.0,4,762,218,1746,35836,42909,634583,0.03141633183314517,168583,1842,0.051400194328452505,19386,659,202,32,893,64137,0.01838378618992083,23523,0,457,0,0.26838090670649684,0,4820,0,1672,46,0,6538,3148,0.07144561146372085,383665,215082,
980,0.0,4,762,218,1746,35836,42909,634583,0.03141633183314517,168583,1842,0.051400194328452505,19386,659,202,32,893,64137,0.01838378618992083,23523,0,457,0,0.26838090670649684,0,4820,0,1672,46,0,6538,3148,0.07144561146372085,383665,215082,
980,0.0,4,762,218,1746,35836,42909,634583,0.03141633183314517,168583,1842,0.051400194328452505,19386,659,202,32,893,64137,0.01838378618992083,23523,0,457,0,0.26838090670649684,0,4820,0,1672,46,0,6538,3148,0.07144561146372085,383665,215082,
980,0.0,4,762,218,1746,35836,42909,634583,0.03141633183314517,168583,1842,0.051400194328452505,19386,659,202,32,893,64137,0.01838378618992083,23523,0,457,0,0.26838090670649684,0,4820,0,1672,46,0,6538,3148,0.07144561146372085,383665,215082,
980,0.0,4,762,218,1746,35836,42909,634583,0.03141633183314517,168583,1842,0.051400194328452505,19386,659,202,32,893,64137,0.01838378618992083,23523,0,457,0,0.26838090670649684,0,4820,0,1672,46,0,6538,3148,0.07144561146372085,383665,215082,
980,0.0,4,762,218,1746,35836,42909,634583,0.03141633183314517,168583,1842,0.051400194328452505,19386,659,202,32,893,64137,0.01838378618992083,23523,0,457,0,0.26838090670649684,0,4820,0,1672,46,0,6538,3148,0.07144561146372085,383665,215082,
980,0.0,4,762,218,1746,35836,42909,634583,0.03141633183314517,168583,1842,0.051400194328452505,19386,659,202,32,893,64137,0.01838378618992083,23523,0,457,0,0.26838090670649684,0,4820,0,1672,46,0,6538,3148,0.07144561146372085,383665,215082,
980,0.0,4,762,218,1746,35836,42909,634583,0.03141633183314517,168583,1842,0.051400194328452505,19386,659,202,32,893,64137,0.01838378618992083,23523,0,457,0,0.26838090670649684,0,4820,0,1672,46,0,6538,3148,0.07144561146372085,383665,215082,
980,0.0,4,762,218,1746,35836,42909,634583,0.03141633183314517,168583,1842,0.051400194328452505,19386,659,202,32,893,64137,0.01838378618992083,23523,0,457,0,0.26838090670649684,0,4820,0,1672,46,0,6538,3148,0.07144561146372085,383665,215082,
980,0.0,4,762,218,1746,35836,42909,634583,0.03141633183314517,168583,1842,0.051400194328452505,19386,659,202,32,893,64137,0.01838378618992083,23523,0,457,0,0.26838090670649684,0,4820,0,1672,46,0,6538,3148,0.07144561146372085,383665,215082,
980,0.0,4,762,218,1746,35836,42909,634583,0.03141633183314517,168583,1842,0.051400194328452505,19386,659,202,32,893,64137,0.01838378618992083,23523,0,457,0,0.26838090670649684,0,4820,0,1672,46,0,6538,3148,0.07144561146372085,383665,215082,
980,0.0,4,762,218,1746,35836,42909,634583,0.03141633183314517,168583,1842,0.051400194328452505,19386,659,202,32,893,64137,0.01838378618992083,23523,0,457,0,0.26838090670649684,0,4820,0,1672,46,0,6538,3148,0.07144561146372085,383665,215082,
980,0.0,4,762,218,1746,35836,42909,634583,0.03141633183314517,168583,1842,0.051400194328452505,19386,659,202,32,893,64137,0.01838378618992083,23523,0,457,0,0.26838090670649684,0,4820,0,1672,46,0,6538,3148,0.07144561146372085,383665,215082,
980,0.0,4,762,218,1746,35836,42909,634583,0.03141633183314517,168583,1842,0.051400194328452505,19386,659,202,32,893,64137,0.01838378618992083,23523,0,457,0,0.26838090670649684,0,4820,0,1672,46,0,6538,3148,0.07144561146372085,383665,215082,
980,0.0,4,762,218,1746,35836,42909,634583,0.03141633183314517,168583,1842,0.051400194328452505,19386,659,202,32,893,64137,0.01838378618992083,23523,0,457,0,0.26838090670649684,0,4820,0,1672,46,0,6538,3148,0.07144561146372085,383665,215082,
980,0.0,4,762,218,1746,35836,42909,634583,0.03141633183314517,168583,1842,0.051400194328452505,19386,659,202,32,893,64137,0.01838378618992083,23523,0,457,0,0.26838090670649684,0,4820,0,1672,46,0,6538,3148,0.07144561146372085,383665,215082,
980,0.0,4,762,218,1746,35836,42909,634583,0.03141633183314517,168583,1842,0.051400194328452505,19386,659,202,32,893,64137,0.01838378618992083,23523,0,457,0,0.26838090670649684,0,4820,0,1672,46,0,6538,3148,0.07144561146372085,383665,215082,
980,0.0,4,762,218,1746,35836,42909,634583,0.03141633183314517,168583,1842,0.051400194328452505,19386,659,202,32,893,64137,0.01838378618992083,23523,0,457,0,0.26838090670649684,0,4820,0,1672,46,0,6538,3148,0.07144561146372085,383665,215082,
980,0.0,4,762,218,1746,35836,42909,634583,0.03141633183314517,168583,1842,0.051400194328452505,19386,659,202,32,893,64137,0.01838378618992083,23523,0,457,0,0.26838090670649684,0,4820,0,1672,46,0,6538,3148,0.07144561146372085,383665,215082,
980,0.0,4,762,218,1746,35836,42909,634583,0.03141633183314517,168583,1842,0.051400194328452505,19386,659,202,32,893,64137,0.01838378618992083,23523,0,457,0,0.26838090670649684,0,4820,0,1672,46,0,6538,3148,0.07144561146372085,383665,215082,
980,0.0,4,762,218,1746,35836,42909,634583,0.03141633183314517,168583,1842,0.051400194328452505,19386,659,202,32,893,64137,0.01838378618992083,23523,0,457,0,0.26838090670649684,0,4820,0,1672,46,0,6538,3148,0.07144561146372085,383665,215082,
980,0.0,4,762,218,1746,35836,42909,634583,0.03141633183314517,168583,1842,0.051400194328452505,19386,659,202,32,893,64137,0.01838378618992083,23523,0,457,0,0.26838090670649684,0,4820,0,1672,46,0,6538,3148,0.07144561146372085,383665,215082,
980,0.0,4,762,218,1746,35836,42909,634583,0.03141633183314517,168583,1842,0.051400194328452505,19386,659,202,32,893,64137,0.01838378618992083,23523,0,457,0,0.26838090670649684,0,4820,0,1672,46,0,6538,3148,0.07144561146372085,383665,215082,
980,0.0,4,762,218,1746,35836,42909,634583,0.03141633183314517,168583,1842,0.051400194328452505,19386,659,202,32,893,64137,0.01838378618992083,23523,0,457,0,0.26838090670649684,0,4820,0,1672,46,0,6538,3148,0.07144561146372085,383665,215082,
980,0.0,4,762,218,1746,35836,42909,634583,0.03141633183314517,168583,1842,0.051400194328452505,19386,659,202,32,893,64137,0.01838378618992083,23523,0,457,0,0.26838090670649684,0,4820,0,1672,46,0,6538,3148,0.07144561146372085,383665,215082,
980,0.0,4,762,218,1746,35836,42909,634583,0.03141633183314517,168583,1842,0.051400194328452505,19386,659,202,32,893,64137,0.01838378618992083,23523,0,457,0,0.26838090670649684,0,4820,0,1672,46,0,6538,3148,0.07144561146372085,383665,215082,
980,0.0,4,762,218,1746,35836,42909,634583,0.03141633183314517,168583,1842,0.051400194328452505,19386,659,202,32,893,64137,0.01838378618992083,23523,0,457,0,0.26838090670649684,0,4820,0,1672,46,0,6538,3148,0.07144561146372085,383665,215082,
980,0.0,4,762,218,1746,35836,42909,634583,0.03141633183314517,168583,1842,0.051400194328452505,19386,40,0,0,40,64137,0.01838378618992083,23523,0,40,0,0.3389830508474576,0,4820,0,1672,46,0,6538,3148,0.07144561146372085,383665,215082,
980,0.0,4,762,218,1746,35836,42909,634583,0.03141633183314517,168583,1842,0.051400194328452505,19386,156,2,0,158,64137,0.01838378618992083,23523,0,154,0,0.31210735941654316,0,4820,0,1672,46,0,6538,3148,0.07144561146372085,383665,215082,
980,0.0,4,762,218,1746,35836,42909,634583,0.03141633183314517,168583,1842,0.051400194328452505,19386,102,30,0,132,64137,0.01838378618992083,23523,0,72,0,0.03763969345175105,0,4820,0,1672,46,0,6538,3148,0.07144561146372085,383665,215082,
980,0.0,4,762,218,1746,35836,42909,634583,0.03141633183314517,168583,1842,0.051400194328452505,19386,102,30,0,132,64137,0.01838378618992083,23523,0,72,0,0.03763969345175105,0,4820,0,1672,46,0,6538,3148,0.07144561146372085,383665,215082,
980,0.0,4,762,218,1746,35836,42909,634583,0.03141633183314517,168583,1842,0.051400194328452505,19386,102,30,0,132,64137,0.01838378618992083,23523,0,72,0,0.03763969345175105,0,4820,0,1672,46,0,6538,3148,0.07144561146372085,383665,215082,
980,0.0,4,762,218,1746,35836,42909,634583,0.03141633183314517,168583,1842,0.051400194328452505,19386,102,30,0,132,64137,0.01838378618992083,23523,0,72,0,0.03763969345175105,0,4820,0,1672,46,0,6538,3148,0.07144561146372085,383665,215082,
980,0.0,4,762,218,1746,35836,42909,634583,0.03141633183314517,168583,1842,0.051400194328452505,19386,102,30,0,132,64137,0.01838378618992083,23523,0,72,0,0.03763969345175105,0,4820,0,1672,46,0,6538,3148,0.07144561146372085,383665,215082,
980,0.0,4,762,218,1746,35836,42909,634583,0.03141633183314517,168583,1842,0.051400194328452505,19386,102,30,0,132,64137,0.01838378618992083,23523,0,72,0,0.03763969345175105,0,4820,0,1672,46,0,6538,3148,0.07144561146372085,383665,215082,
980,0.0,4,762,218,1746,35836,42909,634583,0.03141633183314517,168583,1842,0.051400194328452505,19386,102,30,0,132,64137,0.01838378618992083,23523,0,72,0,0.03763969345175105,0,4820,0,1672,46,0,6538,3148,0.07144561146372085,383665,215082,
980,0.0,4,762,218,1746,35836,42909,634583,0.03141633183314517,168583,1842,0.051400194328452505,19386,102,30,0,132,64137,0.01838378618992083,23523,0,72,0,0.03763969345175105,0,4820,0,1672,46,0,6538,3148,0.07144561146372085,383665,215082,
980,0.0,4,762,218,1746,35836,42909,634583,0.03141633183314517,168583,1842,0.051400194328452505,19386,102,30,0,132,64137,0.01838378618992083,23523,0,72,0,0.03763969345175105,0,4820,0,1672,46,0,6538,3148,0.07144561146372085,383665,215082,
980,0.0,4,762,218,1746,35836,42909,634583,0.03141633183314517,168583,1842,0.051400194328452505,19386,102,30,0,132,64137,0.01838378618992083,23523,0,72,0,0.03763969345175105,0,4820,0,1672,46,0,6538,3148,0.07144561146372085,383665,215082,
980,0.0,4,762,218,1746,35836,42909,634583,0.03141633183314517,168583,1842,0.051400194328452505,19386,102,30,0,132,64137,0.01838378618992083,23523,0,72,0,0.03763969345175105,0,4820,0,1672,46,0,6538,3148,0.07144561146372085,383665,215082,
980,0.0,4,762,218,1746,35836,42909,634583,0.03141633183314517,168583,1842,0.051400194328452505,19386,102,30,0,132,64137,0.01838378618992083,23523,0,72,0,0.03763969345175105,0,4820,0,1672,46,0,6538,3148,0.07144561146372085,383665,215082,
980,0.0,4,762,218,1746,35836,42909,634583,0.03141633183314517,168583,1842,0.051400194328452505,19386,127,17,0,144,64137,0.01838378618992083,23523,0,110,0,0.09007127187403069,0,4820,0,1672,46,0,6538,3148,0.07144561146372085,383665,215082,
980,0.0,4,762,218,1746,35836,42909,634583,0.03141633183314517,168583,1842,0.051400194328452505,19386,127,17,0,144,64137,0.01838378618992083,23523,0,110,0,0.09007127187403069,0,4820,0,1672,46,0,6538,3148,0.07144561146372085,383665,215082,
980,0.0,4,762,218,1746,35836,42909,634583,0.03141633183314517,168583,1842,0.051400194328452505,19386,127,17,0,144,64137,0.01838378618992083,23523,0,110,0,0.09007127187403069,0,4820,0,1672,46,0,6538,3148,0.07144561146372085,383665,215082,
980,0.0,4,762,218,1746,35836,42909,634583,0.03141633183314517,168583,1842,0.051400194328452505,19386,127,17,0,144,64137,0.01838378618992083,23523,0,110,0,0.09007127187403069,0,4820,0,1672,46,0,6538,3148,0.07144561146372085,383665,215082,
368,0.0,37,134,234,539,35836,42909,634583,0.045639562124531324,168583,1842,0.051400194328452505,19386,96,26,12,134,64137,0.01838378618992083,23523,0,70,0,0.5951432511107706,0,4142,0,1789,480,0,6411,2353,0.09153925682118023,383665,215082,
368,0.096506730285985,37,134,234,539,35836,42909,634583,0.045639562124531324,168583,1842,0.051400194328452505,19386,2057,1028,150,3235,64137,0.01838378618992083,23523,98,1029,216,0.11871376458993439,346,4142,32,1789,480,118,6411,2353,0.09153925682118023,383665,215082,
368,0.096506730285985,37,134,234,539,35836,42909,634583,0.045639562124531324,168583,1842,0.051400194328452505,19386,2057,1028,150,3235,64137,0.01838378618992083,23523,98,1029,216,0.11871376458993439,346,4142,32,1789,480,118,6411,2353,0.09153925682118023,383665,215082,
368,0.096506730285985,37,134,234,539,35836,42909,634583,0.045639562124531324,168583,1842,0.051400194328452505,19386,2057,1028,150,3235,64137,0.01838378618992083,23523,98,1029,216,0.11871376458993439,346,4142,32,1789,480,118,6411,2353,0.09153925682118023,383665,215082,
368,0.096506730285985,37,134,234,539,35836,42909,634583,0.045639562124531324,168583,1842,0.051400194328452505,19386,2057,1028,150,3235,64137,0.01838378618992083,23523,98,1029,216,0.11871376458993439,346,4142,32,1789,480,118,6411,2353,0.09153925682118023,383665,215082,
368,0.096506730285985,37,134,234,539,35836,42909,634583,0.045639562124531324,168583,1842,0.051400194328452505,19386,2057,1028,150,3235,64137,0.01838378618992083,23523,98,1029,216,0.11871376458993439,346,4142,32,1789,480,118,6411,2353,0.09153925682118023,383665,215082,
368,0.096506730285985,37,134,234,539,35836,42909,634583,0.045639562124531324,168583,1842,0.051400194328452505,19386,2057,1028,150,3235,64137,0.01838378618992083,23523,98,1029,216,0.11871376458993439,346,4142,32,1789,480,118,6411,2353,0.09153925682118023,383665,215082,
368,0.096506730285985,37,134,234,539,35836,42909,634583,0.045639562124531324,168583,1842,0.051400194328452505,19386,2057,1028,150,3235,64137,0.01838378618992083,23523,98,1029,216,0.11871376458993439,346,4142,32,1789,480,118,6411,2353,0.09153925682118023,383665,215082,
368,0.096506730285985,37,134,234,539,35836,42909,634583,0.045639562124531324,168583,1842,0.051400194328452505,19386,2057,1028,150,3235,64137,0.01838378618992083,23523,98,1029,216,0.11871376458993439,346,4142,32,1789,480,118,6411,2353,0.09153925682118023,383665,215082,
368,0.096506730285985,37,134,234,539,35836,42909,634583,0.045639562124531324,168583,1842,0.051400194328452505,19386,2057,1028,150,3235,64137,0.01838378618992083,23523,98,1029,216,0.11871376458993439,346,4142,32,1789,480,118,6411,2353,0.09153925682118023,383665,215082,
368,0.096506730285985,37,134,234,539,35836,42909,634583,0.045639562124531324,168583,1842,0.051400194328452505,19386,2057,1028,150,3235,64137,0.01838378618992083,23523,98,1029,216,0.11871376458993439,346,4142,32,1789,480,118,6411,2353,0.09153925682118023,383665,215082,
368,0.096506730285985,37,134,234,539,35836,42909,634583,0.045639562124531324,168583,1842,0.051400194328452505,19386,2057,1028,150,3235,64137,0.01838378618992083,23523,98,1029,216,0.11871376458993439,346,4142,32,1789,480,118,6411,2353,0.09153925682118023,383665,215082,
368,0.096506730285985,37,134,234,539,35836,42909,634583,0.045639562124531324,168583,1842,0.051400194328452505,19386,2057,1028,150,3235,64137,0.01838378618992083,23523,98,1029,216,0.11871376458993439,346,4142,32,1789,480,118,6411,2353,0.09153925682118023,383665,215082,
368,0.096506730285985,37,134,234,539,35836,42909,634583,0.045639562124531324,168583,1842,0.051400194328452505,19386,2057,1028,150,3235,64137,0.01838378618992083,23523,98,1029,216,0.11871376458993439,346,4142,32,1789,480,118,6411,2353,0.09153925682118023,383665,215082,
368,0.096506730285985,37,134,234,539,35836,42909,634583,0.045639562124531324,168583,1842,0.051400194328452505,19386,2057,1028,150,3235,64137,0.01838378618992083,23523,98,1029,216,0.11871376458993439,346,4142,32,1789,480,118,6411,2353,0.09153925682118023,383665,215082,
368,0.10666666666666666,37,134,234,539,35836,42909,634583,0.045639562124531324,168583,1842,0.051400194328452505,19386,647,308,112,1067,64137,0.01838378618992083,23523,1,339,3,0.11281686505140527,4,4142,0,1789,480,2,6411,2353,0.09153925682118023,383665,215082,
368,0.10666666666666666,37,134,234,539,35836,42909,634583,0.045639562124531324,168583,1842,0.051400194328452505,19386,647,308,112,1067,64137,0.01838378618992083,23523,1,339,3,0.11281686505140527,4,4142,0,1789,480,2,6411,2353,0.09153925682118023,383665,215082,
2,0.0,0,2,0,4,35836,42909,634583,2.3161551823972203E-4,168583,1842,0.051400194328452505,19386,25,12,2,39,64137,0.01838378618992083,23523,0,13,0,0.0033372689103550695,0,132,0,31,12,0,175,101,0.05384292238447162,383665,215082,
2,0.0,0,2,0,4,35836,42909,634583,2.3161551823972203E-4,168583,1842,0.051400194328452505,19386,24,0,0,24,64137,0.01838378618992083,23523,0,24,0,0.2962962962962963,0,132,0,31,12,0,175,101,0.05384292238447162,383665,215082,
36,0.0513595166163142,0,1,35,37,35836,42909,634583,0.009299564406466568,168583,1842,0.051400194328452505,19386,419,45,16,480,64137,0.01838378618992083,23523,0,374,34,0.18002476685279512,34,3789,0,893,51,34,4733,2896,0.17832096982289167,383665,215082,
36,0.0513595166163142,0,1,35,37,35836,42909,634583,0.009299564406466568,168583,1842,0.051400194328452505,19386,419,45,16,480,64137,0.01838378618992083,23523,0,374,34,0.18002476685279512,34,3789,0,893,51,34,4733,2896,0.17832096982289167,383665,215082,
36,0.0513595166163142,0,1,35,37,35836,42909,634583,0.009299564406466568,168583,1842,0.051400194328452505,19386,419,45,16,480,64137,0.01838378618992083,23523,0,374,34,0.18002476685279512,34,3789,0,893,51,34,4733,2896,0.17832096982289167,383665,215082,
36,0.004437869822485207,0,1,35,37,35836,42909,634583,0.009299564406466568,168583,1842,0.051400194328452505,19386,246,54,2,302,64137,0.01838378618992083,23523,1,192,2,0.047495273218859844,3,3789,0,893,51,1,4733,2896,0.17832096982289167,383665,215082,
36,0.004437869822485207,0,1,35,37,35836,42909,634583,0.009299564406466568,168583,1842,0.051400194328452505,19386,246,54,2,302,64137,0.01838378618992083,23523,1,192,2,0.047495273218859844,3,3789,0,893,51,1,4733,2896,0.17832096982289167,383665,215082,
36,0.004437869822485207,0,1,35,37,35836,42909,634583,0.009299564406466568,168583,1842,0.051400194328452505,19386,246,54,2,302,64137,0.01838378618992083,23523,1,192,2,0.047495273218859844,3,3789,0,893,51,1,4733,2896,0.17832096982289167,383665,215082,
36,0.004437869822485207,0,1,35,37,35836,42909,634583,0.009299564406466568,168583,1842,0.051400194328452505,19386,246,54,2,302,64137,0.01838378618992083,23523,1,192,2,0.047495273218859844,3,3789,0,893,51,1,4733,2896,0.17832096982289167,383665,215082,
36,0.004437869822485207,0,1,35,37,35836,42909,634583,0.009299564406466568,168583,1842,0.051400194328452505,19386,246,54,2,302,64137,0.01838378618992083,23523,1,192,2,0.047495273218859844,3,3789,0,893,51,1,4733,2896,0.17832096982289167,383665,215082,
36,0.004437869822485207,0,1,35,37,35836,42909,634583,0.009299564406466568,168583,1842,0.051400194328452505,19386,246,54,2,302,64137,0.01838378618992083,23523,1,192,2,0.047495273218859844,3,3789,0,893,51,1,4733,2896,0.17832096982289167,383665,215082,
36,0.004437869822485207,0,1,35,37,35836,42909,634583,0.009299564406466568,168583,1842,0.051400194328452505,19386,246,54,2,302,64137,0.01838378618992083,23523,1,192,2,0.047495273218859844,3,3789,0,893,51,1,4733,2896,0.17832096982289167,383665,215082,
36,0.004437869822485207,0,1,35,37,35836,42909,634583,0.009299564406466568,168583,1842,0.051400194328452505,19386,246,54,2,302,64137,0.01838378618992083,23523,1,192,2,0.047495273218859844,3,3789,0,893,51,1,4733,2896,0.17832096982289167,383665,215082,
36,0.004437869822485207,0,1,35,37,35836,42909,634583,0.009299564406466568,168583,1842,0.051400194328452505,19386,246,54,2,302,64137,0.01838378618992083,23523,1,192,2,0.047495273218859844,3,3789,0,893,51,1,4733,2896,0.17832096982289167,383665,215082,
36,0.0,0,1,35,37,35836,42909,634583,0.009299564406466568,168583,1842,0.051400194328452505,19386,1839,570,18,2427,64137,0.01838378618992083,23523,0,1269,0,0.18302890183843773,0,3789,0,893,51,0,4733,2896,0.17832096982289167,383665,215082,
36,0.0,0,1,35,37,35836,42909,634583,0.009299564406466568,168583,1842,0.051400194328452505,19386,1839,570,18,2427,64137,0.01838378618992083,23523,0,1269,0,0.18302890183843773,0,3789,0,893,51,0,4733,2896,0.17832096982289167,383665,215082,
97,0.0,13,80,17,190,35836,42909,634583,0.014722604709560865,168583,1842,0.051400194328452505,19386,55,0,0,55,64137,0.01838378618992083,23523,0,55,0,0.5913978494623656,0,1983,0,572,117,0,2672,1411,0.09737577693632579,383665,215082,
97,0.0,13,80,17,190,35836,42909,634583,0.014722604709560865,168583,1842,0.051400194328452505,19386,94,109,0,203,64137,0.01838378618992083,23523,0,-15,0,0.014344137249675568,0,1983,0,572,117,0,2672,1411,0.09737577693632579,383665,215082,
97,0.0,13,80,17,190,35836,42909,634583,0.014722604709560865,168583,1842,0.051400194328452505,19386,94,109,0,203,64137,0.01838378618992083,23523,0,-15,0,0.014344137249675568,0,1983,0,572,117,0,2672,1411,0.09737577693632579,383665,215082,
97,5.161290322580645E-4,13,80,17,190,35836,42909,634583,0.014722604709560865,168583,1842,0.051400194328452505,19386,1,1,0,2,64137,0.01838378618992083,23523,1,0,1,2.5806451612903227E-4,2,1983,0,572,117,0,2672,1411,0.09737577693632579,383665,215082,
97,0.09392265193370165,13,80,17,190,35836,42909,634583,0.014722604709560865,168583,1842,0.051400194328452505,19386,127,118,28,273,64137,0.01838378618992083,23523,12,9,5,0.11383528260404753,17,1983,0,572,117,-7,2672,1411,0.09737577693632579,383665,215082,
97,0.08351099950453474,13,80,17,190,35836,42909,634583,0.014722604709560865,168583,1842,0.051400194328452505,19386,49,20,63,132,64137,0.01838378618992083,23523,5,29,11,0.10329075508753575,18,1983,2,572,117,6,2672,1411,0.09737577693632579,383665,215082,
97,0.08351099950453474,13,80,17,190,35836,42909,634583,0.014722604709560865,168583,1842,0.051400194328452505,19386,49,20,63,132,64137,0.01838378618992083,23523,5,29,11,0.10329075508753575,18,1983,2,572,117,6,2672,1411,0.09737577693632579,383665,215082,
97,0.08351099950453474,13,80,17,190,35836,42909,634583,0.014722604709560865,168583,1842,0.051400194328452505,19386,49,20,63,132,64137,0.01838378618992083,23523,5,29,11,0.10329075508753575,18,1983,2,572,117,6,2672,1411,0.09737577693632579,383665,215082,
97,0.08056042031523643,13,80,17,190,35836,42909,634583,0.014722604709560865,168583,1842,0.051400194328452505,19386,319,44,0,363,64137,0.01838378618992083,23523,23,275,23,0.06637984040499806,46,1983,0,572,117,0,2672,1411,0.09737577693632579,383665,215082,
97,0.08056042031523643,13,80,17,190,35836,42909,634583,0.014722604709560865,168583,1842,0.051400194328452505,19386,319,44,0,363,64137,0.01838378618992083,23523,23,275,23,0.06637984040499806,46,1983,0,572,117,0,2672,1411,0.09737577693632579,383665,215082,
97,0.08056042031523643,13,80,17,190,35836,42909,634583,0.014722604709560865,168583,1842,0.051400194328452505,19386,319,44,0,363,64137,0.01838378618992083,23523,23,275,23,0.06637984040499806,46,1983,0,572,117,0,2672,1411,0.09737577693632579,383665,215082,
97,0.0,13,80,17,190,35836,42909,634583,0.014722604709560865,168583,1842,0.051400194328452505,19386,97,0,0,97,64137,0.01838378618992083,23523,0,97,0,0.0842013888888889,0,1983,0,572,117,0,2672,1411,0.09737577693632579,383665,215082,
97,0.0,13,80,17,190,35836,42909,634583,0.014722604709560865,168583,1842,0.051400194328452505,19386,97,0,0,97,64137,0.01838378618992083,23523,0,97,0,0.0842013888888889,0,1983,0,572,117,0,2672,1411,0.09737577693632579,383665,215082,
97,0.0,13,80,17,190,35836,42909,634583,0.014722604709560865,168583,1842,0.051400194328452505,19386,97,0,0,97,64137,0.01838378618992083,23523,0,97,0,0.0842013888888889,0,1983,0,572,117,0,2672,1411,0.09737577693632579,383665,215082,
97,0.0,13,80,17,190,35836,42909,634583,0.014722604709560865,168583,1842,0.051400194328452505,19386,44,0,0,44,64137,0.01838378618992083,23523,0,44,0,0.07956600361663653,0,1983,0,572,117,0,2672,1411,0.09737577693632579,383665,215082,
97,0.0050528622935327476,13,80,17,190,35836,42909,634583,0.014722604709560865,168583,1842,0.051400194328452505,19386,43,34,0,77,64137,0.01838378618992083,23523,10,9,12,0.010378826010400391,22,1983,0,572,117,2,2672,1411,0.09737577693632579,383665,215082,
97,0.0050528622935327476,13,80,17,190,35836,42909,634583,0.014722604709560865,168583,1842,0.051400194328452505,19386,43,34,0,77,64137,0.01838378618992083,23523,10,9,12,0.010378826010400391,22,1983,0,572,117,2,2672,1411,0.09737577693632579,383665,215082,
97,0.0050528622935327476,13,80,17,190,35836,42909,634583,0.014722604709560865,168583,1842,0.051400194328452505,19386,43,34,0,77,64137,0.01838378618992083,23523,10,9,12,0.010378826010400391,22,1983,0,572,117,2,2672,1411,0.09737577693632579,383665,215082,
97,0.0050528622935327476,13,80,17,190,35836,42909,634583,0.014722604709560865,168583,1842,0.051400194328452505,19386,43,34,0,77,64137,0.01838378618992083,23523,10,9,12,0.010378826010400391,22,1983,0,572,117,2,2672,1411,0.09737577693632579,383665,215082,
51,0.015172408707450888,4,34,17,89,35836,42909,634583,0.011906935118008851,168583,1842,0.051400194328452505,19386,4,4,0,8,64137,0.01838378618992083,23523,2,0,2,0.007043518485103989,4,386,0,64,5,0,455,322,0.02109518954792519,383665,215082,
51,0.015172408707450888,4,34,17,89,35836,42909,634583,0.011906935118008851,168583,1842,0.051400194328452505,19386,4,4,0,8,64137,0.01838378618992083,23523,2,0,2,0.007043518485103989,4,386,0,64,5,0,455,322,0.02109518954792519,383665,215082,
51,0.015172408707450888,4,34,17,89,35836,42909,634583,0.011906935118008851,168583,1842,0.051400194328452505,19386,4,4,0,8,64137,0.01838378618992083,23523,2,0,2,0.007043518485103989,4,386,0,64,5,0,455,322,0.02109518954792519,383665,215082,
51,0.015172408707450888,4,34,17,89,35836,42909,634583,0.011906935118008851,168583,1842,0.051400194328452505,19386,4,4,0,8,64137,0.01838378618992083,23523,2,0,2,0.007043518485103989,4,386,0,64,5,0,455,322,0.02109518954792519,383665,215082,
51,0.015172408707450888,4,34,17,89,35836,42909,634583,0.011906935118008851,168583,1842,0.051400194328452505,19386,4,4,0,8,64137,0.01838378618992083,23523,2,0,2,0.007043518485103989,4,386,0,64,5,0,455,322,0.02109518954792519,383665,215082,
0,0.0,0,0,0,0,35836,42909,634583,0.0,168583,1842,0.051400194328452505,19386,41,30,9,80,64137,0.01838378618992083,23523,0,11,0,0.12199869868120349,0,125,0,127,29,0,281,-2,0.047114442138120716,383665,215082,
2606,0.0,56,541,2065,3203,35836,42909,634583,0.020572972112898113,168583,1842,0.051400194328452505,19386,0,0,0,0,64137,0.01838378618992083,23523,0,0,0,0.0,0,2734,0,541,56,0,3331,2193,0.02475597864884583,383665,215082,
524,0.0,0,637,-113,1161,35836,42909,634583,0.08133851596109587,168583,1842,0.051400194328452505,19386,126,29,0,155,64137,0.01838378618992083,23523,0,97,0,0.09954880105802935,0,650,0,666,0,0,1316,-16,0.09038840696637127,383665,215082,
524,0.0,0,637,-113,1161,35836,42909,634583,0.08133851596109587,168583,1842,0.051400194328452505,19386,126,29,0,155,64137,0.01838378618992083,23523,0,97,0,0.09954880105802935,0,650,0,666,0,0,1316,-16,0.09038840696637127,383665,215082,
524,0.0,0,637,-113,1161,35836,42909,634583,0.08133851596109587,168583,1842,0.051400194328452505,19386,126,29,0,155,64137,0.01838378618992083,23523,0,97,0,0.09954880105802935,0,650,0,666,0,0,1316,-16,0.09038840696637127,383665,215082,
524,0.0,0,637,-113,1161,35836,42909,634583,0.08133851596109587,168583,1842,0.051400194328452505,19386,126,29,0,155,64137,0.01838378618992083,23523,0,97,0,0.09954880105802935,0,650,0,666,0,0,1316,-16,0.09038840696637127,383665,215082,
524,0.0,0,637,-113,1161,35836,42909,634583,0.08133851596109587,168583,1842,0.051400194328452505,19386,126,29,0,155,64137,0.01838378618992083,23523,0,97,0,0.09954880105802935,0,650,0,666,0,0,1316,-16,0.09038840696637127,383665,215082,
524,0.0,0,637,-113,1161,35836,42909,634583,0.08133851596109587,168583,1842,0.051400194328452505,19386,126,29,0,155,64137,0.01838378618992083,23523,0,97,0,0.09954880105802935,0,650,0,666,0,0,1316,-16,0.09038840696637127,383665,215082,
11,0.0,11,46,-35,68,35836,42909,634583,0.022212944953375655,168583,1842,0.051400194328452505,19386,3,14,1,18,64137,0.01838378618992083,23523,0,-11,0,0.012802275960170697,0,1022,0,727,24,0,1773,295,0.06285018461202671,383665,215082,
11,0.0,11,46,-35,68,35836,42909,634583,0.022212944953375655,168583,1842,0.051400194328452505,19386,51,1,0,52,64137,0.01838378618992083,23523,0,50,0,0.0058055011001001185,0,1022,0,727,24,0,1773,295,0.06285018461202671,383665,215082,
11,0.0,11,46,-35,68,35836,42909,634583,0.022212944953375655,168583,1842,0.051400194328452505,19386,51,1,0,52,64137,0.01838378618992083,23523,0,50,0,0.0058055011001001185,0,1022,0,727,24,0,1773,295,0.06285018461202671,383665,215082,
11,0.0,11,46,-35,68,35836,42909,634583,0.022212944953375655,168583,1842,0.051400194328452505,19386,51,1,0,52,64137,0.01838378618992083,23523,0,50,0,0.0058055011001001185,0,1022,0,727,24,0,1773,295,0.06285018461202671,383665,215082,
11,0.0,11,46,-35,68,35836,42909,634583,0.022212944953375655,168583,1842,0.051400194328452505,19386,61,0,0,61,64137,0.01838378618992083,23523,0,61,0,0.14055299539170507,0,1022,0,727,24,0,1773,295,0.06285018461202671,383665,215082,
11,0.0,11,46,-35,68,35836,42909,634583,0.022212944953375655,168583,1842,0.051400194328452505,19386,143,1,0,144,64137,0.01838378618992083,23523,0,142,0,0.03285821646477384,0,1022,0,727,24,0,1773,295,0.06285018461202671,383665,215082,
1494,0.07751189727933913,75,667,827,2236,35836,42909,634583,0.028000899175463834,168583,1842,0.051400194328452505,19386,1199,179,53,1431,64137,0.01838378618992083,23523,8,1020,26,0.14958321102786012,43,20753,9,11868,3736,18,36357,8885,0.08099588858691166,383665,215082,
1494,0.07751189727933913,75,667,827,2236,35836,42909,634583,0.028000899175463834,168583,1842,0.051400194328452505,19386,1199,179,53,1431,64137,0.01838378618992083,23523,8,1020,26,0.14958321102786012,43,20753,9,11868,3736,18,36357,8885,0.08099588858691166,383665,215082,
1494,0.07751189727933913,75,667,827,2236,35836,42909,634583,0.028000899175463834,168583,1842,0.051400194328452505,19386,1199,179,53,1431,64137,0.01838378618992083,23523,8,1020,26,0.14958321102786012,43,20753,9,11868,3736,18,36357,8885,0.08099588858691166,383665,215082,
1494,0.07751189727933913,75,667,827,2236,35836,42909,634583,0.028000899175463834,168583,1842,0.051400194328452505,19386,1199,179,53,1431,64137,0.01838378618992083,23523,8,1020,26,0.14958321102786012,43,20753,9,11868,3736,18,36357,8885,0.08099588858691166,383665,215082,
1494,0.07751189727933913,75,667,827,2236,35836,42909,634583,0.028000899175463834,168583,1842,0.051400194328452505,19386,1199,179,53,1431,64137,0.01838378618992083,23523,8,1020,26,0.14958321102786012,43,20753,9,11868,3736,18,36357,8885,0.08099588858691166,383665,215082,
1494,0.0,75,667,827,2236,35836,42909,634583,0.028000899175463834,168583,1842,0.051400194328452505,19386,286,285,0,571,64137,0.01838378618992083,23523,0,1,0,0.014776227448185743,0,20753,0,11868,3736,0,36357,8885,0.08099588858691166,383665,215082,
1494,0.010190300346266076,75,667,827,2236,35836,42909,634583,0.028000899175463834,168583,1842,0.051400194328452505,19386,510,175,4,689,64137,0.01838378618992083,23523,28,335,43,0.057081423680768156,71,20753,0,11868,3736,15,36357,8885,0.08099588858691166,383665,215082,
1494,0.010190300346266076,75,667,827,2236,35836,42909,634583,0.028000899175463834,168583,1842,0.051400194328452505,19386,510,175,4,689,64137,0.01838378618992083,23523,28,335,43,0.057081423680768156,71,20753,0,11868,3736,15,36357,8885,0.08099588858691166,383665,215082,
1494,0.07026301948730503,75,667,827,2236,35836,42909,634583,0.028000899175463834,168583,1842,0.051400194328452505,19386,957,499,71,1527,64137,0.01838378618992083,23523,38,458,34,0.10281093304379259,92,20753,20,11868,3736,-4,36357,8885,0.08099588858691166,383665,215082,
1494,0.07026301948730503,75,667,827,2236,35836,42909,634583,0.028000899175463834,168583,1842,0.051400194328452505,19386,957,499,71,1527,64137,0.01838378618992083,23523,38,458,34,0.10281093304379259,92,20753,20,11868,3736,-4,36357,8885,0.08099588858691166,383665,215082,
1494,0.07026301948730503,75,667,827,2236,35836,42909,634583,0.028000899175463834,168583,1842,0.051400194328452505,19386,957,499,71,1527,64137,0.01838378618992083,23523,38,458,34,0.10281093304379259,92,20753,20,11868,3736,-4,36357,8885,0.08099588858691166,383665,215082,
1494,0.07026301948730503,75,667,827,2236,35836,42909,634583,0.028000899175463834,168583,1842,0.051400194328452505,19386,957,499,71,1527,64137,0.01838378618992083,23523,38,458,34,0.10281093304379259,92,20753,20,11868,3736,-4,36357,8885,0.08099588858691166,383665,215082,
1494,0.07026301948730503,75,667,827,2236,35836,42909,634583,0.028000899175463834,168583,1842,0.051400194328452505,19386,957,499,71,1527,64137,0.01838378618992083,23523,38,458,34,0.10281093304379259,92,20753,20,11868,3736,-4,36357,8885,0.08099588858691166,383665,215082,
1494,0.07026301948730503,75,667,827,2236,35836,42909,634583,0.028000899175463834,168583,1842,0.051400194328452505,19386,957,499,71,1527,64137,0.01838378618992083,23523,38,458,34,0.10281093304379259,92,20753,20,11868,3736,-4,36357,8885,0.08099588858691166,383665,215082,
1494,0.07026301948730503,75,667,827,2236,35836,42909,634583,0.028000899175463834,168583,1842,0.051400194328452505,19386,957,499,71,1527,64137,0.01838378618992083,23523,38,458,34,0.10281093304379259,92,20753,20,11868,3736,-4,36357,8885,0.08099588858691166,383665,215082,
1494,0.07026301948730503,75,667,827,2236,35836,42909,634583,0.028000899175463834,168583,1842,0.051400194328452505,19386,957,499,71,1527,64137,0.01838378618992083,23523,38,458,34,0.10281093304379259,92,20753,20,11868,3736,-4,36357,8885,0.08099588858691166,383665,215082,
1494,0.07026301948730503,75,667,827,2236,35836,42909,634583,0.028000899175463834,168583,1842,0.051400194328452505,19386,957,499,71,1527,64137,0.01838378618992083,23523,38,458,34,0.10281093304379259,92,20753,20,11868,3736,-4,36357,8885,0.08099588858691166,383665,215082,
1494,0.07026301948730503,75,667,827,2236,35836,42909,634583,0.028000899175463834,168583,1842,0.051400194328452505,19386,957,499,71,1527,64137,0.01838378618992083,23523,38,458,34,0.10281093304379259,92,20753,20,11868,3736,-4,36357,8885,0.08099588858691166,383665,215082,
1494,0.09375,75,667,827,2236,35836,42909,634583,0.028000899175463834,168583,1842,0.051400194328452505,19386,291,446,31,768,64137,0.01838378618992083,23523,0,-155,3,0.07677623818442826,6,20753,3,11868,3736,3,36357,8885,0.08099588858691166,383665,215082,
1494,0.0,75,667,827,2236,35836,42909,634583,0.028000899175463834,168583,1842,0.051400194328452505,19386,16,1,0,17,64137,0.01838378618992083,23523,0,15,0,0.041686202138095006,0,20753,0,11868,3736,0,36357,8885,0.08099588858691166,383665,215082,
1494,0.0015003750937734434,75,667,827,2236,35836,42909,634583,0.028000899175463834,168583,1842,0.051400194328452505,19386,106,4,0,110,64137,0.01838378618992083,23523,2,102,2,0.10948288104380288,4,20753,0,11868,3736,0,36357,8885,0.08099588858691166,383665,215082,
1494,0.0015003750937734434,75,667,827,2236,35836,42909,634583,0.028000899175463834,168583,1842,0.051400194328452505,19386,106,4,0,110,64137,0.01838378618992083,23523,2,102,2,0.10948288104380288,4,20753,0,11868,3736,0,36357,8885,0.08099588858691166,383665,215082,
1494,0.001354097224676013,75,667,827,2236,35836,42909,634583,0.028000899175463834,168583,1842,0.051400194328452505,19386,273,266,20,559,64137,0.01838378618992083,23523,7,7,7,0.1443459248626542,14,20753,0,11868,3736,0,36357,8885,0.08099588858691166,383665,215082,
1494,0.0010762332184836442,75,667,827,2236,35836,42909,634583,0.028000899175463834,168583,1842,0.051400194328452505,19386,667,125,0,792,64137,0.01838378618992083,23523,6,542,6,0.09356575515429963,12,20753,0,11868,3736,0,36357,8885,0.08099588858691166,383665,215082,
1494,0.001483679525222552,75,667,827,2236,35836,42909,634583,0.028000899175463834,168583,1842,0.051400194328452505,19386,88,6,0,94,64137,0.01838378618992083,23523,2,82,2,0.15030946708990217,4,20753,0,11868,3736,0,36357,8885,0.08099588858691166,383665,215082,
1494,0.004245306714740278,75,667,827,2236,35836,42909,634583,0.028000899175463834,168583,1842,0.051400194328452505,19386,623,260,77,960,64137,0.01838378618992083,23523,3,363,50,0.0701367737925093,53,20753,0,11868,3736,47,36357,8885,0.08099588858691166,383665,215082,
1494,4.222081486172683E-4,75,667,827,2236,35836,42909,634583,0.028000899175463834,168583,1842,0.051400194328452505,19386,29,25,1,55,64137,0.01838378618992083,23523,1,4,1,0.04187105266978195,2,20753,0,11868,3736,0,36357,8885,0.08099588858691166,383665,215082,
1494,0.07190082644628099,75,667,827,2236,35836,42909,634583,0.028000899175463834,168583,1842,0.051400194328452505,19386,452,152,7,611,64137,0.01838378618992083,23523,8,300,79,0.05674800966832527,87,20753,0,11868,3736,71,36357,8885,0.08099588858691166,383665,215082,
1494,0.07190082644628099,75,667,827,2236,35836,42909,634583,0.028000899175463834,168583,1842,0.051400194328452505,19386,452,152,7,611,64137,0.01838378618992083,23523,8,300,79,0.05674800966832527,87,20753,0,11868,3736,71,36357,8885,0.08099588858691166,383665,215082,
1494,0.0,75,667,827,2236,35836,42909,634583,0.028000899175463834,168583,1842,0.051400194328452505,19386,168,78,0,246,64137,0.01838378618992083,23523,0,90,0,0.029750837791531773,0,20753,0,11868,3736,0,36357,8885,0.08099588858691166,383665,215082,
1494,0.7420382165605095,75,667,827,2236,35836,42909,634583,0.028000899175463834,168583,1842,0.051400194328452505,19386,233,0,0,233,64137,0.01838378618992083,23523,0,233,233,0.7420382165605095,233,20753,0,11868,3736,233,36357,8885,0.08099588858691166,383665,215082,
1494,0.7420382165605095,75,667,827,2236,35836,42909,634583,0.028000899175463834,168583,1842,0.051400194328452505,19386,233,0,0,233,64137,0.01838378618992083,23523,0,233,233,0.7420382165605095,233,20753,0,11868,3736,233,36357,8885,0.08099588858691166,383665,215082,
1494,0.7420382165605095,75,667,827,2236,35836,42909,634583,0.028000899175463834,168583,1842,0.051400194328452505,19386,233,0,0,233,64137,0.01838378618992083,23523,0,233,233,0.7420382165605095,233,20753,0,11868,3736,233,36357,8885,0.08099588858691166,383665,215082,
1494,0.005368300445121098,75,667,827,2236,35836,42909,634583,0.028000899175463834,168583,1842,0.051400194328452505,19386,202,98,7,307,64137,0.01838378618992083,23523,28,104,20,0.017366937650235035,48,20753,0,11868,3736,-8,36357,8885,0.08099588858691166,383665,215082,
1494,0.005368300445121098,75,667,827,2236,35836,42909,634583,0.028000899175463834,168583,1842,0.051400194328452505,19386,202,98,7,307,64137,0.01838378618992083,23523,28,104,20,0.017366937650235035,48,20753,0,11868,3736,-8,36357,8885,0.08099588858691166,383665,215082,
1494,0.07102409510792249,75,667,827,2236,35836,42909,634583,0.028000899175463834,168583,1842,0.051400194328452505,19386,3515,3015,1500,8030,64137,0.01838378618992083,23523,238,500,113,0.10788099920565586,369,20753,18,11868,3736,-125,36357,8885,0.08099588858691166,383665,215082,
1494,0.07102409510792249,75,667,827,2236,35836,42909,634583,0.028000899175463834,168583,1842,0.051400194328452505,19386,3515,3015,1500,8030,64137,0.01838378618992083,23523,238,500,113,0.10788099920565586,369,20753,18,11868,3736,-125,36357,8885,0.08099588858691166,383665,215082,
1494,0.03698866889982685,75,667,827,2236,35836,42909,634583,0.028000899175463834,168583,1842,0.051400194328452505,19386,6011,3589,1645,11245,64137,0.01838378618992083,23523,105,2422,116,0.12113236937589592,229,20753,8,11868,3736,11,36357,8885,0.08099588858691166,383665,215082,
1494,0.03698866889982685,75,667,827,2236,35836,42909,634583,0.028000899175463834,168583,1842,0.051400194328452505,19386,6011,3589,1645,11245,64137,0.01838378618992083,23523,105,2422,116,0.12113236937589592,229,20753,8,11868,3736,11,36357,8885,0.08099588858691166,383665,215082,
1494,0.03698866889982685,75,667,827,2236,35836,42909,634583,0.028000899175463834,168583,1842,0.051400194328452505,19386,6011,3589,1645,11245,64137,0.01838378618992083,23523,105,2422,116,0.12113236937589592,229,20753,8,11868,3736,11,36357,8885,0.08099588858691166,383665,215082,
1494,0.03698866889982685,75,667,827,2236,35836,42909,634583,0.028000899175463834,168583,1842,0.051400194328452505,19386,6011,3589,1645,11245,64137,0.01838378618992083,23523,105,2422,116,0.12113236937589592,229,20753,8,11868,3736,11,36357,8885,0.08099588858691166,383665,215082,
1494,0.03698866889982685,75,667,827,2236,35836,42909,634583,0.028000899175463834,168583,1842,0.051400194328452505,19386,6011,3589,1645,11245,64137,0.01838378618992083,23523,105,2422,116,0.12113236937589592,229,20753,8,11868,3736,11,36357,8885,0.08099588858691166,383665,215082,
1494,0.03698866889982685,75,667,827,2236,35836,42909,634583,0.028000899175463834,168583,1842,0.051400194328452505,19386,6011,3589,1645,11245,64137,0.01838378618992083,23523,105,2422,116,0.12113236937589592,229,20753,8,11868,3736,11,36357,8885,0.08099588858691166,383665,215082,
1494,0.03698866889982685,75,667,827,2236,35836,42909,634583,0.028000899175463834,168583,1842,0.051400194328452505,19386,6011,3589,1645,11245,64137,0.01838378618992083,23523,105,2422,116,0.12113236937589592,229,20753,8,11868,3736,11,36357,8885,0.08099588858691166,383665,215082,
1494,0.03698866889982685,75,667,827,2236,35836,42909,634583,0.028000899175463834,168583,1842,0.051400194328452505,19386,6011,3589,1645,11245,64137,0.01838378618992083,23523,105,2422,116,0.12113236937589592,229,20753,8,11868,3736,11,36357,8885,0.08099588858691166,383665,215082,
1494,0.03698866889982685,75,667,827,2236,35836,42909,634583,0.028000899175463834,168583,1842,0.051400194328452505,19386,6011,3589,1645,11245,64137,0.01838378618992083,23523,105,2422,116,0.12113236937589592,229,20753,8,11868,3736,11,36357,8885,0.08099588858691166,383665,215082,
1494,0.0054967966753989884,75,667,827,2236,35836,42909,634583,0.028000899175463834,168583,1842,0.051400194328452505,19386,227,37,0,264,64137,0.01838378618992083,23523,23,190,23,0.03226721340412728,46,20753,0,11868,3736,0,36357,8885,0.08099588858691166,383665,215082,
252,0.0,10,50,202,312,35836,42909,634583,0.03559470365925637,168583,1842,0.051400194328452505,19386,55,3,0,58,64137,0.01838378618992083,23523,0,52,0,0.00474126679594173,0,1348,0,775,35,0,2158,573,0.03803808573803486,383665,215082,
252,0.0,10,50,202,312,35836,42909,634583,0.03559470365925637,168583,1842,0.051400194328452505,19386,55,3,0,58,64137,0.01838378618992083,23523,0,52,0,0.00474126679594173,0,1348,0,775,35,0,2158,573,0.03803808573803486,383665,215082,
252,0.0023752969121140144,10,50,202,312,35836,42909,634583,0.03559470365925637,168583,1842,0.051400194328452505,19386,13,10,6,29,64137,0.01838378618992083,23523,1,3,1,0.060570662699116595,2,1348,0,775,35,0,2158,573,0.03803808573803486,383665,215082,
252,0.0023752969121140144,10,50,202,312,35836,42909,634583,0.03559470365925637,168583,1842,0.051400194328452505,19386,13,10,6,29,64137,0.01838378618992083,23523,1,3,1,0.060570662699116595,2,1348,0,775,35,0,2158,573,0.03803808573803486,383665,215082,
167,0.0,26,183,-16,376,35836,42909,634583,0.007151934259716146,168583,1842,0.051400194328452505,19386,150,124,24,298,64137,0.01838378618992083,23523,0,26,0,0.1050639877049997,0,2303,0,1120,215,0,3638,1183,0.04549265234335249,383665,215082,
167,0.0,26,183,-16,376,35836,42909,634583,0.007151934259716146,168583,1842,0.051400194328452505,19386,150,124,24,298,64137,0.01838378618992083,23523,0,26,0,0.1050639877049997,0,2303,0,1120,215,0,3638,1183,0.04549265234335249,383665,215082,
167,0.0,26,183,-16,376,35836,42909,634583,0.007151934259716146,168583,1842,0.051400194328452505,19386,7,3,0,10,64137,0.01838378618992083,23523,0,4,0,0.06622516556291391,0,2303,0,1120,215,0,3638,1183,0.04549265234335249,383665,215082,
167,0.0,26,183,-16,376,35836,42909,634583,0.007151934259716146,168583,1842,0.051400194328452505,19386,6,3,0,9,64137,0.01838378618992083,23523,0,3,0,0.07136493228795437,0,2303,0,1120,215,0,3638,1183,0.04549265234335249,383665,215082,
167,0.0,26,183,-16,376,35836,42909,634583,0.007151934259716146,168583,1842,0.051400194328452505,19386,6,3,0,9,64137,0.01838378618992083,23523,0,3,0,0.07136493228795437,0,2303,0,1120,215,0,3638,1183,0.04549265234335249,383665,215082,
167,0.0,26,183,-16,376,35836,42909,634583,0.007151934259716146,168583,1842,0.051400194328452505,19386,54,1,0,55,64137,0.01838378618992083,23523,0,53,0,0.004897016006806881,0,2303,0,1120,215,0,3638,1183,0.04549265234335249,383665,215082,
167,0.0,26,183,-16,376,35836,42909,634583,0.007151934259716146,168583,1842,0.051400194328452505,19386,185,114,6,305,64137,0.01838378618992083,23523,0,71,0,0.14151645708970226,0,2303,0,1120,215,0,3638,1183,0.04549265234335249,383665,215082,
167,0.0,26,183,-16,376,35836,42909,634583,0.007151934259716146,168583,1842,0.051400194328452505,19386,185,114,6,305,64137,0.01838378618992083,23523,0,71,0,0.14151645708970226,0,2303,0,1120,215,0,3638,1183,0.04549265234335249,383665,215082,
167,0.005583627273572962,26,183,-16,376,35836,42909,634583,0.007151934259716146,168583,1842,0.051400194328452505,19386,162,30,23,215,64137,0.01838378618992083,23523,9,132,103,0.02625447311504912,130,2303,18,1120,215,94,3638,1183,0.04549265234335249,383665,215082,
167,0.17136887217528707,26,183,-16,376,35836,42909,634583,0.007151934259716146,168583,1842,0.051400194328452505,19386,188,123,38,349,64137,0.01838378618992083,23523,25,65,23,0.09789021797742187,56,2303,8,1120,215,-2,3638,1183,0.04549265234335249,383665,215082,
167,0.17136887217528707,26,183,-16,376,35836,42909,634583,0.007151934259716146,168583,1842,0.051400194328452505,19386,188,123,38,349,64137,0.01838378618992083,23523,25,65,23,0.09789021797742187,56,2303,8,1120,215,-2,3638,1183,0.04549265234335249,383665,215082,
167,0.17136887217528707,26,183,-16,376,35836,42909,634583,0.007151934259716146,168583,1842,0.051400194328452505,19386,188,123,38,349,64137,0.01838378618992083,23523,25,65,23,0.09789021797742187,56,2303,8,1120,215,-2,3638,1183,0.04549265234335249,383665,215082,
167,0.17136887217528707,26,183,-16,376,35836,42909,634583,0.007151934259716146,168583,1842,0.051400194328452505,19386,188,123,38,349,64137,0.01838378618992083,23523,25,65,23,0.09789021797742187,56,2303,8,1120,215,-2,3638,1183,0.04549265234335249,383665,215082,
167,0.17136887217528707,26,183,-16,376,35836,42909,634583,0.007151934259716146,168583,1842,0.051400194328452505,19386,188,123,38,349,64137,0.01838378618992083,23523,25,65,23,0.09789021797742187,56,2303,8,1120,215,-2,3638,1183,0.04549265234335249,383665,215082,
167,0.0,26,183,-16,376,35836,42909,634583,0.007151934259716146,168583,1842,0.051400194328452505,19386,37,0,0,37,64137,0.01838378618992083,23523,0,37,0,0.006561447065082462,0,2303,0,1120,215,0,3638,1183,0.04549265234335249,383665,215082,
167,0.0,26,183,-16,376,35836,42909,634583,0.007151934259716146,168583,1842,0.051400194328452505,19386,37,0,0,37,64137,0.01838378618992083,23523,0,37,0,0.006561447065082462,0,2303,0,1120,215,0,3638,1183,0.04549265234335249,383665,215082,
167,0.0013026487190620929,26,183,-16,376,35836,42909,634583,0.007151934259716146,168583,1842,0.051400194328452505,19386,81,3,0,84,64137,0.01838378618992083,23523,3,78,3,0.007431574707236192,6,2303,0,1120,215,0,3638,1183,0.04549265234335249,383665,215082,
167,0.0,26,183,-16,376,35836,42909,634583,0.007151934259716146,168583,1842,0.051400194328452505,19386,125,53,22,200,64137,0.01838378618992083,23523,0,72,0,0.14368999975623273,0,2303,0,1120,215,0,3638,1183,0.04549265234335249,383665,215082,
167,0.002795396926221046,26,183,-16,376,35836,42909,634583,0.007151934259716146,168583,1842,0.051400194328452505,19386,394,246,68,708,64137,0.01838378618992083,23523,18,148,18,0.028335323387705055,36,2303,0,1120,215,0,3638,1183,0.04549265234335249,383665,215082,
167,0.002795396926221046,26,183,-16,376,35836,42909,634583,0.007151934259716146,168583,1842,0.051400194328452505,19386,394,246,68,708,64137,0.01838378618992083,23523,18,148,18,0.028335323387705055,36,2303,0,1120,215,0,3638,1183,0.04549265234335249,383665,215082,
167,0.002795396926221046,26,183,-16,376,35836,42909,634583,0.007151934259716146,168583,1842,0.051400194328452505,19386,394,246,68,708,64137,0.01838378618992083,23523,18,148,18,0.028335323387705055,36,2303,0,1120,215,0,3638,1183,0.04549265234335249,383665,215082,
167,0.002795396926221046,26,183,-16,376,35836,42909,634583,0.007151934259716146,168583,1842,0.051400194328452505,19386,394,246,68,708,64137,0.01838378618992083,23523,18,148,18,0.028335323387705055,36,2303,0,1120,215,0,3638,1183,0.04549265234335249,383665,215082,
15,0.005120106841848797,0,18,-3,33,35836,42909,634583,0.002563417799833329,168583,1842,0.051400194328452505,19386,22,17,1,40,64137,0.01838378618992083,23523,3,5,5,0.05364431417791912,8,235,0,151,4,2,390,84,0.04185207062462715,383665,215082,
15,0.0,0,18,-3,33,35836,42909,634583,0.002563417799833329,168583,1842,0.051400194328452505,19386,98,98,0,196,64137,0.01838378618992083,23523,0,0,0,0.10876145452148481,0,235,0,151,4,0,390,84,0.04185207062462715,383665,215082,
15,0.0017196904557179708,0,18,-3,33,35836,42909,634583,0.002563417799833329,168583,1842,0.051400194328452505,19386,75,5,0,80,64137,0.01838378618992083,23523,5,70,5,0.023359688485239324,10,235,0,151,4,0,390,84,0.04185207062462715,383665,215082,
0,0.0,0,0,0,0,35836,42909,634583,0.0,168583,1842,0.051400194328452505,19386,12,1,3,16,64137,0.01838378618992083,23523,0,11,0,0.3018867924528302,0,191,0,21,4,0,216,170,0.176100663912775,383665,215082,
0,0.0,0,0,0,0,35836,42909,634583,0.0,168583,1842,0.051400194328452505,19386,12,1,3,16,64137,0.01838378618992083,23523,0,11,0,0.3018867924528302,0,191,0,21,4,0,216,170,0.176100663912775,383665,215082,
0,0.0,0,0,0,0,35836,42909,634583,0.0,168583,1842,0.051400194328452505,19386,12,1,3,16,64137,0.01838378618992083,23523,0,11,0,0.3018867924528302,0,191,0,21,4,0,216,170,0.176100663912775,383665,215082,
0,0.0,0,0,0,0,35836,42909,634583,0.0,168583,1842,0.051400194328452505,19386,32,3,0,35,64137,0.01838378618992083,23523,0,29,0,0.4430379746835443,0,191,0,21,4,0,216,170,0.176100663912775,383665,215082,
21,0.21818181818181817,1,16,5,38,35836,42909,634583,0.02086613642841587,168583,1842,0.051400194328452505,19386,104,12,3,119,64137,0.01838378618992083,23523,3,92,8,0.07090079318453395,12,359,1,64,4,5,427,295,0.01921592090589185,383665,215082,
21,0.005555555555555556,1,16,5,38,35836,42909,634583,0.02086613642841587,168583,1842,0.051400194328452505,19386,49,11,1,61,64137,0.01838378618992083,23523,2,38,2,0.012348873706023212,4,359,0,64,4,0,427,295,0.01921592090589185,383665,215082,
21,0.21818181818181817,1,16,5,38,35836,42909,634583,0.02086613642841587,168583,1842,0.051400194328452505,19386,104,12,3,119,64137,0.01838378618992083,23523,3,92,8,0.07090079318453395,12,359,1,64,4,5,427,295,0.01921592090589185,383665,215082,
21,0.21818181818181817,1,16,5,38,35836,42909,634583,0.02086613642841587,168583,1842,0.051400194328452505,19386,104,12,3,119,64137,0.01838378618992083,23523,3,92,8,0.07090079318453395,12,359,1,64,4,5,427,295,0.01921592090589185,383665,215082,
21,0.21818181818181817,1,16,5,38,35836,42909,634583,0.02086613642841587,168583,1842,0.051400194328452505,19386,104,12,3,119,64137,0.01838378618992083,23523,3,92,8,0.07090079318453395,12,359,1,64,4,5,427,295,0.01921592090589185,383665,215082,
21,0.21818181818181817,1,16,5,38,35836,42909,634583,0.02086613642841587,168583,1842,0.051400194328452505,19386,104,12,3,119,64137,0.01838378618992083,23523,3,92,8,0.07090079318453395,12,359,1,64,4,5,427,295,0.01921592090589185,383665,215082,
21,0.21818181818181817,1,16,5,38,35836,42909,634583,0.02086613642841587,168583,1842,0.051400194328452505,19386,104,12,3,119,64137,0.01838378618992083,23523,3,92,8,0.07090079318453395,12,359,1,64,4,5,427,295,0.01921592090589185,383665,215082,
21,0.21818181818181817,1,16,5,38,35836,42909,634583,0.02086613642841587,168583,1842,0.051400194328452505,19386,104,12,3,119,64137,0.01838378618992083,23523,3,92,8,0.07090079318453395,12,359,1,64,4,5,427,295,0.01921592090589185,383665,215082,
21,0.0024778030146603344,1,16,5,38,35836,42909,634583,0.02086613642841587,168583,1842,0.051400194328452505,19386,36,14,0,50,64137,0.01838378618992083,23523,6,22,6,0.01260869949041316,12,359,0,64,4,0,427,295,0.01921592090589185,383665,215082,
27,0.3870967741935484,38,10,17,75,35836,42909,634583,0.07178587276365685,168583,1842,0.051400194328452505,19386,48,107,49,204,64137,0.01838378618992083,23523,0,-59,10,0.17007898634924695,48,1305,38,709,145,10,2159,596,0.15662848939393897,383665,215082,
27,0.0,38,10,17,75,35836,42909,634583,0.07178587276365685,168583,1842,0.051400194328452505,19386,185,330,63,578,64137,0.01838378618992083,23523,0,-145,0,0.14513161225583224,0,1305,0,709,145,0,2159,596,0.15662848939393897,383665,215082,
27,0.0,38,10,17,75,35836,42909,634583,0.07178587276365685,168583,1842,0.051400194328452505,19386,185,330,63,578,64137,0.01838378618992083,23523,0,-145,0,0.14513161225583224,0,1305,0,709,145,0,2159,596,0.15662848939393897,383665,215082,
27,0.0,38,10,17,75,35836,42909,634583,0.07178587276365685,168583,1842,0.051400194328452505,19386,185,330,63,578,64137,0.01838378618992083,23523,0,-145,0,0.14513161225583224,0,1305,0,709,145,0,2159,596,0.15662848939393897,383665,215082,
27,0.0,38,10,17,75,35836,42909,634583,0.07178587276365685,168583,1842,0.051400194328452505,19386,185,330,63,578,64137,0.01838378618992083,23523,0,-145,0,0.14513161225583224,0,1305,0,709,145,0,2159,596,0.15662848939393897,383665,215082,
27,0.0,38,10,17,75,35836,42909,634583,0.07178587276365685,168583,1842,0.051400194328452505,19386,145,52,1,198,64137,0.01838378618992083,23523,0,93,0,0.095976754392223,0,1305,0,709,145,0,2159,596,0.15662848939393897,383665,215082,
27,0.09001077973409989,38,10,17,75,35836,42909,634583,0.07178587276365685,168583,1842,0.051400194328452505,19386,485,30,15,530,64137,0.01838378618992083,23523,3,455,6,0.14786813296962883,9,1305,0,709,145,3,2159,596,0.15662848939393897,383665,215082,
27,0.09001077973409989,38,10,17,75,35836,42909,634583,0.07178587276365685,168583,1842,0.051400194328452505,19386,485,30,15,530,64137,0.01838378618992083,23523,3,455,6,0.14786813296962883,9,1305,0,709,145,3,2159,596,0.15662848939393897,383665,215082,
27,0.09001077973409989,38,10,17,75,35836,42909,634583,0.07178587276365685,168583,1842,0.051400194328452505,19386,485,30,15,530,64137,0.01838378618992083,23523,3,455,6,0.14786813296962883,9,1305,0,709,145,3,2159,596,0.15662848939393897,383665,215082,
27,0.014084507042253521,38,10,17,75,35836,42909,634583,0.07178587276365685,168583,1842,0.051400194328452505,19386,1,1,0,2,64137,0.01838378618992083,23523,0,0,1,0.010091034008931639,1,1305,0,709,145,1,2159,596,0.15662848939393897,383665,215082,
27,0.09001077973409989,38,10,17,75,35836,42909,634583,0.07178587276365685,168583,1842,0.051400194328452505,19386,485,30,15,530,64137,0.01838378618992083,23523,3,455,6,0.14786813296962883,9,1305,0,709,145,3,2159,596,0.15662848939393897,383665,215082,
27,0.09001077973409989,38,10,17,75,35836,42909,634583,0.07178587276365685,168583,1842,0.051400194328452505,19386,485,30,15,530,64137,0.01838378618992083,23523,3,455,6,0.14786813296962883,9,1305,0,709,145,3,2159,596,0.15662848939393897,383665,215082,
27,0.09001077973409989,38,10,17,75,35836,42909,634583,0.07178587276365685,168583,1842,0.051400194328452505,19386,485,30,15,530,64137,0.01838378618992083,23523,3,455,6,0.14786813296962883,9,1305,0,709,145,3,2159,596,0.15662848939393897,383665,215082,
27,0.09001077973409989,38,10,17,75,35836,42909,634583,0.07178587276365685,168583,1842,0.051400194328452505,19386,485,30,15,530,64137,0.01838378618992083,23523,3,455,6,0.14786813296962883,9,1305,0,709,145,3,2159,596,0.15662848939393897,383665,215082,
27,0.09001077973409989,38,10,17,75,35836,42909,634583,0.07178587276365685,168583,1842,0.051400194328452505,19386,485,30,15,530,64137,0.01838378618992083,23523,3,455,6,0.14786813296962883,9,1305,0,709,145,3,2159,596,0.15662848939393897,383665,215082,
27,0.09001077973409989,38,10,17,75,35836,42909,634583,0.07178587276365685,168583,1842,0.051400194328452505,19386,485,30,15,530,64137,0.01838378618992083,23523,3,455,6,0.14786813296962883,9,1305,0,709,145,3,2159,596,0.15662848939393897,383665,215082,
27,0.0,38,10,17,75,35836,42909,634583,0.07178587276365685,168583,1842,0.051400194328452505,19386,51,0,0,51,64137,0.01838378618992083,23523,0,51,0,0.03136531365313653,0,1305,0,709,145,0,2159,596,0.15662848939393897,383665,215082,
27,0.09001077973409989,38,10,17,75,35836,42909,634583,0.07178587276365685,168583,1842,0.051400194328452505,19386,485,30,15,530,64137,0.01838378618992083,23523,3,455,6,0.14786813296962883,9,1305,0,709,145,3,2159,596,0.15662848939393897,383665,215082,
27,0.09001077973409989,38,10,17,75,35836,42909,634583,0.07178587276365685,168583,1842,0.051400194328452505,19386,485,30,15,530,64137,0.01838378618992083,23523,3,455,6,0.14786813296962883,9,1305,0,709,145,3,2159,596,0.15662848939393897,383665,215082,
33,0.0,5,9,24,47,35836,42909,634583,0.010127127774186598,168583,1842,0.051400194328452505,19386,2,2,0,4,64137,0.01838378618992083,23523,0,0,0,0.16666666666666666,0,1436,0,81,33,0,1550,1355,0.056420804824977716,383665,215082,
33,0.0,5,9,24,47,35836,42909,634583,0.010127127774186598,168583,1842,0.051400194328452505,19386,2,2,0,4,64137,0.01838378618992083,23523,0,0,0,0.16666666666666666,0,1436,0,81,33,0,1550,1355,0.056420804824977716,383665,215082,
33,0.0,5,9,24,47,35836,42909,634583,0.010127127774186598,168583,1842,0.051400194328452505,19386,2,2,0,4,64137,0.01838378618992083,23523,0,0,0,0.16666666666666666,0,1436,0,81,33,0,1550,1355,0.056420804824977716,383665,215082,
33,0.0,5,9,24,47,35836,42909,634583,0.010127127774186598,168583,1842,0.051400194328452505,19386,41,0,0,41,64137,0.01838378618992083,23523,0,41,0,0.021454735740450027,0,1436,0,81,33,0,1550,1355,0.056420804824977716,383665,215082,
33,0.0,5,9,24,47,35836,42909,634583,0.010127127774186598,168583,1842,0.051400194328452505,19386,31,0,0,31,64137,0.01838378618992083,23523,0,31,0,0.010278117266336609,0,1436,0,81,33,0,1550,1355,0.056420804824977716,383665,215082,
33,0.0,5,9,24,47,35836,42909,634583,0.010127127774186598,168583,1842,0.051400194328452505,19386,62,0,0,62,64137,0.01838378618992083,23523,0,62,0,0.030392156862745098,0,1436,0,81,33,0,1550,1355,0.056420804824977716,383665,215082,
33,0.0,5,9,24,47,35836,42909,634583,0.010127127774186598,168583,1842,0.051400194328452505,19386,69,0,0,69,64137,0.01838378618992083,23523,0,69,0,0.07940161104718067,0,1436,0,81,33,0,1550,1355,0.056420804824977716,383665,215082,
33,0.0,5,9,24,47,35836,42909,634583,0.010127127774186598,168583,1842,0.051400194328452505,19386,25,2,0,27,64137,0.01838378618992083,23523,0,23,0,0.016280654939979627,0,1436,0,81,33,0,1550,1355,0.056420804824977716,383665,215082,
33,0.0,5,9,24,47,35836,42909,634583,0.010127127774186598,168583,1842,0.051400194328452505,19386,25,2,0,27,64137,0.01838378618992083,23523,0,23,0,0.016280654939979627,0,1436,0,81,33,0,1550,1355,0.056420804824977716,383665,215082,
33,0.0,5,9,24,47,35836,42909,634583,0.010127127774186598,168583,1842,0.051400194328452505,19386,25,2,0,27,64137,0.01838378618992083,23523,0,23,0,0.016280654939979627,0,1436,0,81,33,0,1550,1355,0.056420804824977716,383665,215082,
33,0.0,5,9,24,47,35836,42909,634583,0.010127127774186598,168583,1842,0.051400194328452505,19386,191,2,0,193,64137,0.01838378618992083,23523,0,189,0,0.047710890863009114,0,1436,0,81,33,0,1550,1355,0.056420804824977716,383665,215082,
28,0.0,0,0,28,28,35836,42909,634583,0.017902813299232736,168583,1842,0.051400194328452505,19386,0,0,0,0,64137,0.01838378618992083,23523,0,0,0,0.0,0,298,0,14,0,0,312,284,0.03608614430650619,383665,215082,
3,0.0,0,3,0,6,35836,42909,634583,0.002033898305084746,168583,1842,0.051400194328452505,19386,1,1,0,2,64137,0.01838378618992083,23523,0,0,0,0.004878048780487805,0,138,0,21,0,0,159,117,0.009637415184618362,383665,215082,
3,0.0,0,3,0,6,35836,42909,634583,0.002033898305084746,168583,1842,0.051400194328452505,19386,1,1,0,2,64137,0.01838378618992083,23523,0,0,0,0.004878048780487805,0,138,0,21,0,0,159,117,0.009637415184618362,383665,215082,
3,0.0,0,3,0,6,35836,42909,634583,0.002033898305084746,168583,1842,0.051400194328452505,19386,1,1,0,2,64137,0.01838378618992083,23523,0,0,0,0.004878048780487805,0,138,0,21,0,0,159,117,0.009637415184618362,383665,215082,
3,0.0,0,3,0,6,35836,42909,634583,0.002033898305084746,168583,1842,0.051400194328452505,19386,1,1,0,2,64137,0.01838378618992083,23523,0,0,0,0.004878048780487805,0,138,0,21,0,0,159,117,0.009637415184618362,383665,215082,
3,0.0,0,3,0,6,35836,42909,634583,0.002033898305084746,168583,1842,0.051400194328452505,19386,1,1,0,2,64137,0.01838378618992083,23523,0,0,0,0.004878048780487805,0,138,0,21,0,0,159,117,0.009637415184618362,383665,215082,
3,0.0,0,3,0,6,35836,42909,634583,0.002033898305084746,168583,1842,0.051400194328452505,19386,1,1,0,2,64137,0.01838378618992083,23523,0,0,0,0.004878048780487805,0,138,0,21,0,0,159,117,0.009637415184618362,383665,215082,
3,0.0,0,3,0,6,35836,42909,634583,0.002033898305084746,168583,1842,0.051400194328452505,19386,1,1,0,2,64137,0.01838378618992083,23523,0,0,0,0.004878048780487805,0,138,0,21,0,0,159,117,0.009637415184618362,383665,215082,
3,0.0,0,3,0,6,35836,42909,634583,0.002033898305084746,168583,1842,0.051400194328452505,19386,1,1,0,2,64137,0.01838378618992083,23523,0,0,0,0.004878048780487805,0,138,0,21,0,0,159,117,0.009637415184618362,383665,215082,
3,0.0,0,3,0,6,35836,42909,634583,0.002033898305084746,168583,1842,0.051400194328452505,19386,1,1,0,2,64137,0.01838378618992083,23523,0,0,0,0.004878048780487805,0,138,0,21,0,0,159,117,0.009637415184618362,383665,215082,
4,0.005934718100890208,0,4,0,8,35836,42909,634583,0.004993858788293638,168583,1842,0.051400194328452505,19386,294,1,0,295,64137,0.01838378618992083,23523,1,293,1,0.13700212574760887,2,469,0,60,4,0,533,409,0.05459216356190144,383665,215082,
4,0.005934718100890208,0,4,0,8,35836,42909,634583,0.004993858788293638,168583,1842,0.051400194328452505,19386,294,1,0,295,64137,0.01838378618992083,23523,1,293,1,0.13700212574760887,2,469,0,60,4,0,533,409,0.05459216356190144,383665,215082,
4,0.005934718100890208,0,4,0,8,35836,42909,634583,0.004993858788293638,168583,1842,0.051400194328452505,19386,294,1,0,295,64137,0.01838378618992083,23523,1,293,1,0.13700212574760887,2,469,0,60,4,0,533,409,0.05459216356190144,383665,215082,
2,0.0,0,2,0,4,35836,42909,634583,0.005064523983442902,168583,1842,0.051400194328452505,19386,47,1,0,48,64137,0.01838378618992083,23523,0,46,0,0.006138248373852107,0,3136,0,277,28,0,3441,2859,0.057885005942720835,383665,215082,
2,0.0,0,2,0,4,35836,42909,634583,0.005064523983442902,168583,1842,0.051400194328452505,19386,47,1,0,48,64137,0.01838378618992083,23523,0,46,0,0.006138248373852107,0,3136,0,277,28,0,3441,2859,0.057885005942720835,383665,215082,
2,0.0,0,2,0,4,35836,42909,634583,0.005064523983442902,168583,1842,0.051400194328452505,19386,48,24,0,72,64137,0.01838378618992083,23523,0,24,0,0.06083557172356792,0,3136,0,277,28,0,3441,2859,0.057885005942720835,383665,215082,
2,0.0,0,2,0,4,35836,42909,634583,0.005064523983442902,168583,1842,0.051400194328452505,19386,48,24,0,72,64137,0.01838378618992083,23523,0,24,0,0.06083557172356792,0,3136,0,277,28,0,3441,2859,0.057885005942720835,383665,215082,
2,0.0,0,2,0,4,35836,42909,634583,0.005064523983442902,168583,1842,0.051400194328452505,19386,295,7,0,302,64137,0.01838378618992083,23523,0,288,0,0.01821415867350658,0,3136,0,277,28,0,3441,2859,0.057885005942720835,383665,215082,
2,0.0,0,2,0,4,35836,42909,634583,0.005064523983442902,168583,1842,0.051400194328452505,19386,295,7,0,302,64137,0.01838378618992083,23523,0,288,0,0.01821415867350658,0,3136,0,277,28,0,3441,2859,0.057885005942720835,383665,215082,
2,0.0,0,2,0,4,35836,42909,634583,0.005064523983442902,168583,1842,0.051400194328452505,19386,295,7,0,302,64137,0.01838378618992083,23523,0,288,0,0.01821415867350658,0,3136,0,277,28,0,3441,2859,0.057885005942720835,383665,215082,
2,0.0,0,2,0,4,35836,42909,634583,0.005064523983442902,168583,1842,0.051400194328452505,19386,295,7,0,302,64137,0.01838378618992083,23523,0,288,0,0.01821415867350658,0,3136,0,277,28,0,3441,2859,0.057885005942720835,383665,215082,
2,0.0,0,2,0,4,35836,42909,634583,0.005064523983442902,168583,1842,0.051400194328452505,19386,295,7,0,302,64137,0.01838378618992083,23523,0,288,0,0.01821415867350658,0,3136,0,277,28,0,3441,2859,0.057885005942720835,383665,215082,
2,0.0,0,2,0,4,35836,42909,634583,0.005064523983442902,168583,1842,0.051400194328452505,19386,20,0,0,20,64137,0.01838378618992083,23523,0,20,0,0.00733215025140491,0,3136,0,277,28,0,3441,2859,0.057885005942720835,383665,215082,
2,0.0,0,2,0,4,35836,42909,634583,0.005064523983442902,168583,1842,0.051400194328452505,19386,417,26,0,443,64137,0.01838378618992083,23523,0,391,0,0.04506854131673959,0,3136,0,277,28,0,3441,2859,0.057885005942720835,383665,215082,
2,0.0,0,2,0,4,35836,42909,634583,0.005064523983442902,168583,1842,0.051400194328452505,19386,417,26,0,443,64137,0.01838378618992083,23523,0,391,0,0.04506854131673959,0,3136,0,277,28,0,3441,2859,0.057885005942720835,383665,215082,
2,0.0,0,2,0,4,35836,42909,634583,0.005064523983442902,168583,1842,0.051400194328452505,19386,417,26,0,443,64137,0.01838378618992083,23523,0,391,0,0.04506854131673959,0,3136,0,277,28,0,3441,2859,0.057885005942720835,383665,215082,
2,0.0,0,2,0,4,35836,42909,634583,0.005064523983442902,168583,1842,0.051400194328452505,19386,417,26,0,443,64137,0.01838378618992083,23523,0,391,0,0.04506854131673959,0,3136,0,277,28,0,3441,2859,0.057885005942720835,383665,215082,
2,0.0,0,2,0,4,35836,42909,634583,0.005064523983442902,168583,1842,0.051400194328452505,19386,417,26,0,443,64137,0.01838378618992083,23523,0,391,0,0.04506854131673959,0,3136,0,277,28,0,3441,2859,0.057885005942720835,383665,215082,
2,0.0,0,2,0,4,35836,42909,634583,0.005064523983442902,168583,1842,0.051400194328452505,19386,417,26,0,443,64137,0.01838378618992083,23523,0,391,0,0.04506854131673959,0,3136,0,277,28,0,3441,2859,0.057885005942720835,383665,215082,
2,0.0,0,2,0,4,35836,42909,634583,0.005064523983442902,168583,1842,0.051400194328452505,19386,417,26,0,443,64137,0.01838378618992083,23523,0,391,0,0.04506854131673959,0,3136,0,277,28,0,3441,2859,0.057885005942720835,383665,215082,
2,0.0,0,2,0,4,35836,42909,634583,0.005064523983442902,168583,1842,0.051400194328452505,19386,417,26,0,443,64137,0.01838378618992083,23523,0,391,0,0.04506854131673959,0,3136,0,277,28,0,3441,2859,0.057885005942720835,383665,215082,
2,0.0,0,2,0,4,35836,42909,634583,0.005064523983442902,168583,1842,0.051400194328452505,19386,417,26,0,443,64137,0.01838378618992083,23523,0,391,0,0.04506854131673959,0,3136,0,277,28,0,3441,2859,0.057885005942720835,383665,215082,
2,0.0,0,2,0,4,35836,42909,634583,0.005064523983442902,168583,1842,0.051400194328452505,19386,417,26,0,443,64137,0.01838378618992083,23523,0,391,0,0.04506854131673959,0,3136,0,277,28,0,3441,2859,0.057885005942720835,383665,215082,
2,0.0,0,2,0,4,35836,42909,634583,0.005064523983442902,168583,1842,0.051400194328452505,19386,417,26,0,443,64137,0.01838378618992083,23523,0,391,0,0.04506854131673959,0,3136,0,277,28,0,3441,2859,0.057885005942720835,383665,215082,
2,0.0,0,2,0,4,35836,42909,634583,0.005064523983442902,168583,1842,0.051400194328452505,19386,417,26,0,443,64137,0.01838378618992083,23523,0,391,0,0.04506854131673959,0,3136,0,277,28,0,3441,2859,0.057885005942720835,383665,215082,
2,0.0,0,2,0,4,35836,42909,634583,0.005064523983442902,168583,1842,0.051400194328452505,19386,417,26,0,443,64137,0.01838378618992083,23523,0,391,0,0.04506854131673959,0,3136,0,277,28,0,3441,2859,0.057885005942720835,383665,215082,
2,0.0,0,2,0,4,35836,42909,634583,0.005064523983442902,168583,1842,0.051400194328452505,19386,417,26,0,443,64137,0.01838378618992083,23523,0,391,0,0.04506854131673959,0,3136,0,277,28,0,3441,2859,0.057885005942720835,383665,215082,
2,0.0,0,2,0,4,35836,42909,634583,0.005064523983442902,168583,1842,0.051400194328452505,19386,417,26,0,443,64137,0.01838378618992083,23523,0,391,0,0.04506854131673959,0,3136,0,277,28,0,3441,2859,0.057885005942720835,383665,215082,
2,0.0,0,2,0,4,35836,42909,634583,0.005064523983442902,168583,1842,0.051400194328452505,19386,417,26,0,443,64137,0.01838378618992083,23523,0,391,0,0.04506854131673959,0,3136,0,277,28,0,3441,2859,0.057885005942720835,383665,215082,
2,0.0,0,2,0,4,35836,42909,634583,0.005064523983442902,168583,1842,0.051400194328452505,19386,417,26,0,443,64137,0.01838378618992083,23523,0,391,0,0.04506854131673959,0,3136,0,277,28,0,3441,2859,0.057885005942720835,383665,215082,
2,0.0,0,2,0,4,35836,42909,634583,0.005064523983442902,168583,1842,0.051400194328452505,19386,417,26,0,443,64137,0.01838378618992083,23523,0,391,0,0.04506854131673959,0,3136,0,277,28,0,3441,2859,0.057885005942720835,383665,215082,
2,0.0,0,2,0,4,35836,42909,634583,0.005064523983442902,168583,1842,0.051400194328452505,19386,19,0,0,19,64137,0.01838378618992083,23523,0,19,0,0.01486697965571205,0,3136,0,277,28,0,3441,2859,0.057885005942720835,383665,215082,
2,0.0,0,2,0,4,35836,42909,634583,0.005064523983442902,168583,1842,0.051400194328452505,19386,24,1,0,25,64137,0.01838378618992083,23523,0,23,0,0.03004763209834053,0,3136,0,277,28,0,3441,2859,0.057885005942720835,383665,215082,
2,0.0,0,2,0,4,35836,42909,634583,0.005064523983442902,168583,1842,0.051400194328452505,19386,19,0,0,19,64137,0.01838378618992083,23523,0,19,0,0.01486697965571205,0,3136,0,277,28,0,3441,2859,0.057885005942720835,383665,215082,
2,0.13333333333333333,0,2,0,4,35836,42909,634583,0.005064523983442902,168583,1842,0.051400194328452505,19386,20,9,4,33,64137,0.01838378618992083,23523,1,11,1,0.04778748337467199,2,3136,0,277,28,0,3441,2859,0.057885005942720835,383665,215082,
2,0.0,0,2,0,4,35836,42909,634583,0.005064523983442902,168583,1842,0.051400194328452505,19386,107,56,15,178,64137,0.01838378618992083,23523,0,51,0,0.07581549518186168,0,3136,0,277,28,0,3441,2859,0.057885005942720835,383665,215082,
2,0.0,0,2,0,4,35836,42909,634583,0.005064523983442902,168583,1842,0.051400194328452505,19386,24,1,0,25,64137,0.01838378618992083,23523,0,23,0,0.03004763209834053,0,3136,0,277,28,0,3441,2859,0.057885005942720835,383665,215082,
2,0.0,0,2,0,4,35836,42909,634583,0.005064523983442902,168583,1842,0.051400194328452505,19386,24,1,0,25,64137,0.01838378618992083,23523,0,23,0,0.03004763209834053,0,3136,0,277,28,0,3441,2859,0.057885005942720835,383665,215082,
2,0.0,0,2,0,4,35836,42909,634583,0.005064523983442902,168583,1842,0.051400194328452505,19386,46,3,0,49,64137,0.01838378618992083,23523,0,43,0,0.11307137508809022,0,3136,0,277,28,0,3441,2859,0.057885005942720835,383665,215082,
2,0.0,0,2,0,4,35836,42909,634583,0.005064523983442902,168583,1842,0.051400194328452505,19386,46,3,0,49,64137,0.01838378618992083,23523,0,43,0,0.11307137508809022,0,3136,0,277,28,0,3441,2859,0.057885005942720835,383665,215082,
2,0.0,0,2,0,4,35836,42909,634583,0.005064523983442902,168583,1842,0.051400194328452505,19386,46,3,0,49,64137,0.01838378618992083,23523,0,43,0,0.11307137508809022,0,3136,0,277,28,0,3441,2859,0.057885005942720835,383665,215082,
2,0.0,0,2,0,4,35836,42909,634583,0.005064523983442902,168583,1842,0.051400194328452505,19386,46,3,0,49,64137,0.01838378618992083,23523,0,43,0,0.11307137508809022,0,3136,0,277,28,0,3441,2859,0.057885005942720835,383665,215082,
2,0.0,0,2,0,4,35836,42909,634583,0.005064523983442902,168583,1842,0.051400194328452505,19386,46,3,0,49,64137,0.01838378618992083,23523,0,43,0,0.11307137508809022,0,3136,0,277,28,0,3441,2859,0.057885005942720835,383665,215082,
2,0.0,0,2,0,4,35836,42909,634583,0.005064523983442902,168583,1842,0.051400194328452505,19386,46,3,0,49,64137,0.01838378618992083,23523,0,43,0,0.11307137508809022,0,3136,0,277,28,0,3441,2859,0.057885005942720835,383665,215082,
2,0.0,0,2,0,4,35836,42909,634583,0.005064523983442902,168583,1842,0.051400194328452505,19386,46,3,0,49,64137,0.01838378618992083,23523,0,43,0,0.11307137508809022,0,3136,0,277,28,0,3441,2859,0.057885005942720835,383665,215082,
2,0.0,0,2,0,4,35836,42909,634583,0.005064523983442902,168583,1842,0.051400194328452505,19386,223,8,0,231,64137,0.01838378618992083,23523,0,215,0,0.07324413361470752,0,3136,0,277,28,0,3441,2859,0.057885005942720835,383665,215082,
2,0.0,0,2,0,4,35836,42909,634583,0.005064523983442902,168583,1842,0.051400194328452505,19386,223,8,0,231,64137,0.01838378618992083,23523,0,215,0,0.07324413361470752,0,3136,0,277,28,0,3441,2859,0.057885005942720835,383665,215082,
2,0.0,0,2,0,4,35836,42909,634583,0.005064523983442902,168583,1842,0.051400194328452505,19386,223,8,0,231,64137,0.01838378618992083,23523,0,215,0,0.07324413361470752,0,3136,0,277,28,0,3441,2859,0.057885005942720835,383665,215082,
2,0.0,0,2,0,4,35836,42909,634583,0.005064523983442902,168583,1842,0.051400194328452505,19386,223,8,0,231,64137,0.01838378618992083,23523,0,215,0,0.07324413361470752,0,3136,0,277,28,0,3441,2859,0.057885005942720835,383665,215082,
2,0.0,0,2,0,4,35836,42909,634583,0.005064523983442902,168583,1842,0.051400194328452505,19386,121,10,0,131,64137,0.01838378618992083,23523,0,111,0,0.02245056425146068,0,3136,0,277,28,0,3441,2859,0.057885005942720835,383665,215082,
2,0.0,0,2,0,4,35836,42909,634583,0.005064523983442902,168583,1842,0.051400194328452505,19386,121,10,0,131,64137,0.01838378618992083,23523,0,111,0,0.02245056425146068,0,3136,0,277,28,0,3441,2859,0.057885005942720835,383665,215082,
2,0.0,0,2,0,4,35836,42909,634583,0.005064523983442902,168583,1842,0.051400194328452505,19386,121,10,0,131,64137,0.01838378618992083,23523,0,111,0,0.02245056425146068,0,3136,0,277,28,0,3441,2859,0.057885005942720835,383665,215082,
2,0.0,0,2,0,4,35836,42909,634583,0.005064523983442902,168583,1842,0.051400194328452505,19386,121,10,0,131,64137,0.01838378618992083,23523,0,111,0,0.02245056425146068,0,3136,0,277,28,0,3441,2859,0.057885005942720835,383665,215082,
2,0.0,0,2,0,4,35836,42909,634583,0.005064523983442902,168583,1842,0.051400194328452505,19386,9,10,0,19,64137,0.01838378618992083,23523,0,-1,0,0.0213508723399954,0,3136,0,277,28,0,3441,2859,0.057885005942720835,383665,215082,
2,0.0,0,2,0,4,35836,42909,634583,0.005064523983442902,168583,1842,0.051400194328452505,19386,9,10,0,19,64137,0.01838378618992083,23523,0,-1,0,0.0213508723399954,0,3136,0,277,28,0,3441,2859,0.057885005942720835,383665,215082,
2,0.0,0,2,0,4,35836,42909,634583,0.005064523983442902,168583,1842,0.051400194328452505,19386,124,7,0,131,64137,0.01838378618992083,23523,0,117,0,0.0543855498093557,0,3136,0,277,28,0,3441,2859,0.057885005942720835,383665,215082,
2,0.0,0,2,0,4,35836,42909,634583,0.005064523983442902,168583,1842,0.051400194328452505,19386,124,7,0,131,64137,0.01838378618992083,23523,0,117,0,0.0543855498093557,0,3136,0,277,28,0,3441,2859,0.057885005942720835,383665,215082,
2,0.0,0,2,0,4,35836,42909,634583,0.005064523983442902,168583,1842,0.051400194328452505,19386,0,0,0,0,64137,0.01838378618992083,23523,0,0,0,0.0,0,3136,0,277,28,0,3441,2859,0.057885005942720835,383665,215082,
2,0.0,0,2,0,4,35836,42909,634583,0.005064523983442902,168583,1842,0.051400194328452505,19386,0,0,0,0,64137,0.01838378618992083,23523,0,0,0,0.0,0,3136,0,277,28,0,3441,2859,0.057885005942720835,383665,215082,
2,0.05405405405405406,0,2,0,4,35836,42909,634583,0.005064523983442902,168583,1842,0.051400194328452505,19386,77,1,0,78,64137,0.01838378618992083,23523,1,76,1,0.03784707258511359,2,3136,0,277,28,0,3441,2859,0.057885005942720835,383665,215082,
2,0.05405405405405406,0,2,0,4,35836,42909,634583,0.005064523983442902,168583,1842,0.051400194328452505,19386,77,1,0,78,64137,0.01838378618992083,23523,1,76,1,0.03784707258511359,2,3136,0,277,28,0,3441,2859,0.057885005942720835,383665,215082,
2,0.0,0,2,0,4,35836,42909,634583,0.005064523983442902,168583,1842,0.051400194328452505,19386,74,1,0,75,64137,0.01838378618992083,23523,0,73,0,0.04642857142857143,0,3136,0,277,28,0,3441,2859,0.057885005942720835,383665,215082,
2,0.0,0,2,0,4,35836,42909,634583,0.005064523983442902,168583,1842,0.051400194328452505,19386,74,1,0,75,64137,0.01838378618992083,23523,0,73,0,0.04642857142857143,0,3136,0,277,28,0,3441,2859,0.057885005942720835,383665,215082,
2,0.0,0,2,0,4,35836,42909,634583,0.005064523983442902,168583,1842,0.051400194328452505,19386,74,1,0,75,64137,0.01838378618992083,23523,0,73,0,0.04642857142857143,0,3136,0,277,28,0,3441,2859,0.057885005942720835,383665,215082,
2,0.0,0,2,0,4,35836,42909,634583,0.005064523983442902,168583,1842,0.051400194328452505,19386,74,1,0,75,64137,0.01838378618992083,23523,0,73,0,0.04642857142857143,0,3136,0,277,28,0,3441,2859,0.057885005942720835,383665,215082,
2,0.0,0,2,0,4,35836,42909,634583,0.005064523983442902,168583,1842,0.051400194328452505,19386,74,1,0,75,64137,0.01838378618992083,23523,0,73,0,0.04642857142857143,0,3136,0,277,28,0,3441,2859,0.057885005942720835,383665,215082,
2,0.0,0,2,0,4,35836,42909,634583,0.005064523983442902,168583,1842,0.051400194328452505,19386,175,2,0,177,64137,0.01838378618992083,23523,0,173,0,0.006862022405048106,0,3136,0,277,28,0,3441,2859,0.057885005942720835,383665,215082,
2,0.0,0,2,0,4,35836,42909,634583,0.005064523983442902,168583,1842,0.051400194328452505,19386,175,2,0,177,64137,0.01838378618992083,23523,0,173,0,0.006862022405048106,0,3136,0,277,28,0,3441,2859,0.057885005942720835,383665,215082,
2,0.0,0,2,0,4,35836,42909,634583,0.005064523983442902,168583,1842,0.051400194328452505,19386,175,2,0,177,64137,0.01838378618992083,23523,0,173,0,0.006862022405048106,0,3136,0,277,28,0,3441,2859,0.057885005942720835,383665,215082,
2,0.0,0,2,0,4,35836,42909,634583,0.005064523983442902,168583,1842,0.051400194328452505,19386,175,2,0,177,64137,0.01838378618992083,23523,0,173,0,0.006862022405048106,0,3136,0,277,28,0,3441,2859,0.057885005942720835,383665,215082,
2,0.0,0,2,0,4,35836,42909,634583,0.005064523983442902,168583,1842,0.051400194328452505,19386,175,2,0,177,64137,0.01838378618992083,23523,0,173,0,0.006862022405048106,0,3136,0,277,28,0,3441,2859,0.057885005942720835,383665,215082,
2,0.0,0,2,0,4,35836,42909,634583,0.005064523983442902,168583,1842,0.051400194328452505,19386,175,2,0,177,64137,0.01838378618992083,23523,0,173,0,0.006862022405048106,0,3136,0,277,28,0,3441,2859,0.057885005942720835,383665,215082,
2,0.0,0,2,0,4,35836,42909,634583,0.005064523983442902,168583,1842,0.051400194328452505,19386,100,14,0,114,64137,0.01838378618992083,23523,0,86,0,0.14152318653690785,0,3136,0,277,28,0,3441,2859,0.057885005942720835,383665,215082,
2,0.0,0,2,0,4,35836,42909,634583,0.005064523983442902,168583,1842,0.051400194328452505,19386,100,14,0,114,64137,0.01838378618992083,23523,0,86,0,0.14152318653690785,0,3136,0,277,28,0,3441,2859,0.057885005942720835,383665,215082,
2,0.0,0,2,0,4,35836,42909,634583,0.005064523983442902,168583,1842,0.051400194328452505,19386,100,14,0,114,64137,0.01838378618992083,23523,0,86,0,0.14152318653690785,0,3136,0,277,28,0,3441,2859,0.057885005942720835,383665,215082,
2,0.0,0,2,0,4,35836,42909,634583,0.005064523983442902,168583,1842,0.051400194328452505,19386,100,14,0,114,64137,0.01838378618992083,23523,0,86,0,0.14152318653690785,0,3136,0,277,28,0,3441,2859,0.057885005942720835,383665,215082,
2,0.0,0,2,0,4,35836,42909,634583,0.005064523983442902,168583,1842,0.051400194328452505,19386,117,2,0,119,64137,0.01838378618992083,23523,0,115,0,0.13676551476531315,0,3136,0,277,28,0,3441,2859,0.057885005942720835,383665,215082,
2,0.0,0,2,0,4,35836,42909,634583,0.005064523983442902,168583,1842,0.051400194328452505,19386,117,2,0,119,64137,0.01838378618992083,23523,0,115,0,0.13676551476531315,0,3136,0,277,28,0,3441,2859,0.057885005942720835,383665,215082,
2,0.0,0,2,0,4,35836,42909,634583,0.005064523983442902,168583,1842,0.051400194328452505,19386,117,2,0,119,64137,0.01838378618992083,23523,0,115,0,0.13676551476531315,0,3136,0,277,28,0,3441,2859,0.057885005942720835,383665,215082,
2,0.0,0,2,0,4,35836,42909,634583,0.005064523983442902,168583,1842,0.051400194328452505,19386,5,1,0,6,64137,0.01838378618992083,23523,0,4,0,0.11212121212121212,0,3136,0,277,28,0,3441,2859,0.057885005942720835,383665,215082,
2,0.0,0,2,0,4,35836,42909,634583,0.005064523983442902,168583,1842,0.051400194328452505,19386,5,1,0,6,64137,0.01838378618992083,23523,0,4,0,0.11212121212121212,0,3136,0,277,28,0,3441,2859,0.057885005942720835,383665,215082,
2,0.0,0,2,0,4,35836,42909,634583,0.005064523983442902,168583,1842,0.051400194328452505,19386,5,1,0,6,64137,0.01838378618992083,23523,0,4,0,0.11212121212121212,0,3136,0,277,28,0,3441,2859,0.057885005942720835,383665,215082,
2,0.0,0,2,0,4,35836,42909,634583,0.005064523983442902,168583,1842,0.051400194328452505,19386,20,1,0,21,64137,0.01838378618992083,23523,0,19,0,0.07161458333333333,0,3136,0,277,28,0,3441,2859,0.057885005942720835,383665,215082,
2,0.0,0,2,0,4,35836,42909,634583,0.005064523983442902,168583,1842,0.051400194328452505,19386,20,1,0,21,64137,0.01838378618992083,23523,0,19,0,0.07161458333333333,0,3136,0,277,28,0,3441,2859,0.057885005942720835,383665,215082,
2,0.0,0,2,0,4,35836,42909,634583,0.005064523983442902,168583,1842,0.051400194328452505,19386,32,11,0,43,64137,0.01838378618992083,23523,0,21,0,0.07383731211317418,0,3136,0,277,28,0,3441,2859,0.057885005942720835,383665,215082,
2,0.0,0,2,0,4,35836,42909,634583,0.005064523983442902,168583,1842,0.051400194328452505,19386,32,11,0,43,64137,0.01838378618992083,23523,0,21,0,0.07383731211317418,0,3136,0,277,28,0,3441,2859,0.057885005942720835,383665,215082,
2,0.0,0,2,0,4,35836,42909,634583,0.005064523983442902,168583,1842,0.051400194328452505,19386,72,0,0,72,64137,0.01838378618992083,23523,0,72,0,0.3364485981308411,0,3136,0,277,28,0,3441,2859,0.057885005942720835,383665,215082,
2,0.0,0,2,0,4,35836,42909,634583,0.005064523983442902,168583,1842,0.051400194328452505,19386,72,0,0,72,64137,0.01838378618992083,23523,0,72,0,0.3364485981308411,0,3136,0,277,28,0,3441,2859,0.057885005942720835,383665,215082,
2,0.0,0,2,0,4,35836,42909,634583,0.005064523983442902,168583,1842,0.051400194328452505,19386,314,49,8,371,64137,0.01838378618992083,23523,0,265,0,0.11940477340832854,0,3136,0,277,28,0,3441,2859,0.057885005942720835,383665,215082,
2,0.0,0,2,0,4,35836,42909,634583,0.005064523983442902,168583,1842,0.051400194328452505,19386,314,49,8,371,64137,0.01838378618992083,23523,0,265,0,0.11940477340832854,0,3136,0,277,28,0,3441,2859,0.057885005942720835,383665,215082,
2,0.0,0,2,0,4,35836,42909,634583,0.005064523983442902,168583,1842,0.051400194328452505,19386,114,1,0,115,64137,0.01838378618992083,23523,0,113,0,0.00625879394168212,0,3136,0,277,28,0,3441,2859,0.057885005942720835,383665,215082,
2,0.0,0,2,0,4,35836,42909,634583,0.005064523983442902,168583,1842,0.051400194328452505,19386,114,1,0,115,64137,0.01838378618992083,23523,0,113,0,0.00625879394168212,0,3136,0,277,28,0,3441,2859,0.057885005942720835,383665,215082,
2,0.0,0,2,0,4,35836,42909,634583,0.005064523983442902,168583,1842,0.051400194328452505,19386,114,1,0,115,64137,0.01838378618992083,23523,0,113,0,0.00625879394168212,0,3136,0,277,28,0,3441,2859,0.057885005942720835,383665,215082,
2,0.0,0,2,0,4,35836,42909,634583,0.005064523983442902,168583,1842,0.051400194328452505,19386,114,1,0,115,64137,0.01838378618992083,23523,0,113,0,0.00625879394168212,0,3136,0,277,28,0,3441,2859,0.057885005942720835,383665,215082,
2,0.0,0,2,0,4,35836,42909,634583,0.005064523983442902,168583,1842,0.051400194328452505,19386,224,19,0,243,64137,0.01838378618992083,23523,0,205,0,0.060329674347932995,0,3136,0,277,28,0,3441,2859,0.057885005942720835,383665,215082,
2,0.0,0,2,0,4,35836,42909,634583,0.005064523983442902,168583,1842,0.051400194328452505,19386,224,19,0,243,64137,0.01838378618992083,23523,0,205,0,0.060329674347932995,0,3136,0,277,28,0,3441,2859,0.057885005942720835,383665,215082,
2,0.0,0,2,0,4,35836,42909,634583,0.005064523983442902,168583,1842,0.051400194328452505,19386,224,19,0,243,64137,0.01838378618992083,23523,0,205,0,0.060329674347932995,0,3136,0,277,28,0,3441,2859,0.057885005942720835,383665,215082,
2,0.0,0,2,0,4,35836,42909,634583,0.005064523983442902,168583,1842,0.051400194328452505,19386,224,19,0,243,64137,0.01838378618992083,23523,0,205,0,0.060329674347932995,0,3136,0,277,28,0,3441,2859,0.057885005942720835,383665,215082,
5,0.0,0,3,2,8,35836,42909,634583,0.014414414414414415,168583,1842,0.051400194328452505,19386,209,13,1,223,64137,0.01838378618992083,23523,0,196,0,0.029234157505755604,0,1105,0,364,31,0,1500,741,0.05493426926673764,383665,215082,
2,0.0,0,2,0,4,35836,42909,634583,0.005064523983442902,168583,1842,0.051400194328452505,19386,224,19,0,243,64137,0.01838378618992083,23523,0,205,0,0.060329674347932995,0,3136,0,277,28,0,3441,2859,0.057885005942720835,383665,215082,
5,0.0,0,3,2,8,35836,42909,634583,0.014414414414414415,168583,1842,0.051400194328452505,19386,16,239,1,256,64137,0.01838378618992083,23523,0,-223,0,0.07962153699491971,0,1105,0,364,31,0,1500,741,0.05493426926673764,383665,215082,
5,0.21621621621621623,0,3,2,8,35836,42909,634583,0.014414414414414415,168583,1842,0.051400194328452505,19386,148,8,0,156,64137,0.01838378618992083,23523,3,140,5,0.07226023606198625,8,1105,0,364,31,2,1500,741,0.05493426926673764,383665,215082,
5,0.0,0,3,2,8,35836,42909,634583,0.014414414414414415,168583,1842,0.051400194328452505,19386,8,3,0,11,64137,0.01838378618992083,23523,0,5,0,0.102803738317757,0,1105,0,364,31,0,1500,741,0.05493426926673764,383665,215082,
5,0.0,0,3,2,8,35836,42909,634583,0.014414414414414415,168583,1842,0.051400194328452505,19386,105,28,6,139,64137,0.01838378618992083,23523,0,77,0,0.04772340578459593,0,1105,0,364,31,0,1500,741,0.05493426926673764,383665,215082,
5,0.0,0,3,2,8,35836,42909,634583,0.014414414414414415,168583,1842,0.051400194328452505,19386,114,1,0,115,64137,0.01838378618992083,23523,0,113,0,0.3144736842105263,0,1105,0,364,31,0,1500,741,0.05493426926673764,383665,215082,
0,0.0,0,0,0,0,35836,42909,634583,0.0,168583,1842,0.051400194328452505,19386,0,0,0,0,64137,0.01838378618992083,23523,0,0,0,0.0,0,0,0,0,0,0,0,0,0.0,383665,215082,
0,0.0,0,0,0,0,35836,42909,634583,0.0,168583,1842,0.051400194328452505,19386,0,0,0,0,64137,0.01838378618992083,23523,0,0,0,0.0,0,0,0,0,0,0,0,0,0.0,383665,215082,
0,0.0,0,0,0,0,35836,42909,634583,0.0,168583,1842,0.051400194328452505,19386,0,0,0,0,64137,0.01838378618992083,23523,0,0,0,0.0,0,0,0,0,0,0,0,0,0.0,383665,215082,
0,0.0,0,0,0,0,35836,42909,634583,0.0,168583,1842,0.051400194328452505,19386,0,0,0,0,64137,0.01838378618992083,23523,0,0,0,0.0,0,0,0,0,0,0,0,0,0.0,383665,215082,
0,0.0,0,0,0,0,35836,42909,634583,0.0,168583,1842,0.051400194328452505,19386,0,0,0,0,64137,0.01838378618992083,23523,0,0,0,0.0,0,0,0,0,0,0,0,0,0.0,383665,215082,
0,0.0,0,0,0,0,35836,42909,634583,0.0,168583,1842,0.051400194328452505,19386,0,0,0,0,64137,0.01838378618992083,23523,0,0,0,0.0,0,0,0,0,0,0,0,0,0.0,383665,215082,
0,0.0,0,0,0,0,35836,42909,634583,0.0,168583,1842,0.051400194328452505,19386,0,0,0,0,64137,0.01838378618992083,23523,0,0,0,0.0,0,0,0,0,0,0,0,0,0.0,383665,215082,
0,0.0,0,0,0,0,35836,42909,634583,0.0,168583,1842,0.051400194328452505,19386,0,0,0,0,64137,0.01838378618992083,23523,0,0,0,0.0,0,0,0,0,0,0,0,0,0.0,383665,215082,
0,0.0,0,0,0,0,35836,42909,634583,0.0,168583,1842,0.051400194328452505,19386,0,0,0,0,64137,0.01838378618992083,23523,0,0,0,0.0,0,0,0,0,0,0,0,0,0.0,383665,215082,
0,0.0,0,0,0,0,35836,42909,634583,0.0,168583,1842,0.051400194328452505,19386,0,0,0,0,64137,0.01838378618992083,23523,0,0,0,0.0,0,0,0,0,0,0,0,0,0.0,383665,215082,
0,0.0,0,0,0,0,35836,42909,634583,0.0,168583,1842,0.051400194328452505,19386,0,0,0,0,64137,0.01838378618992083,23523,0,0,0,0.0,0,0,0,0,0,0,0,0,0.0,383665,215082,
0,0.0,0,0,0,0,35836,42909,634583,0.0,168583,1842,0.051400194328452505,19386,0,0,0,0,64137,0.01838378618992083,23523,0,0,0,0.0,0,0,0,0,0,0,0,0,0.0,383665,215082,
0,0.0,0,0,0,0,35836,42909,634583,0.0,168583,1842,0.051400194328452505,19386,0,0,0,0,64137,0.01838378618992083,23523,0,0,0,0.0,0,0,0,0,0,0,0,0,0.0,383665,215082,
0,0.0,0,0,0,0,35836,42909,634583,0.0,168583,1842,0.051400194328452505,19386,0,0,0,0,64137,0.01838378618992083,23523,0,0,0,0.0,0,0,0,0,0,0,0,0,0.0,383665,215082,
0,0.0,0,0,0,0,35836,42909,634583,0.0,168583,1842,0.051400194328452505,19386,0,0,0,0,64137,0.01838378618992083,23523,0,0,0,0.0,0,0,0,0,0,0,0,0,0.0,383665,215082,
0,0.0,0,0,0,0,35836,42909,634583,0.0,168583,1842,0.051400194328452505,19386,0,0,0,0,64137,0.01838378618992083,23523,0,0,0,0.0,0,0,0,0,0,0,0,0,0.0,383665,215082,
0,0.0,0,0,0,0,35836,42909,634583,0.0,168583,1842,0.051400194328452505,19386,0,0,0,0,64137,0.01838378618992083,23523,0,0,0,0.0,0,0,0,0,0,0,0,0,0.0,383665,215082,
0,0.0,0,0,0,0,35836,42909,634583,0.0,168583,1842,0.051400194328452505,19386,0,0,0,0,64137,0.01838378618992083,23523,0,0,0,0.0,0,0,0,0,0,0,0,0,0.0,383665,215082,
0,0.0,0,0,0,0,35836,42909,634583,0.0,168583,1842,0.051400194328452505,19386,0,0,0,0,64137,0.01838378618992083,23523,0,0,0,0.0,0,0,0,0,0,0,0,0,0.0,383665,215082,
0,0.0,0,0,0,0,35836,42909,634583,0.0,168583,1842,0.051400194328452505,19386,0,0,0,0,64137,0.01838378618992083,23523,0,0,0,0.0,0,0,0,0,0,0,0,0,0.0,383665,215082,
0,0.0,0,0,0,0,35836,42909,634583,0.0,168583,1842,0.051400194328452505,19386,0,0,0,0,64137,0.01838378618992083,23523,0,0,0,0.0,0,0,0,0,0,0,0,0,0.0,383665,215082,
0,0.0,0,0,0,0,35836,42909,634583,0.0,168583,1842,0.051400194328452505,19386,0,0,0,0,64137,0.01838378618992083,23523,0,0,0,0.0,0,0,0,0,0,0,0,0,0.0,383665,215082,
0,0.0,0,0,0,0,35836,42909,634583,0.0,168583,1842,0.051400194328452505,19386,0,0,0,0,64137,0.01838378618992083,23523,0,0,0,0.0,0,0,0,0,0,0,0,0,0.0,383665,215082,
0,0.0,0,0,0,0,35836,42909,634583,0.0,168583,1842,0.051400194328452505,19386,0,0,0,0,64137,0.01838378618992083,23523,0,0,0,0.0,0,0,0,0,0,0,0,0,0.0,383665,215082,
0,0.0,0,0,0,0,35836,42909,634583,0.0,168583,1842,0.051400194328452505,19386,0,0,0,0,64137,0.01838378618992083,23523,0,0,0,0.0,0,0,0,0,0,0,0,0,0.0,383665,215082,
0,0.0,0,0,0,0,35836,42909,634583,0.0,168583,1842,0.051400194328452505,19386,0,0,0,0,64137,0.01838378618992083,23523,0,0,0,0.0,0,0,0,0,0,0,0,0,0.0,383665,215082,
0,0.0,0,0,0,0,35836,42909,634583,0.0,168583,1842,0.051400194328452505,19386,0,0,0,0,64137,0.01838378618992083,23523,0,0,0,0.0,0,0,0,0,0,0,0,0,0.0,383665,215082,
0,0.0,0,0,0,0,35836,42909,634583,0.0,168583,1842,0.051400194328452505,19386,0,0,0,0,64137,0.01838378618992083,23523,0,0,0,0.0,0,0,0,0,0,0,0,0,0.0,383665,215082,
0,0.0,0,0,0,0,35836,42909,634583,0.0,168583,1842,0.051400194328452505,19386,0,0,0,0,64137,0.01838378618992083,23523,0,0,0,0.0,0,0,0,0,0,0,0,0,0.0,383665,215082,
0,0.0,0,0,0,0,35836,42909,634583,0.0,168583,1842,0.051400194328452505,19386,0,0,0,0,64137,0.01838378618992083,23523,0,0,0,0.0,0,0,0,0,0,0,0,0,0.0,383665,215082,
0,0.0,0,0,0,0,35836,42909,634583,0.0,168583,1842,0.051400194328452505,19386,0,0,0,0,64137,0.01838378618992083,23523,0,0,0,0.0,0,0,0,0,0,0,0,0,0.0,383665,215082,
0,0.0,0,0,0,0,35836,42909,634583,0.0,168583,1842,0.051400194328452505,19386,0,0,0,0,64137,0.01838378618992083,23523,0,0,0,0.0,0,0,0,0,0,0,0,0,0.0,383665,215082,
0,0.0,0,0,0,0,35836,42909,634583,0.0,168583,1842,0.051400194328452505,19386,0,0,0,0,64137,0.01838378618992083,23523,0,0,0,0.0,0,0,0,0,0,0,0,0,0.0,383665,215082,
0,0.0,0,0,0,0,35836,42909,634583,0.0,168583,1842,0.051400194328452505,19386,0,0,0,0,64137,0.01838378618992083,23523,0,0,0,0.0,0,0,0,0,0,0,0,0,0.0,383665,215082,
0,0.0,0,0,0,0,35836,42909,634583,0.0,168583,1842,0.051400194328452505,19386,0,0,0,0,64137,0.01838378618992083,23523,0,0,0,0.0,0,0,0,0,0,0,0,0,0.0,383665,215082,
0,0.0,0,0,0,0,35836,42909,634583,0.0,168583,1842,0.051400194328452505,19386,0,0,0,0,64137,0.01838378618992083,23523,0,0,0,0.0,0,0,0,0,0,0,0,0,0.0,383665,215082,
0,0.0,0,0,0,0,35836,42909,634583,0.0,168583,1842,0.051400194328452505,19386,0,0,0,0,64137,0.01838378618992083,23523,0,0,0,0.0,0,0,0,0,0,0,0,0,0.0,383665,215082,
0,0.0,0,0,0,0,35836,42909,634583,0.0,168583,1842,0.051400194328452505,19386,0,0,0,0,64137,0.01838378618992083,23523,0,0,0,0.0,0,0,0,0,0,0,0,0,0.0,383665,215082,
0,0.0,0,0,0,0,35836,42909,634583,0.0,168583,1842,0.051400194328452505,19386,0,0,0,0,64137,0.01838378618992083,23523,0,0,0,0.0,0,0,0,0,0,0,0,0,0.0,383665,215082,
0,0.0,0,0,0,0,35836,42909,634583,0.0,168583,1842,0.051400194328452505,19386,0,0,0,0,64137,0.01838378618992083,23523,0,0,0,0.0,0,0,0,0,0,0,0,0,0.0,383665,215082,
0,0.0,0,0,0,0,35836,42909,634583,0.0,168583,1842,0.051400194328452505,19386,0,0,0,0,64137,0.01838378618992083,23523,0,0,0,0.0,0,0,0,0,0,0,0,0,0.0,383665,215082,
0,0.0,0,0,0,0,35836,42909,634583,0.0,168583,1842,0.051400194328452505,19386,0,0,0,0,64137,0.01838378618992083,23523,0,0,0,0.0,0,0,0,0,0,0,0,0,0.0,383665,215082,
0,0.0,0,0,0,0,35836,42909,634583,0.0,168583,1842,0.051400194328452505,19386,0,0,0,0,64137,0.01838378618992083,23523,0,0,0,0.0,0,0,0,0,0,0,0,0,0.0,383665,215082,
0,0.0,0,0,0,0,35836,42909,634583,0.0,168583,1842,0.051400194328452505,19386,0,0,0,0,64137,0.01838378618992083,23523,0,0,0,0.0,0,0,0,0,0,0,0,0,0.0,383665,215082,
0,0.0,0,0,0,0,35836,42909,634583,0.0,168583,1842,0.051400194328452505,19386,0,0,0,0,64137,0.01838378618992083,23523,0,0,0,0.0,0,0,0,0,0,0,0,0,0.0,383665,215082,
0,0.0,0,0,0,0,35836,42909,634583,0.0,168583,1842,0.051400194328452505,19386,0,0,0,0,64137,0.01838378618992083,23523,0,0,0,0.0,0,0,0,0,0,0,0,0,0.0,383665,215082,
0,0.0,0,0,0,0,35836,42909,634583,0.0,168583,1842,0.051400194328452505,19386,0,0,0,0,64137,0.01838378618992083,23523,0,0,0,0.0,0,0,0,0,0,0,0,0,0.0,383665,215082,
0,0.0,0,0,0,0,35836,42909,634583,0.0,168583,1842,0.051400194328452505,19386,0,0,0,0,64137,0.01838378618992083,23523,0,0,0,0.0,0,0,0,0,0,0,0,0,0.0,383665,215082,
0,0.0,0,0,0,0,35836,42909,634583,0.0,168583,1842,0.051400194328452505,19386,0,0,0,0,64137,0.01838378618992083,23523,0,0,0,0.0,0,0,0,0,0,0,0,0,0.0,383665,215082,
0,0.0,0,0,0,0,35836,42909,634583,0.0,168583,1842,0.051400194328452505,19386,0,0,0,0,64137,0.01838378618992083,23523,0,0,0,0.0,0,0,0,0,0,0,0,0,0.0,383665,215082,
0,0.0,0,0,0,0,35836,42909,634583,0.0,168583,1842,0.051400194328452505,19386,0,0,0,0,64137,0.01838378618992083,23523,0,0,0,0.0,0,0,0,0,0,0,0,0,0.0,383665,215082,
0,0.0,0,0,0,0,35836,42909,634583,0.0,168583,1842,0.051400194328452505,19386,0,0,0,0,64137,0.01838378618992083,23523,0,0,0,0.0,0,0,0,0,0,0,0,0,0.0,383665,215082,
0,0.0,0,0,0,0,35836,42909,634583,0.0,168583,1842,0.051400194328452505,19386,0,0,0,0,64137,0.01838378618992083,23523,0,0,0,0.0,0,0,0,0,0,0,0,0,0.0,383665,215082,
0,0.0,0,0,0,0,35836,42909,634583,0.0,168583,1842,0.051400194328452505,19386,0,0,0,0,64137,0.01838378618992083,23523,0,0,0,0.0,0,0,0,0,0,0,0,0,0.0,383665,215082,
0,0.0,0,0,0,0,35836,42909,634583,0.0,168583,1842,0.051400194328452505,19386,0,0,0,0,64137,0.01838378618992083,23523,0,0,0,0.0,0,0,0,0,0,0,0,0,0.0,383665,215082,
0,0.0,0,0,0,0,35836,42909,634583,0.0,168583,1842,0.051400194328452505,19386,0,0,0,0,64137,0.01838378618992083,23523,0,0,0,0.0,0,0,0,0,0,0,0,0,0.0,383665,215082,
0,0.0,0,0,0,0,35836,42909,634583,0.0,168583,1842,0.051400194328452505,19386,0,0,0,0,64137,0.01838378618992083,23523,0,0,0,0.0,0,0,0,0,0,0,0,0,0.0,383665,215082,
0,0.0,0,0,0,0,35836,42909,634583,0.0,168583,1842,0.051400194328452505,19386,0,0,0,0,64137,0.01838378618992083,23523,0,0,0,0.0,0,0,0,0,0,0,0,0,0.0,383665,215082,
0,0.0,0,0,0,0,35836,42909,634583,0.0,168583,1842,0.051400194328452505,19386,0,0,0,0,64137,0.01838378618992083,23523,0,0,0,0.0,0,0,0,0,0,0,0,0,0.0,383665,215082,
0,0.0,0,0,0,0,35836,42909,634583,0.0,168583,1842,0.051400194328452505,19386,0,0,0,0,64137,0.01838378618992083,23523,0,0,0,0.0,0,0,0,0,0,0,0,0,0.0,383665,215082,
0,0.0,0,0,0,0,35836,42909,634583,0.0,168583,1842,0.051400194328452505,19386,0,0,0,0,64137,0.01838378618992083,23523,0,0,0,0.0,0,0,0,0,0,0,0,0,0.0,383665,215082,
0,0.0,0,0,0,0,35836,42909,634583,0.0,168583,1842,0.051400194328452505,19386,0,0,0,0,64137,0.01838378618992083,23523,0,0,0,0.0,0,0,0,0,0,0,0,0,0.0,383665,215082,
0,0.0,0,0,0,0,35836,42909,634583,0.0,168583,1842,0.051400194328452505,19386,0,0,0,0,64137,0.01838378618992083,23523,0,0,0,0.0,0,0,0,0,0,0,0,0,0.0,383665,215082,
0,0.0,0,0,0,0,35836,42909,634583,0.0,168583,1842,0.051400194328452505,19386,0,0,0,0,64137,0.01838378618992083,23523,0,0,0,0.0,0,0,0,0,0,0,0,0,0.0,383665,215082,
0,0.0,0,0,0,0,35836,42909,634583,0.0,168583,1842,0.051400194328452505,19386,0,0,0,0,64137,0.01838378618992083,23523,0,0,0,0.0,0,0,0,0,0,0,0,0,0.0,383665,215082,
0,0.0,0,0,0,0,35836,42909,634583,0.0,168583,1842,0.051400194328452505,19386,0,0,0,0,64137,0.01838378618992083,23523,0,0,0,0.0,0,0,0,0,0,0,0,0,0.0,383665,215082,
0,0.0,0,0,0,0,35836,42909,634583,0.0,168583,1842,0.051400194328452505,19386,0,0,0,0,64137,0.01838378618992083,23523,0,0,0,0.0,0,0,0,0,0,0,0,0,0.0,383665,215082,
0,0.0,0,0,0,0,35836,42909,634583,0.0,168583,1842,0.051400194328452505,19386,0,0,0,0,64137,0.01838378618992083,23523,0,0,0,0.0,0,0,0,0,0,0,0,0,0.0,383665,215082,
0,0.0,0,0,0,0,35836,42909,634583,0.0,168583,1842,0.051400194328452505,19386,0,0,0,0,64137,0.01838378618992083,23523,0,0,0,0.0,0,0,0,0,0,0,0,0,0.0,383665,215082,
0,0.0,0,0,0,0,35836,42909,634583,0.0,168583,1842,0.051400194328452505,19386,0,0,0,0,64137,0.01838378618992083,23523,0,0,0,0.0,0,0,0,0,0,0,0,0,0.0,383665,215082,
0,0.0,0,0,0,0,35836,42909,634583,0.0,168583,1842,0.051400194328452505,19386,0,0,0,0,64137,0.01838378618992083,23523,0,0,0,0.0,0,0,0,0,0,0,0,0,0.0,383665,215082,
0,0.0,0,0,0,0,35836,42909,634583,0.0,168583,1842,0.051400194328452505,19386,0,0,0,0,64137,0.01838378618992083,23523,0,0,0,0.0,0,0,0,0,0,0,0,0,0.0,383665,215082,
0,0.0,0,0,0,0,35836,42909,634583,0.0,168583,1842,0.051400194328452505,19386,0,0,0,0,64137,0.01838378618992083,23523,0,0,0,0.0,0,0,0,0,0,0,0,0,0.0,383665,215082,
0,0.0,0,0,0,0,35836,42909,634583,0.0,168583,1842,0.051400194328452505,19386,0,0,0,0,64137,0.01838378618992083,23523,0,0,0,0.0,0,0,0,0,0,0,0,0,0.0,383665,215082,
0,0.0,0,0,0,0,35836,42909,634583,0.0,168583,1842,0.051400194328452505,19386,0,0,0,0,64137,0.01838378618992083,23523,0,0,0,0.0,0,0,0,0,0,0,0,0,0.0,383665,215082,
0,0.0,0,0,0,0,35836,42909,634583,0.0,168583,1842,0.051400194328452505,19386,0,0,0,0,64137,0.01838378618992083,23523,0,0,0,0.0,0,0,0,0,0,0,0,0,0.0,383665,215082,
0,0.0,0,0,0,0,35836,42909,634583,0.0,168583,1842,0.051400194328452505,19386,0,0,0,0,64137,0.01838378618992083,23523,0,0,0,0.0,0,0,0,0,0,0,0,0,0.0,383665,215082,
0,0.0,0,0,0,0,35836,42909,634583,0.0,168583,1842,0.051400194328452505,19386,0,0,0,0,64137,0.01838378618992083,23523,0,0,0,0.0,0,0,0,0,0,0,0,0,0.0,383665,215082,
0,0.0,0,0,0,0,35836,42909,634583,0.0,168583,1842,0.051400194328452505,19386,0,0,0,0,64137,0.01838378618992083,23523,0,0,0,0.0,0,0,0,0,0,0,0,0,0.0,383665,215082,
0,0.0,0,0,0,0,35836,42909,634583,0.0,168583,1842,0.051400194328452505,19386,0,0,0,0,64137,0.01838378618992083,23523,0,0,0,0.0,0,0,0,0,0,0,0,0,0.0,383665,215082,
0,0.0,0,0,0,0,35836,42909,634583,0.0,168583,1842,0.051400194328452505,19386,0,0,0,0,64137,0.01838378618992083,23523,0,0,0,0.0,0,0,0,0,0,0,0,0,0.0,383665,215082,
0,0.0,0,0,0,0,35836,42909,634583,0.0,168583,1842,0.051400194328452505,19386,0,0,0,0,64137,0.01838378618992083,23523,0,0,0,0.0,0,0,0,0,0,0,0,0,0.0,383665,215082,
0,0.0,0,0,0,0,35836,42909,634583,0.0,168583,1842,0.051400194328452505,19386,0,0,0,0,64137,0.01838378618992083,23523,0,0,0,0.0,0,0,0,0,0,0,0,0,0.0,383665,215082,
0,0.0,0,0,0,0,35836,42909,634583,0.0,168583,1842,0.051400194328452505,19386,0,0,0,0,64137,0.01838378618992083,23523,0,0,0,0.0,0,0,0,0,0,0,0,0,0.0,383665,215082,
0,0.0,0,0,0,0,35836,42909,634583,0.0,168583,1842,0.051400194328452505,19386,0,0,0,0,64137,0.01838378618992083,23523,0,0,0,0.0,0,0,0,0,0,0,0,0,0.0,383665,215082,
0,0.0,0,0,0,0,35836,42909,634583,0.0,168583,1842,0.051400194328452505,19386,0,0,0,0,64137,0.01838378618992083,23523,0,0,0,0.0,0,0,0,0,0,0,0,0,0.0,383665,215082,
0,0.0,0,0,0,0,35836,42909,634583,0.0,168583,1842,0.051400194328452505,19386,0,0,0,0,64137,0.01838378618992083,23523,0,0,0,0.0,0,0,0,0,0,0,0,0,0.0,383665,215082,
0,0.0,0,0,0,0,35836,42909,634583,0.0,168583,1842,0.051400194328452505,19386,0,0,0,0,64137,0.01838378618992083,23523,0,0,0,0.0,0,0,0,0,0,0,0,0,0.0,383665,215082,
0,0.0,0,0,0,0,35836,42909,634583,0.0,168583,1842,0.051400194328452505,19386,0,0,0,0,64137,0.01838378618992083,23523,0,0,0,0.0,0,0,0,0,0,0,0,0,0.0,383665,215082,
0,0.0,0,0,0,0,35836,42909,634583,0.0,168583,1842,0.051400194328452505,19386,0,0,0,0,64137,0.01838378618992083,23523,0,0,0,0.0,0,0,0,0,0,0,0,0,0.0,383665,215082,
0,0.0,0,0,0,0,35836,42909,634583,0.0,168583,1842,0.051400194328452505,19386,0,0,0,0,64137,0.01838378618992083,23523,0,0,0,0.0,0,0,0,0,0,0,0,0,0.0,383665,215082,
0,0.0,0,0,0,0,35836,42909,634583,0.0,168583,1842,0.051400194328452505,19386,0,0,0,0,64137,0.01838378618992083,23523,0,0,0,0.0,0,0,0,0,0,0,0,0,0.0,383665,215082,
0,0.0,0,0,0,0,35836,42909,634583,0.0,168583,1842,0.051400194328452505,19386,0,0,0,0,64137,0.01838378618992083,23523,0,0,0,0.0,0,0,0,0,0,0,0,0,0.0,383665,215082,
0,0.0,0,0,0,0,35836,42909,634583,0.0,168583,1842,0.051400194328452505,19386,0,0,0,0,64137,0.01838378618992083,23523,0,0,0,0.0,0,0,0,0,0,0,0,0,0.0,383665,215082,
0,0.0,0,0,0,0,35836,42909,634583,0.0,168583,1842,0.051400194328452505,19386,0,0,0,0,64137,0.01838378618992083,23523,0,0,0,0.0,0,0,0,0,0,0,0,0,0.0,383665,215082,
0,0.0,0,0,0,0,35836,42909,634583,0.0,168583,1842,0.051400194328452505,19386,0,0,0,0,64137,0.01838378618992083,23523,0,0,0,0.0,0,0,0,0,0,0,0,0,0.0,383665,215082,
0,0.0,0,0,0,0,35836,42909,634583,0.0,168583,1842,0.051400194328452505,19386,0,0,0,0,64137,0.01838378618992083,23523,0,0,0,0.0,0,0,0,0,0,0,0,0,0.0,383665,215082,
0,0.0,0,0,0,0,35836,42909,634583,0.0,168583,1842,0.051400194328452505,19386,0,0,0,0,64137,0.01838378618992083,23523,0,0,0,0.0,0,0,0,0,0,0,0,0,0.0,383665,215082,
0,0.0,0,0,0,0,35836,42909,634583,0.0,168583,1842,0.051400194328452505,19386,0,0,0,0,64137,0.01838378618992083,23523,0,0,0,0.0,0,0,0,0,0,0,0,0,0.0,383665,215082,
0,0.0,0,0,0,0,35836,42909,634583,0.0,168583,1842,0.051400194328452505,19386,0,0,0,0,64137,0.01838378618992083,23523,0,0,0,0.0,0,0,0,0,0,0,0,0,0.0,383665,215082,
0,0.0,0,0,0,0,35836,42909,634583,0.0,168583,1842,0.051400194328452505,19386,0,0,0,0,64137,0.01838378618992083,23523,0,0,0,0.0,0,0,0,0,0,0,0,0,0.0,383665,215082,
0,0.0,0,0,0,0,35836,42909,634583,0.0,168583,1842,0.051400194328452505,19386,0,0,0,0,64137,0.01838378618992083,23523,0,0,0,0.0,0,0,0,0,0,0,0,0,0.0,383665,215082,
0,0.0,0,0,0,0,35836,42909,634583,0.0,168583,1842,0.051400194328452505,19386,0,0,0,0,64137,0.01838378618992083,23523,0,0,0,0.0,0,0,0,0,0,0,0,0,0.0,383665,215082,
0,0.0,0,0,0,0,35836,42909,634583,0.0,168583,1842,0.051400194328452505,19386,0,0,0,0,64137,0.01838378618992083,23523,0,0,0,0.0,0,0,0,0,0,0,0,0,0.0,383665,215082,
0,0.0,0,0,0,0,35836,42909,634583,0.0,168583,1842,0.051400194328452505,19386,0,0,0,0,64137,0.01838378618992083,23523,0,0,0,0.0,0,0,0,0,0,0,0,0,0.0,383665,215082,
0,0.0,0,0,0,0,35836,42909,634583,0.0,168583,1842,0.051400194328452505,19386,0,0,0,0,64137,0.01838378618992083,23523,0,0,0,0.0,0,0,0,0,0,0,0,0,0.0,383665,215082,
0,0.0,0,0,0,0,35836,42909,634583,0.0,168583,1842,0.051400194328452505,19386,0,0,0,0,64137,0.01838378618992083,23523,0,0,0,0.0,0,0,0,0,0,0,0,0,0.0,383665,215082,
0,0.0,0,0,0,0,35836,42909,634583,0.0,168583,1842,0.051400194328452505,19386,0,0,0,0,64137,0.01838378618992083,23523,0,0,0,0.0,0,0,0,0,0,0,0,0,0.0,383665,215082,
0,0.0,0,0,0,0,35836,42909,634583,0.0,168583,1842,0.051400194328452505,19386,0,0,0,0,64137,0.01838378618992083,23523,0,0,0,0.0,0,0,0,0,0,0,0,0,0.0,383665,215082,
0,0.0,0,0,0,0,35836,42909,634583,0.0,168583,1842,0.051400194328452505,19386,0,0,0,0,64137,0.01838378618992083,23523,0,0,0,0.0,0,0,0,0,0,0,0,0,0.0,383665,215082,
0,0.0,0,0,0,0,35836,42909,634583,0.0,168583,1842,0.051400194328452505,19386,0,0,0,0,64137,0.01838378618992083,23523,0,0,0,0.0,0,0,0,0,0,0,0,0,0.0,383665,215082,
0,0.0,0,0,0,0,35836,42909,634583,0.0,168583,1842,0.051400194328452505,19386,0,0,0,0,64137,0.01838378618992083,23523,0,0,0,0.0,0,0,0,0,0,0,0,0,0.0,383665,215082,
0,0.0,0,0,0,0,35836,42909,634583,0.0,168583,1842,0.051400194328452505,19386,0,0,0,0,64137,0.01838378618992083,23523,0,0,0,0.0,0,0,0,0,0,0,0,0,0.0,383665,215082,
0,0.0,0,0,0,0,35836,42909,634583,0.0,168583,1842,0.051400194328452505,19386,0,0,0,0,64137,0.01838378618992083,23523,0,0,0,0.0,0,0,0,0,0,0,0,0,0.0,383665,215082,
0,0.0,0,0,0,0,35836,42909,634583,0.0,168583,1842,0.051400194328452505,19386,0,0,0,0,64137,0.01838378618992083,23523,0,0,0,0.0,0,0,0,0,0,0,0,0,0.0,383665,215082,
0,0.0,0,0,0,0,35836,42909,634583,0.0,168583,1842,0.051400194328452505,19386,0,0,0,0,64137,0.01838378618992083,23523,0,0,0,0.0,0,0,0,0,0,0,0,0,0.0,383665,215082,
0,0.0,0,0,0,0,35836,42909,634583,0.0,168583,1842,0.051400194328452505,19386,0,0,0,0,64137,0.01838378618992083,23523,0,0,0,0.0,0,0,0,0,0,0,0,0,0.0,383665,215082,
0,0.0,0,0,0,0,35836,42909,634583,0.0,168583,1842,0.051400194328452505,19386,0,0,0,0,64137,0.01838378618992083,23523,0,0,0,0.0,0,0,0,0,0,0,0,0,0.0,383665,215082,
0,0.0,0,0,0,0,35836,42909,634583,0.0,168583,1842,0.051400194328452505,19386,0,0,0,0,64137,0.01838378618992083,23523,0,0,0,0.0,0,0,0,0,0,0,0,0,0.0,383665,215082,
0,0.0,0,0,0,0,35836,42909,634583,0.0,168583,1842,0.051400194328452505,19386,0,0,0,0,64137,0.01838378618992083,23523,0,0,0,0.0,0,0,0,0,0,0,0,0,0.0,383665,215082,
0,0.0,0,0,0,0,35836,42909,634583,0.0,168583,1842,0.051400194328452505,19386,0,0,0,0,64137,0.01838378618992083,23523,0,0,0,0.0,0,0,0,0,0,0,0,0,0.0,383665,215082,
0,0.0,0,0,0,0,35836,42909,634583,0.0,168583,1842,0.051400194328452505,19386,0,0,0,0,64137,0.01838378618992083,23523,0,0,0,0.0,0,0,0,0,0,0,0,0,0.0,383665,215082,
0,0.0,0,0,0,0,35836,42909,634583,0.0,168583,1842,0.051400194328452505,19386,0,0,0,0,64137,0.01838378618992083,23523,0,0,0,0.0,0,0,0,0,0,0,0,0,0.0,383665,215082,
0,0.0,0,0,0,0,35836,42909,634583,0.0,168583,1842,0.051400194328452505,19386,0,0,0,0,64137,0.01838378618992083,23523,0,0,0,0.0,0,0,0,0,0,0,0,0,0.0,383665,215082,
0,0.0,0,0,0,0,35836,42909,634583,0.0,168583,1842,0.051400194328452505,19386,0,0,0,0,64137,0.01838378618992083,23523,0,0,0,0.0,0,0,0,0,0,0,0,0,0.0,383665,215082,
0,0.0,0,0,0,0,35836,42909,634583,0.0,168583,1842,0.051400194328452505,19386,0,0,0,0,64137,0.01838378618992083,23523,0,0,0,0.0,0,0,0,0,0,0,0,0,0.0,383665,215082,
0,0.0,0,0,0,0,35836,42909,634583,0.0,168583,1842,0.051400194328452505,19386,0,0,0,0,64137,0.01838378618992083,23523,0,0,0,0.0,0,0,0,0,0,0,0,0,0.0,383665,215082,
0,0.0,0,0,0,0,35836,42909,634583,0.0,168583,1842,0.051400194328452505,19386,0,0,0,0,64137,0.01838378618992083,23523,0,0,0,0.0,0,0,0,0,0,0,0,0,0.0,383665,215082,
0,0.0,0,0,0,0,35836,42909,634583,0.0,168583,1842,0.051400194328452505,19386,0,0,0,0,64137,0.01838378618992083,23523,0,0,0,0.0,0,0,0,0,0,0,0,0,0.0,383665,215082,
0,0.0,0,0,0,0,35836,42909,634583,0.0,168583,1842,0.051400194328452505,19386,0,0,0,0,64137,0.01838378618992083,23523,0,0,0,0.0,0,0,0,0,0,0,0,0,0.0,383665,215082,
0,0.0,0,0,0,0,35836,42909,634583,0.0,168583,1842,0.051400194328452505,19386,0,0,0,0,64137,0.01838378618992083,23523,0,0,0,0.0,0,0,0,0,0,0,0,0,0.0,383665,215082,
0,0.0,0,0,0,0,35836,42909,634583,0.0,168583,1842,0.051400194328452505,19386,0,0,0,0,64137,0.01838378618992083,23523,0,0,0,0.0,0,0,0,0,0,0,0,0,0.0,383665,215082,
0,0.0,0,0,0,0,35836,42909,634583,0.0,168583,1842,0.051400194328452505,19386,0,0,0,0,64137,0.01838378618992083,23523,0,0,0,0.0,0,0,0,0,0,0,0,0,0.0,383665,215082,
0,0.0,0,0,0,0,35836,42909,634583,0.0,168583,1842,0.051400194328452505,19386,0,0,0,0,64137,0.01838378618992083,23523,0,0,0,0.0,0,0,0,0,0,0,0,0,0.0,383665,215082,
0,0.0,0,0,0,0,35836,42909,634583,0.0,168583,1842,0.051400194328452505,19386,0,0,0,0,64137,0.01838378618992083,23523,0,0,0,0.0,0,0,0,0,0,0,0,0,0.0,383665,215082,
0,0.0,0,0,0,0,35836,42909,634583,0.0,168583,1842,0.051400194328452505,19386,0,0,0,0,64137,0.01838378618992083,23523,0,0,0,0.0,0,0,0,0,0,0,0,0,0.0,383665,215082,
0,0.0,0,0,0,0,35836,42909,634583,0.0,168583,1842,0.051400194328452505,19386,0,0,0,0,64137,0.01838378618992083,23523,0,0,0,0.0,0,0,0,0,0,0,0,0,0.0,383665,215082,
0,0.0,0,0,0,0,35836,42909,634583,0.0,168583,1842,0.051400194328452505,19386,0,0,0,0,64137,0.01838378618992083,23523,0,0,0,0.0,0,0,0,0,0,0,0,0,0.0,383665,215082,
0,0.0,0,0,0,0,35836,42909,634583,0.0,168583,1842,0.051400194328452505,19386,0,0,0,0,64137,0.01838378618992083,23523,0,0,0,0.0,0,0,0,0,0,0,0,0,0.0,383665,215082,
0,0.0,0,0,0,0,35836,42909,634583,0.0,168583,1842,0.051400194328452505,19386,0,0,0,0,64137,0.01838378618992083,23523,0,0,0,0.0,0,0,0,0,0,0,0,0,0.0,383665,215082,
0,0.0,0,0,0,0,35836,42909,634583,0.0,168583,1842,0.051400194328452505,19386,0,0,0,0,64137,0.01838378618992083,23523,0,0,0,0.0,0,0,0,0,0,0,0,0,0.0,383665,215082,
0,0.0,0,0,0,0,35836,42909,634583,0.0,168583,1842,0.051400194328452505,19386,0,0,0,0,64137,0.01838378618992083,23523,0,0,0,0.0,0,0,0,0,0,0,0,0,0.0,383665,215082,
0,0.0,0,0,0,0,35836,42909,634583,0.0,168583,1842,0.051400194328452505,19386,0,0,0,0,64137,0.01838378618992083,23523,0,0,0,0.0,0,0,0,0,0,0,0,0,0.0,383665,215082,
0,0.0,0,0,0,0,35836,42909,634583,0.0,168583,1842,0.051400194328452505,19386,0,0,0,0,64137,0.01838378618992083,23523,0,0,0,0.0,0,0,0,0,0,0,0,0,0.0,383665,215082,
0,0.0,0,0,0,0,35836,42909,634583,0.0,168583,1842,0.051400194328452505,19386,0,0,0,0,64137,0.01838378618992083,23523,0,0,0,0.0,0,0,0,0,0,0,0,0,0.0,383665,215082,
0,0.0,0,0,0,0,35836,42909,634583,0.0,168583,1842,0.051400194328452505,19386,0,0,0,0,64137,0.01838378618992083,23523,0,0,0,0.0,0,0,0,0,0,0,0,0,0.0,383665,215082,
0,0.0,0,0,0,0,35836,42909,634583,0.0,168583,1842,0.051400194328452505,19386,0,0,0,0,64137,0.01838378618992083,23523,0,0,0,0.0,0,0,0,0,0,0,0,0,0.0,383665,215082,
0,0.0,0,0,0,0,35836,42909,634583,0.0,168583,1842,0.051400194328452505,19386,0,0,0,0,64137,0.01838378618992083,23523,0,0,0,0.0,0,0,0,0,0,0,0,0,0.0,383665,215082,
0,0.0,0,0,0,0,35836,42909,634583,0.0,168583,1842,0.051400194328452505,19386,0,0,0,0,64137,0.01838378618992083,23523,0,0,0,0.0,0,0,0,0,0,0,0,0,0.0,383665,215082,
0,0.0,0,0,0,0,35836,42909,634583,0.0,168583,1842,0.051400194328452505,19386,0,0,0,0,64137,0.01838378618992083,23523,0,0,0,0.0,0,0,0,0,0,0,0,0,0.0,383665,215082,
0,0.0,0,0,0,0,35836,42909,634583,0.0,168583,1842,0.051400194328452505,19386,0,0,0,0,64137,0.01838378618992083,23523,0,0,0,0.0,0,0,0,0,0,0,0,0,0.0,383665,215082,
0,0.0,0,0,0,0,35836,42909,634583,0.0,168583,1842,0.051400194328452505,19386,0,0,0,0,64137,0.01838378618992083,23523,0,0,0,0.0,0,0,0,0,0,0,0,0,0.0,383665,215082,
0,0.0,0,0,0,0,35836,42909,634583,0.0,168583,1842,0.051400194328452505,19386,0,0,0,0,64137,0.01838378618992083,23523,0,0,0,0.0,0,0,0,0,0,0,0,0,0.0,383665,215082,
0,0.0,0,0,0,0,35836,42909,634583,0.0,168583,1842,0.051400194328452505,19386,0,0,0,0,64137,0.01838378618992083,23523,0,0,0,0.0,0,0,0,0,0,0,0,0,0.0,383665,215082,
0,0.0,0,0,0,0,35836,42909,634583,0.0,168583,1842,0.051400194328452505,19386,0,0,0,0,64137,0.01838378618992083,23523,0,0,0,0.0,0,0,0,0,0,0,0,0,0.0,383665,215082,
0,0.0,0,0,0,0,35836,42909,634583,0.0,168583,1842,0.051400194328452505,19386,0,0,0,0,64137,0.01838378618992083,23523,0,0,0,0.0,0,0,0,0,0,0,0,0,0.0,383665,215082,
0,0.0,0,0,0,0,35836,42909,634583,0.0,168583,1842,0.051400194328452505,19386,0,0,0,0,64137,0.01838378618992083,23523,0,0,0,0.0,0,0,0,0,0,0,0,0,0.0,383665,215082,
0,0.0,0,0,0,0,35836,42909,634583,0.0,168583,1842,0.051400194328452505,19386,0,0,0,0,64137,0.01838378618992083,23523,0,0,0,0.0,0,0,0,0,0,0,0,0,0.0,383665,215082,
0,0.0,0,0,0,0,35836,42909,634583,0.0,168583,1842,0.051400194328452505,19386,0,0,0,0,64137,0.01838378618992083,23523,0,0,0,0.0,0,0,0,0,0,0,0,0,0.0,383665,215082,
0,0.0,0,0,0,0,35836,42909,634583,0.0,168583,1842,0.051400194328452505,19386,0,0,0,0,64137,0.01838378618992083,23523,0,0,0,0.0,0,0,0,0,0,0,0,0,0.0,383665,215082,
0,0.0,0,0,0,0,35836,42909,634583,0.0,168583,1842,0.051400194328452505,19386,0,0,0,0,64137,0.01838378618992083,23523,0,0,0,0.0,0,0,0,0,0,0,0,0,0.0,383665,215082,
0,0.0,0,0,0,0,35836,42909,634583,0.0,168583,1842,0.051400194328452505,19386,0,0,0,0,64137,0.01838378618992083,23523,0,0,0,0.0,0,0,0,0,0,0,0,0,0.0,383665,215082,
0,0.0,0,0,0,0,35836,42909,634583,0.0,168583,1842,0.051400194328452505,19386,0,0,0,0,64137,0.01838378618992083,23523,0,0,0,0.0,0,0,0,0,0,0,0,0,0.0,383665,215082,
0,0.0,0,0,0,0,35836,42909,634583,0.0,168583,1842,0.051400194328452505,19386,0,0,0,0,64137,0.01838378618992083,23523,0,0,0,0.0,0,0,0,0,0,0,0,0,0.0,383665,215082,
0,0.0,0,0,0,0,35836,42909,634583,0.0,168583,1842,0.051400194328452505,19386,0,0,0,0,64137,0.01838378618992083,23523,0,0,0,0.0,0,0,0,0,0,0,0,0,0.0,383665,215082,
0,0.0,0,0,0,0,35836,42909,634583,0.0,168583,1842,0.051400194328452505,19386,0,0,0,0,64137,0.01838378618992083,23523,0,0,0,0.0,0,0,0,0,0,0,0,0,0.0,383665,215082,
0,0.0,0,0,0,0,35836,42909,634583,0.0,168583,1842,0.051400194328452505,19386,0,0,0,0,64137,0.01838378618992083,23523,0,0,0,0.0,0,0,0,0,0,0,0,0,0.0,383665,215082,
0,0.0,0,0,0,0,35836,42909,634583,0.0,168583,1842,0.051400194328452505,19386,0,0,0,0,64137,0.01838378618992083,23523,0,0,0,0.0,0,0,0,0,0,0,0,0,0.0,383665,215082,
0,0.0,0,0,0,0,35836,42909,634583,0.0,168583,1842,0.051400194328452505,19386,0,0,0,0,64137,0.01838378618992083,23523,0,0,0,0.0,0,0,0,0,0,0,0,0,0.0,383665,215082,
0,0.0,0,0,0,0,35836,42909,634583,0.0,168583,1842,0.051400194328452505,19386,0,0,0,0,64137,0.01838378618992083,23523,0,0,0,0.0,0,0,0,0,0,0,0,0,0.0,383665,215082,
0,0.0,0,0,0,0,35836,42909,634583,0.0,168583,1842,0.051400194328452505,19386,0,0,0,0,64137,0.01838378618992083,23523,0,0,0,0.0,0,0,0,0,0,0,0,0,0.0,383665,215082,
0,0.0,0,0,0,0,35836,42909,634583,0.0,168583,1842,0.051400194328452505,19386,0,0,0,0,64137,0.01838378618992083,23523,0,0,0,0.0,0,0,0,0,0,0,0,0,0.0,383665,215082,
0,0.0,0,0,0,0,35836,42909,634583,0.0,168583,1842,0.051400194328452505,19386,0,0,0,0,64137,0.01838378618992083,23523,0,0,0,0.0,0,0,0,0,0,0,0,0,0.0,383665,215082,
0,0.0,0,0,0,0,35836,42909,634583,0.0,168583,1842,0.051400194328452505,19386,0,0,0,0,64137,0.01838378618992083,23523,0,0,0,0.0,0,0,0,0,0,0,0,0,0.0,383665,215082,
0,0.0,0,0,0,0,35836,42909,634583,0.0,168583,1842,0.051400194328452505,19386,0,0,0,0,64137,0.01838378618992083,23523,0,0,0,0.0,0,0,0,0,0,0,0,0,0.0,383665,215082,
0,0.0,0,0,0,0,35836,42909,634583,0.0,168583,1842,0.051400194328452505,19386,0,0,0,0,64137,0.01838378618992083,23523,0,0,0,0.0,0,0,0,0,0,0,0,0,0.0,383665,215082,
0,0.0,0,0,0,0,35836,42909,634583,0.0,168583,1842,0.051400194328452505,19386,0,0,0,0,64137,0.01838378618992083,23523,0,0,0,0.0,0,0,0,0,0,0,0,0,0.0,383665,215082,
0,0.0,0,0,0,0,35836,42909,634583,0.0,168583,1842,0.051400194328452505,19386,0,0,0,0,64137,0.01838378618992083,23523,0,0,0,0.0,0,0,0,0,0,0,0,0,0.0,383665,215082,
0,0.0,0,0,0,0,35836,42909,634583,0.0,168583,1842,0.051400194328452505,19386,0,0,0,0,64137,0.01838378618992083,23523,0,0,0,0.0,0,0,0,0,0,0,0,0,0.0,383665,215082,
0,0.0,0,0,0,0,35836,42909,634583,0.0,168583,1842,0.051400194328452505,19386,0,0,0,0,64137,0.01838378618992083,23523,0,0,0,0.0,0,0,0,0,0,0,0,0,0.0,383665,215082,
0,0.0,0,0,0,0,35836,42909,634583,0.0,168583,1842,0.051400194328452505,19386,0,0,0,0,64137,0.01838378618992083,23523,0,0,0,0.0,0,0,0,0,0,0,0,0,0.0,383665,215082,
0,0.0,0,0,0,0,35836,42909,634583,0.0,168583,1842,0.051400194328452505,19386,0,0,0,0,64137,0.01838378618992083,23523,0,0,0,0.0,0,0,0,0,0,0,0,0,0.0,383665,215082,
0,0.0,0,0,0,0,35836,42909,634583,0.0,168583,1842,0.051400194328452505,19386,0,0,0,0,64137,0.01838378618992083,23523,0,0,0,0.0,0,0,0,0,0,0,0,0,0.0,383665,215082,
0,0.0,0,0,0,0,35836,42909,634583,0.0,168583,1842,0.051400194328452505,19386,0,0,0,0,64137,0.01838378618992083,23523,0,0,0,0.0,0,0,0,0,0,0,0,0,0.0,383665,215082,
0,0.0,0,0,0,0,35836,42909,634583,0.0,168583,1842,0.051400194328452505,19386,0,0,0,0,64137,0.01838378618992083,23523,0,0,0,0.0,0,0,0,0,0,0,0,0,0.0,383665,215082,
0,0.0,0,0,0,0,35836,42909,634583,0.0,168583,1842,0.051400194328452505,19386,0,0,0,0,64137,0.01838378618992083,23523,0,0,0,0.0,0,0,0,0,0,0,0,0,0.0,383665,215082,
0,0.0,0,0,0,0,35836,42909,634583,0.0,168583,1842,0.051400194328452505,19386,0,0,0,0,64137,0.01838378618992083,23523,0,0,0,0.0,0,0,0,0,0,0,0,0,0.0,383665,215082,
0,0.0,0,0,0,0,35836,42909,634583,0.0,168583,1842,0.051400194328452505,19386,0,0,0,0,64137,0.01838378618992083,23523,0,0,0,0.0,0,0,0,0,0,0,0,0,0.0,383665,215082,
0,0.0,0,0,0,0,35836,42909,634583,0.0,168583,1842,0.051400194328452505,19386,0,0,0,0,64137,0.01838378618992083,23523,0,0,0,0.0,0,0,0,0,0,0,0,0,0.0,383665,215082,
0,0.0,0,0,0,0,35836,42909,634583,0.0,168583,1842,0.051400194328452505,19386,0,0,0,0,64137,0.01838378618992083,23523,0,0,0,0.0,0,0,0,0,0,0,0,0,0.0,383665,215082,
0,0.0,0,0,0,0,35836,42909,634583,0.0,168583,1842,0.051400194328452505,19386,0,0,0,0,64137,0.01838378618992083,23523,0,0,0,0.0,0,0,0,0,0,0,0,0,0.0,383665,215082,
0,0.0,0,0,0,0,35836,42909,634583,0.0,168583,1842,0.051400194328452505,19386,0,0,0,0,64137,0.01838378618992083,23523,0,0,0,0.0,0,0,0,0,0,0,0,0,0.0,383665,215082,
0,0.0,0,0,0,0,35836,42909,634583,0.0,168583,1842,0.051400194328452505,19386,0,0,0,0,64137,0.01838378618992083,23523,0,0,0,0.0,0,0,0,0,0,0,0,0,0.0,383665,215082,
0,0.0,0,0,0,0,35836,42909,634583,0.0,168583,1842,0.051400194328452505,19386,0,0,0,0,64137,0.01838378618992083,23523,0,0,0,0.0,0,0,0,0,0,0,0,0,0.0,383665,215082,
0,0.0,0,0,0,0,35836,42909,634583,0.0,168583,1842,0.051400194328452505,19386,0,0,0,0,64137,0.01838378618992083,23523,0,0,0,0.0,0,0,0,0,0,0,0,0,0.0,383665,215082,
0,0.0,0,0,0,0,35836,42909,634583,0.0,168583,1842,0.051400194328452505,19386,0,0,0,0,64137,0.01838378618992083,23523,0,0,0,0.0,0,0,0,0,0,0,0,0,0.0,383665,215082,
0,0.0,0,0,0,0,35836,42909,634583,0.0,168583,1842,0.051400194328452505,19386,0,0,0,0,64137,0.01838378618992083,23523,0,0,0,0.0,0,0,0,0,0,0,0,0,0.0,383665,215082,
0,0.0,0,0,0,0,35836,42909,634583,0.0,168583,1842,0.051400194328452505,19386,0,0,0,0,64137,0.01838378618992083,23523,0,0,0,0.0,0,0,0,0,0,0,0,0,0.0,383665,215082,
0,0.0,0,0,0,0,35836,42909,634583,0.0,168583,1842,0.051400194328452505,19386,0,0,0,0,64137,0.01838378618992083,23523,0,0,0,0.0,0,0,0,0,0,0,0,0,0.0,383665,215082,
0,0.0,0,0,0,0,35836,42909,634583,0.0,168583,1842,0.051400194328452505,19386,0,0,0,0,64137,0.01838378618992083,23523,0,0,0,0.0,0,0,0,0,0,0,0,0,0.0,383665,215082,
0,0.0,0,0,0,0,35836,42909,634583,0.0,168583,1842,0.051400194328452505,19386,0,0,0,0,64137,0.01838378618992083,23523,0,0,0,0.0,0,0,0,0,0,0,0,0,0.0,383665,215082,
0,0.0,0,0,0,0,35836,42909,634583,0.0,168583,1842,0.051400194328452505,19386,0,0,0,0,64137,0.01838378618992083,23523,0,0,0,0.0,0,0,0,0,0,0,0,0,0.0,383665,215082,
0,0.0,0,0,0,0,35836,42909,634583,0.0,168583,1842,0.051400194328452505,19386,0,0,0,0,64137,0.01838378618992083,23523,0,0,0,0.0,0,0,0,0,0,0,0,0,0.0,383665,215082,
0,0.0,0,0,0,0,35836,42909,634583,0.0,168583,1842,0.051400194328452505,19386,0,0,0,0,64137,0.01838378618992083,23523,0,0,0,0.0,0,0,0,0,0,0,0,0,0.0,383665,215082,
0,0.0,0,0,0,0,35836,42909,634583,0.0,168583,1842,0.051400194328452505,19386,0,0,0,0,64137,0.01838378618992083,23523,0,0,0,0.0,0,0,0,0,0,0,0,0,0.0,383665,215082,
0,0.0,0,0,0,0,35836,42909,634583,0.0,168583,1842,0.051400194328452505,19386,0,0,0,0,64137,0.01838378618992083,23523,0,0,0,0.0,0,0,0,0,0,0,0,0,0.0,383665,215082,
0,0.0,0,0,0,0,35836,42909,634583,0.0,168583,1842,0.051400194328452505,19386,0,0,0,0,64137,0.01838378618992083,23523,0,0,0,0.0,0,0,0,0,0,0,0,0,0.0,383665,215082,
0,0.0,0,0,0,0,35836,42909,634583,0.0,168583,1842,0.051400194328452505,19386,0,0,0,0,64137,0.01838378618992083,23523,0,0,0,0.0,0,0,0,0,0,0,0,0,0.0,383665,215082,
0,0.0,0,0,0,0,35836,42909,634583,0.0,168583,1842,0.051400194328452505,19386,0,0,0,0,64137,0.01838378618992083,23523,0,0,0,0.0,0,0,0,0,0,0,0,0,0.0,383665,215082,
0,0.0,0,0,0,0,35836,42909,634583,0.0,168583,1842,0.051400194328452505,19386,0,0,0,0,64137,0.01838378618992083,23523,0,0,0,0.0,0,0,0,0,0,0,0,0,0.0,383665,215082,
0,0.0,0,0,0,0,35836,42909,634583,0.0,168583,1842,0.051400194328452505,19386,0,0,0,0,64137,0.01838378618992083,23523,0,0,0,0.0,0,0,0,0,0,0,0,0,0.0,383665,215082,
0,0.0,0,0,0,0,35836,42909,634583,0.0,168583,1842,0.051400194328452505,19386,0,0,0,0,64137,0.01838378618992083,23523,0,0,0,0.0,0,0,0,0,0,0,0,0,0.0,383665,215082,
0,0.0,0,0,0,0,35836,42909,634583,0.0,168583,1842,0.051400194328452505,19386,0,0,0,0,64137,0.01838378618992083,23523,0,0,0,0.0,0,0,0,0,0,0,0,0,0.0,383665,215082,
0,0.0,0,0,0,0,35836,42909,634583,0.0,168583,1842,0.051400194328452505,19386,0,0,0,0,64137,0.01838378618992083,23523,0,0,0,0.0,0,0,0,0,0,0,0,0,0.0,383665,215082,
0,0.0,0,0,0,0,35836,42909,634583,0.0,168583,1842,0.051400194328452505,19386,0,0,0,0,64137,0.01838378618992083,23523,0,0,0,0.0,0,0,0,0,0,0,0,0,0.0,383665,215082,
0,0.0,0,0,0,0,35836,42909,634583,0.0,168583,1842,0.051400194328452505,19386,0,0,0,0,64137,0.01838378618992083,23523,0,0,0,0.0,0,0,0,0,0,0,0,0,0.0,383665,215082,
0,0.0,0,0,0,0,35836,42909,634583,0.0,168583,1842,0.051400194328452505,19386,0,0,0,0,64137,0.01838378618992083,23523,0,0,0,0.0,0,0,0,0,0,0,0,0,0.0,383665,215082,
0,0.0,0,0,0,0,35836,42909,634583,0.0,168583,1842,0.051400194328452505,19386,0,0,0,0,64137,0.01838378618992083,23523,0,0,0,0.0,0,0,0,0,0,0,0,0,0.0,383665,215082,
0,0.0,0,0,0,0,35836,42909,634583,0.0,168583,1842,0.051400194328452505,19386,0,0,0,0,64137,0.01838378618992083,23523,0,0,0,0.0,0,0,0,0,0,0,0,0,0.0,383665,215082,
0,0.0,0,0,0,0,35836,42909,634583,0.0,168583,1842,0.051400194328452505,19386,0,0,0,0,64137,0.01838378618992083,23523,0,0,0,0.0,0,0,0,0,0,0,0,0,0.0,383665,215082,
0,0.0,0,0,0,0,35836,42909,634583,0.0,168583,1842,0.051400194328452505,19386,0,0,0,0,64137,0.01838378618992083,23523,0,0,0,0.0,0,0,0,0,0,0,0,0,0.0,383665,215082,
0,0.0,0,0,0,0,35836,42909,634583,0.0,168583,1842,0.051400194328452505,19386,0,0,0,0,64137,0.01838378618992083,23523,0,0,0,0.0,0,0,0,0,0,0,0,0,0.0,383665,215082,
0,0.0,0,0,0,0,35836,42909,634583,0.0,168583,1842,0.051400194328452505,19386,0,0,0,0,64137,0.01838378618992083,23523,0,0,0,0.0,0,0,0,0,0,0,0,0,0.0,383665,215082,
0,0.0,0,0,0,0,35836,42909,634583,0.0,168583,1842,0.051400194328452505,19386,0,0,0,0,64137,0.01838378618992083,23523,0,0,0,0.0,0,0,0,0,0,0,0,0,0.0,383665,215082,
0,0.0,0,0,0,0,35836,42909,634583,0.0,168583,1842,0.051400194328452505,19386,0,0,0,0,64137,0.01838378618992083,23523,0,0,0,0.0,0,0,0,0,0,0,0,0,0.0,383665,215082,
0,0.0,0,0,0,0,35836,42909,634583,0.0,168583,1842,0.051400194328452505,19386,0,0,0,0,64137,0.01838378618992083,23523,0,0,0,0.0,0,0,0,0,0,0,0,0,0.0,383665,215082,
0,0.0,0,0,0,0,35836,42909,634583,0.0,168583,1842,0.051400194328452505,19386,0,0,0,0,64137,0.01838378618992083,23523,0,0,0,0.0,0,0,0,0,0,0,0,0,0.0,383665,215082,
0,0.0,0,0,0,0,35836,42909,634583,0.0,168583,1842,0.051400194328452505,19386,0,0,0,0,64137,0.01838378618992083,23523,0,0,0,0.0,0,0,0,0,0,0,0,0,0.0,383665,215082,
0,0.0,0,0,0,0,35836,42909,634583,0.0,168583,1842,0.051400194328452505,19386,0,0,0,0,64137,0.01838378618992083,23523,0,0,0,0.0,0,0,0,0,0,0,0,0,0.0,383665,215082,
0,0.0,0,0,0,0,35836,42909,634583,0.0,168583,1842,0.051400194328452505,19386,0,0,0,0,64137,0.01838378618992083,23523,0,0,0,0.0,0,0,0,0,0,0,0,0,0.0,383665,215082,
0,0.0,0,0,0,0,35836,42909,634583,0.0,168583,1842,0.051400194328452505,19386,0,0,0,0,64137,0.01838378618992083,23523,0,0,0,0.0,0,0,0,0,0,0,0,0,0.0,383665,215082,
0,0.0,0,0,0,0,35836,42909,634583,0.0,168583,1842,0.051400194328452505,19386,0,0,0,0,64137,0.01838378618992083,23523,0,0,0,0.0,0,0,0,0,0,0,0,0,0.0,383665,215082,
0,0.0,0,0,0,0,35836,42909,634583,0.0,168583,1842,0.051400194328452505,19386,0,0,0,0,64137,0.01838378618992083,23523,0,0,0,0.0,0,0,0,0,0,0,0,0,0.0,383665,215082,
0,0.0,0,0,0,0,35836,42909,634583,0.0,168583,1842,0.051400194328452505,19386,0,0,0,0,64137,0.01838378618992083,23523,0,0,0,0.0,0,0,0,0,0,0,0,0,0.0,383665,215082,
0,0.0,0,0,0,0,35836,42909,634583,0.0,168583,1842,0.051400194328452505,19386,0,0,0,0,64137,0.01838378618992083,23523,0,0,0,0.0,0,0,0,0,0,0,0,0,0.0,383665,215082,
0,0.0,0,0,0,0,35836,42909,634583,0.0,168583,1842,0.051400194328452505,19386,0,0,0,0,64137,0.01838378618992083,23523,0,0,0,0.0,0,0,0,0,0,0,0,0,0.0,383665,215082,
0,0.0,0,0,0,0,35836,42909,634583,0.0,168583,1842,0.051400194328452505,19386,0,0,0,0,64137,0.01838378618992083,23523,0,0,0,0.0,0,0,0,0,0,0,0,0,0.0,383665,215082,
0,0.0,0,0,0,0,35836,42909,634583,0.0,168583,1842,0.051400194328452505,19386,0,0,0,0,64137,0.01838378618992083,23523,0,0,0,0.0,0,0,0,0,0,0,0,0,0.0,383665,215082,
268,0.0,1,137,131,406,35836,42909,634583,0.0033163941071360846,168583,1842,0.051400194328452505,19386,336,330,56,722,64137,0.01838378618992083,23523,0,6,0,0.19450461286963558,0,84323,0,52866,12262,0,149451,31457,0.05583383876262924,383665,215082,
268,0.0,1,137,131,406,35836,42909,634583,0.0033163941071360846,168583,1842,0.051400194328452505,19386,336,330,56,722,64137,0.01838378618992083,23523,0,6,0,0.19450461286963558,0,84323,0,52866,12262,0,149451,31457,0.05583383876262924,383665,215082,
268,0.0,1,137,131,406,35836,42909,634583,0.0033163941071360846,168583,1842,0.051400194328452505,19386,336,330,56,722,64137,0.01838378618992083,23523,0,6,0,0.19450461286963558,0,84323,0,52866,12262,0,149451,31457,0.05583383876262924,383665,215082,
268,0.0,1,137,131,406,35836,42909,634583,0.0033163941071360846,168583,1842,0.051400194328452505,19386,506,406,59,971,64137,0.01838378618992083,23523,0,100,0,0.1700763777445502,0,84323,0,52866,12262,0,149451,31457,0.05583383876262924,383665,215082,
268,0.0,1,137,131,406,35836,42909,634583,0.0033163941071360846,168583,1842,0.051400194328452505,19386,506,406,59,971,64137,0.01838378618992083,23523,0,100,0,0.1700763777445502,0,84323,0,52866,12262,0,149451,31457,0.05583383876262924,383665,215082,
268,0.0,1,137,131,406,35836,42909,634583,0.0033163941071360846,168583,1842,0.051400194328452505,19386,506,406,59,971,64137,0.01838378618992083,23523,0,100,0,0.1700763777445502,0,84323,0,52866,12262,0,149451,31457,0.05583383876262924,383665,215082,
268,0.0,1,137,131,406,35836,42909,634583,0.0033163941071360846,168583,1842,0.051400194328452505,19386,110,323,38,471,64137,0.01838378618992083,23523,0,-213,0,0.0944372338169388,0,84323,0,52866,12262,0,149451,31457,0.05583383876262924,383665,215082,
268,0.0,1,137,131,406,35836,42909,634583,0.0033163941071360846,168583,1842,0.051400194328452505,19386,110,323,38,471,64137,0.01838378618992083,23523,0,-213,0,0.0944372338169388,0,84323,0,52866,12262,0,149451,31457,0.05583383876262924,383665,215082,
268,0.0,1,137,131,406,35836,42909,634583,0.0033163941071360846,168583,1842,0.051400194328452505,19386,110,323,38,471,64137,0.01838378618992083,23523,0,-213,0,0.0944372338169388,0,84323,0,52866,12262,0,149451,31457,0.05583383876262924,383665,215082,
268,0.0,1,137,131,406,35836,42909,634583,0.0033163941071360846,168583,1842,0.051400194328452505,19386,9,9,0,18,64137,0.01838378618992083,23523,0,0,0,0.047619047619047616,0,84323,0,52866,12262,0,149451,31457,0.05583383876262924,383665,215082,
268,0.0,1,137,131,406,35836,42909,634583,0.0033163941071360846,168583,1842,0.051400194328452505,19386,9,9,0,18,64137,0.01838378618992083,23523,0,0,0,0.047619047619047616,0,84323,0,52866,12262,0,149451,31457,0.05583383876262924,383665,215082,
268,0.0,1,137,131,406,35836,42909,634583,0.0033163941071360846,168583,1842,0.051400194328452505,19386,9,9,0,18,64137,0.01838378618992083,23523,0,0,0,0.047619047619047616,0,84323,0,52866,12262,0,149451,31457,0.05583383876262924,383665,215082,
268,0.0,1,137,131,406,35836,42909,634583,0.0033163941071360846,168583,1842,0.051400194328452505,19386,58046,38889,10572,107507,64137,0.01838378618992083,23523,0,19157,0,0.415986767925396,0,84323,0,52866,12262,0,149451,31457,0.05583383876262924,383665,215082,
268,0.0,1,137,131,406,35836,42909,634583,0.0033163941071360846,168583,1842,0.051400194328452505,19386,58046,38889,10572,107507,64137,0.01838378618992083,23523,0,19157,0,0.415986767925396,0,84323,0,52866,12262,0,149451,31457,0.05583383876262924,383665,215082,
268,0.0,1,137,131,406,35836,42909,634583,0.0033163941071360846,168583,1842,0.051400194328452505,19386,58046,38889,10572,107507,64137,0.01838378618992083,23523,0,19157,0,0.415986767925396,0,84323,0,52866,12262,0,149451,31457,0.05583383876262924,383665,215082,
268,0.0,1,137,131,406,35836,42909,634583,0.0033163941071360846,168583,1842,0.051400194328452505,19386,58046,38889,10572,107507,64137,0.01838378618992083,23523,0,19157,0,0.415986767925396,0,84323,0,52866,12262,0,149451,31457,0.05583383876262924,383665,215082,
268,0.0,1,137,131,406,35836,42909,634583,0.0033163941071360846,168583,1842,0.051400194328452505,19386,58046,38889,10572,107507,64137,0.01838378618992083,23523,0,19157,0,0.415986767925396,0,84323,0,52866,12262,0,149451,31457,0.05583383876262924,383665,215082,
268,0.0,1,137,131,406,35836,42909,634583,0.0033163941071360846,168583,1842,0.051400194328452505,19386,58046,38889,10572,107507,64137,0.01838378618992083,23523,0,19157,0,0.415986767925396,0,84323,0,52866,12262,0,149451,31457,0.05583383876262924,383665,215082,
268,0.0,1,137,131,406,35836,42909,634583,0.0033163941071360846,168583,1842,0.051400194328452505,19386,58046,38889,10572,107507,64137,0.01838378618992083,23523,0,19157,0,0.415986767925396,0,84323,0,52866,12262,0,149451,31457,0.05583383876262924,383665,215082,
268,0.0,1,137,131,406,35836,42909,634583,0.0033163941071360846,168583,1842,0.051400194328452505,19386,58046,38889,10572,107507,64137,0.01838378618992083,23523,0,19157,0,0.415986767925396,0,84323,0,52866,12262,0,149451,31457,0.05583383876262924,383665,215082,
268,0.0,1,137,131,406,35836,42909,634583,0.0033163941071360846,168583,1842,0.051400194328452505,19386,58046,38889,10572,107507,64137,0.01838378618992083,23523,0,19157,0,0.415986767925396,0,84323,0,52866,12262,0,149451,31457,0.05583383876262924,383665,215082,
268,0.0,1,137,131,406,35836,42909,634583,0.0033163941071360846,168583,1842,0.051400194328452505,19386,58046,38889,10572,107507,64137,0.01838378618992083,23523,0,19157,0,0.415986767925396,0,84323,0,52866,12262,0,149451,31457,0.05583383876262924,383665,215082,
268,0.0,1,137,131,406,35836,42909,634583,0.0033163941071360846,168583,1842,0.051400194328452505,19386,58046,38889,10572,107507,64137,0.01838378618992083,23523,0,19157,0,0.415986767925396,0,84323,0,52866,12262,0,149451,31457,0.05583383876262924,383665,215082,
268,0.0,1,137,131,406,35836,42909,634583,0.0033163941071360846,168583,1842,0.051400194328452505,19386,58046,38889,10572,107507,64137,0.01838378618992083,23523,0,19157,0,0.415986767925396,0,84323,0,52866,12262,0,149451,31457,0.05583383876262924,383665,215082,
268,0.0,1,137,131,406,35836,42909,634583,0.0033163941071360846,168583,1842,0.051400194328452505,19386,58046,38889,10572,107507,64137,0.01838378618992083,23523,0,19157,0,0.415986767925396,0,84323,0,52866,12262,0,149451,31457,0.05583383876262924,383665,215082,
268,0.0,1,137,131,406,35836,42909,634583,0.0033163941071360846,168583,1842,0.051400194328452505,19386,58046,38889,10572,107507,64137,0.01838378618992083,23523,0,19157,0,0.415986767925396,0,84323,0,52866,12262,0,149451,31457,0.05583383876262924,383665,215082,
268,0.0,1,137,131,406,35836,42909,634583,0.0033163941071360846,168583,1842,0.051400194328452505,19386,58046,38889,10572,107507,64137,0.01838378618992083,23523,0,19157,0,0.415986767925396,0,84323,0,52866,12262,0,149451,31457,0.05583383876262924,383665,215082,
268,0.0,1,137,131,406,35836,42909,634583,0.0033163941071360846,168583,1842,0.051400194328452505,19386,58046,38889,10572,107507,64137,0.01838378618992083,23523,0,19157,0,0.415986767925396,0,84323,0,52866,12262,0,149451,31457,0.05583383876262924,383665,215082,
268,0.0,1,137,131,406,35836,42909,634583,0.0033163941071360846,168583,1842,0.051400194328452505,19386,58046,38889,10572,107507,64137,0.01838378618992083,23523,0,19157,0,0.415986767925396,0,84323,0,52866,12262,0,149451,31457,0.05583383876262924,383665,215082,
268,0.0,1,137,131,406,35836,42909,634583,0.0033163941071360846,168583,1842,0.051400194328452505,19386,58046,38889,10572,107507,64137,0.01838378618992083,23523,0,19157,0,0.415986767925396,0,84323,0,52866,12262,0,149451,31457,0.05583383876262924,383665,215082,
268,0.0,1,137,131,406,35836,42909,634583,0.0033163941071360846,168583,1842,0.051400194328452505,19386,58046,38889,10572,107507,64137,0.01838378618992083,23523,0,19157,0,0.415986767925396,0,84323,0,52866,12262,0,149451,31457,0.05583383876262924,383665,215082,
268,0.0,1,137,131,406,35836,42909,634583,0.0033163941071360846,168583,1842,0.051400194328452505,19386,58046,38889,10572,107507,64137,0.01838378618992083,23523,0,19157,0,0.415986767925396,0,84323,0,52866,12262,0,149451,31457,0.05583383876262924,383665,215082,
268,0.0,1,137,131,406,35836,42909,634583,0.0033163941071360846,168583,1842,0.051400194328452505,19386,58046,38889,10572,107507,64137,0.01838378618992083,23523,0,19157,0,0.415986767925396,0,84323,0,52866,12262,0,149451,31457,0.05583383876262924,383665,215082,
268,0.0,1,137,131,406,35836,42909,634583,0.0033163941071360846,168583,1842,0.051400194328452505,19386,58046,38889,10572,107507,64137,0.01838378618992083,23523,0,19157,0,0.415986767925396,0,84323,0,52866,12262,0,149451,31457,0.05583383876262924,383665,215082,
268,0.0,1,137,131,406,35836,42909,634583,0.0033163941071360846,168583,1842,0.051400194328452505,19386,58046,38889,10572,107507,64137,0.01838378618992083,23523,0,19157,0,0.415986767925396,0,84323,0,52866,12262,0,149451,31457,0.05583383876262924,383665,215082,
268,0.0,1,137,131,406,35836,42909,634583,0.0033163941071360846,168583,1842,0.051400194328452505,19386,58046,38889,10572,107507,64137,0.01838378618992083,23523,0,19157,0,0.415986767925396,0,84323,0,52866,12262,0,149451,31457,0.05583383876262924,383665,215082,
268,0.0,1,137,131,406,35836,42909,634583,0.0033163941071360846,168583,1842,0.051400194328452505,19386,58046,38889,10572,107507,64137,0.01838378618992083,23523,0,19157,0,0.415986767925396,0,84323,0,52866,12262,0,149451,31457,0.05583383876262924,383665,215082,
268,0.0,1,137,131,406,35836,42909,634583,0.0033163941071360846,168583,1842,0.051400194328452505,19386,58046,38889,10572,107507,64137,0.01838378618992083,23523,0,19157,0,0.415986767925396,0,84323,0,52866,12262,0,149451,31457,0.05583383876262924,383665,215082,
268,0.0,1,137,131,406,35836,42909,634583,0.0033163941071360846,168583,1842,0.051400194328452505,19386,58046,38889,10572,107507,64137,0.01838378618992083,23523,0,19157,0,0.415986767925396,0,84323,0,52866,12262,0,149451,31457,0.05583383876262924,383665,215082,
268,0.0,1,137,131,406,35836,42909,634583,0.0033163941071360846,168583,1842,0.051400194328452505,19386,58046,38889,10572,107507,64137,0.01838378618992083,23523,0,19157,0,0.415986767925396,0,84323,0,52866,12262,0,149451,31457,0.05583383876262924,383665,215082,
268,0.0,1,137,131,406,35836,42909,634583,0.0033163941071360846,168583,1842,0.051400194328452505,19386,58046,38889,10572,107507,64137,0.01838378618992083,23523,0,19157,0,0.415986767925396,0,84323,0,52866,12262,0,149451,31457,0.05583383876262924,383665,215082,
268,0.0,1,137,131,406,35836,42909,634583,0.0033163941071360846,168583,1842,0.051400194328452505,19386,58046,38889,10572,107507,64137,0.01838378618992083,23523,0,19157,0,0.415986767925396,0,84323,0,52866,12262,0,149451,31457,0.05583383876262924,383665,215082,
268,0.0,1,137,131,406,35836,42909,634583,0.0033163941071360846,168583,1842,0.051400194328452505,19386,58046,38889,10572,107507,64137,0.01838378618992083,23523,0,19157,0,0.415986767925396,0,84323,0,52866,12262,0,149451,31457,0.05583383876262924,383665,215082,
268,0.0,1,137,131,406,35836,42909,634583,0.0033163941071360846,168583,1842,0.051400194328452505,19386,58046,38889,10572,107507,64137,0.01838378618992083,23523,0,19157,0,0.415986767925396,0,84323,0,52866,12262,0,149451,31457,0.05583383876262924,383665,215082,
268,0.0,1,137,131,406,35836,42909,634583,0.0033163941071360846,168583,1842,0.051400194328452505,19386,58046,38889,10572,107507,64137,0.01838378618992083,23523,0,19157,0,0.415986767925396,0,84323,0,52866,12262,0,149451,31457,0.05583383876262924,383665,215082,
268,0.0,1,137,131,406,35836,42909,634583,0.0033163941071360846,168583,1842,0.051400194328452505,19386,58046,38889,10572,107507,64137,0.01838378618992083,23523,0,19157,0,0.415986767925396,0,84323,0,52866,12262,0,149451,31457,0.05583383876262924,383665,215082,
268,0.0,1,137,131,406,35836,42909,634583,0.0033163941071360846,168583,1842,0.051400194328452505,19386,58046,38889,10572,107507,64137,0.01838378618992083,23523,0,19157,0,0.415986767925396,0,84323,0,52866,12262,0,149451,31457,0.05583383876262924,383665,215082,
268,0.0,1,137,131,406,35836,42909,634583,0.0033163941071360846,168583,1842,0.051400194328452505,19386,58046,38889,10572,107507,64137,0.01838378618992083,23523,0,19157,0,0.415986767925396,0,84323,0,52866,12262,0,149451,31457,0.05583383876262924,383665,215082,
268,0.0,1,137,131,406,35836,42909,634583,0.0033163941071360846,168583,1842,0.051400194328452505,19386,58046,38889,10572,107507,64137,0.01838378618992083,23523,0,19157,0,0.415986767925396,0,84323,0,52866,12262,0,149451,31457,0.05583383876262924,383665,215082,
268,0.0,1,137,131,406,35836,42909,634583,0.0033163941071360846,168583,1842,0.051400194328452505,19386,58046,38889,10572,107507,64137,0.01838378618992083,23523,0,19157,0,0.415986767925396,0,84323,0,52866,12262,0,149451,31457,0.05583383876262924,383665,215082,
268,0.0,1,137,131,406,35836,42909,634583,0.0033163941071360846,168583,1842,0.051400194328452505,19386,58046,38889,10572,107507,64137,0.01838378618992083,23523,0,19157,0,0.415986767925396,0,84323,0,52866,12262,0,149451,31457,0.05583383876262924,383665,215082,
268,0.0,1,137,131,406,35836,42909,634583,0.0033163941071360846,168583,1842,0.051400194328452505,19386,58046,38889,10572,107507,64137,0.01838378618992083,23523,0,19157,0,0.415986767925396,0,84323,0,52866,12262,0,149451,31457,0.05583383876262924,383665,215082,
268,0.0,1,137,131,406,35836,42909,634583,0.0033163941071360846,168583,1842,0.051400194328452505,19386,58046,38889,10572,107507,64137,0.01838378618992083,23523,0,19157,0,0.415986767925396,0,84323,0,52866,12262,0,149451,31457,0.05583383876262924,383665,215082,
268,0.0,1,137,131,406,35836,42909,634583,0.0033163941071360846,168583,1842,0.051400194328452505,19386,58046,38889,10572,107507,64137,0.01838378618992083,23523,0,19157,0,0.415986767925396,0,84323,0,52866,12262,0,149451,31457,0.05583383876262924,383665,215082,
268,0.0,1,137,131,406,35836,42909,634583,0.0033163941071360846,168583,1842,0.051400194328452505,19386,58046,38889,10572,107507,64137,0.01838378618992083,23523,0,19157,0,0.415986767925396,0,84323,0,52866,12262,0,149451,31457,0.05583383876262924,383665,215082,
268,0.0,1,137,131,406,35836,42909,634583,0.0033163941071360846,168583,1842,0.051400194328452505,19386,58046,38889,10572,107507,64137,0.01838378618992083,23523,0,19157,0,0.415986767925396,0,84323,0,52866,12262,0,149451,31457,0.05583383876262924,383665,215082,
268,0.0,1,137,131,406,35836,42909,634583,0.0033163941071360846,168583,1842,0.051400194328452505,19386,58046,38889,10572,107507,64137,0.01838378618992083,23523,0,19157,0,0.415986767925396,0,84323,0,52866,12262,0,149451,31457,0.05583383876262924,383665,215082,
268,0.0,1,137,131,406,35836,42909,634583,0.0033163941071360846,168583,1842,0.051400194328452505,19386,58046,38889,10572,107507,64137,0.01838378618992083,23523,0,19157,0,0.415986767925396,0,84323,0,52866,12262,0,149451,31457,0.05583383876262924,383665,215082,
268,0.0,1,137,131,406,35836,42909,634583,0.0033163941071360846,168583,1842,0.051400194328452505,19386,58046,38889,10572,107507,64137,0.01838378618992083,23523,0,19157,0,0.415986767925396,0,84323,0,52866,12262,0,149451,31457,0.05583383876262924,383665,215082,
268,0.0,1,137,131,406,35836,42909,634583,0.0033163941071360846,168583,1842,0.051400194328452505,19386,58046,38889,10572,107507,64137,0.01838378618992083,23523,0,19157,0,0.415986767925396,0,84323,0,52866,12262,0,149451,31457,0.05583383876262924,383665,215082,
268,0.0,1,137,131,406,35836,42909,634583,0.0033163941071360846,168583,1842,0.051400194328452505,19386,58046,38889,10572,107507,64137,0.01838378618992083,23523,0,19157,0,0.415986767925396,0,84323,0,52866,12262,0,149451,31457,0.05583383876262924,383665,215082,
268,0.0,1,137,131,406,35836,42909,634583,0.0033163941071360846,168583,1842,0.051400194328452505,19386,58046,38889,10572,107507,64137,0.01838378618992083,23523,0,19157,0,0.415986767925396,0,84323,0,52866,12262,0,149451,31457,0.05583383876262924,383665,215082,
268,0.0,1,137,131,406,35836,42909,634583,0.0033163941071360846,168583,1842,0.051400194328452505,19386,58046,38889,10572,107507,64137,0.01838378618992083,23523,0,19157,0,0.415986767925396,0,84323,0,52866,12262,0,149451,31457,0.05583383876262924,383665,215082,
268,0.0,1,137,131,406,35836,42909,634583,0.0033163941071360846,168583,1842,0.051400194328452505,19386,58046,38889,10572,107507,64137,0.01838378618992083,23523,0,19157,0,0.415986767925396,0,84323,0,52866,12262,0,149451,31457,0.05583383876262924,383665,215082,
268,0.0,1,137,131,406,35836,42909,634583,0.0033163941071360846,168583,1842,0.051400194328452505,19386,58046,38889,10572,107507,64137,0.01838378618992083,23523,0,19157,0,0.415986767925396,0,84323,0,52866,12262,0,149451,31457,0.05583383876262924,383665,215082,
268,0.0,1,137,131,406,35836,42909,634583,0.0033163941071360846,168583,1842,0.051400194328452505,19386,58046,38889,10572,107507,64137,0.01838378618992083,23523,0,19157,0,0.415986767925396,0,84323,0,52866,12262,0,149451,31457,0.05583383876262924,383665,215082,
268,0.0,1,137,131,406,35836,42909,634583,0.0033163941071360846,168583,1842,0.051400194328452505,19386,58046,38889,10572,107507,64137,0.01838378618992083,23523,0,19157,0,0.415986767925396,0,84323,0,52866,12262,0,149451,31457,0.05583383876262924,383665,215082,
268,0.0,1,137,131,406,35836,42909,634583,0.0033163941071360846,168583,1842,0.051400194328452505,19386,58046,38889,10572,107507,64137,0.01838378618992083,23523,0,19157,0,0.415986767925396,0,84323,0,52866,12262,0,149451,31457,0.05583383876262924,383665,215082,
268,0.0,1,137,131,406,35836,42909,634583,0.0033163941071360846,168583,1842,0.051400194328452505,19386,58046,38889,10572,107507,64137,0.01838378618992083,23523,0,19157,0,0.415986767925396,0,84323,0,52866,12262,0,149451,31457,0.05583383876262924,383665,215082,
268,0.0,1,137,131,406,35836,42909,634583,0.0033163941071360846,168583,1842,0.051400194328452505,19386,58046,38889,10572,107507,64137,0.01838378618992083,23523,0,19157,0,0.415986767925396,0,84323,0,52866,12262,0,149451,31457,0.05583383876262924,383665,215082,
268,0.0,1,137,131,406,35836,42909,634583,0.0033163941071360846,168583,1842,0.051400194328452505,19386,58046,38889,10572,107507,64137,0.01838378618992083,23523,0,19157,0,0.415986767925396,0,84323,0,52866,12262,0,149451,31457,0.05583383876262924,383665,215082,
268,0.0,1,137,131,406,35836,42909,634583,0.0033163941071360846,168583,1842,0.051400194328452505,19386,58046,38889,10572,107507,64137,0.01838378618992083,23523,0,19157,0,0.415986767925396,0,84323,0,52866,12262,0,149451,31457,0.05583383876262924,383665,215082,
268,0.0,1,137,131,406,35836,42909,634583,0.0033163941071360846,168583,1842,0.051400194328452505,19386,58046,38889,10572,107507,64137,0.01838378618992083,23523,0,19157,0,0.415986767925396,0,84323,0,52866,12262,0,149451,31457,0.05583383876262924,383665,215082,
268,0.0,1,137,131,406,35836,42909,634583,0.0033163941071360846,168583,1842,0.051400194328452505,19386,58046,38889,10572,107507,64137,0.01838378618992083,23523,0,19157,0,0.415986767925396,0,84323,0,52866,12262,0,149451,31457,0.05583383876262924,383665,215082,
268,0.0,1,137,131,406,35836,42909,634583,0.0033163941071360846,168583,1842,0.051400194328452505,19386,58046,38889,10572,107507,64137,0.01838378618992083,23523,0,19157,0,0.415986767925396,0,84323,0,52866,12262,0,149451,31457,0.05583383876262924,383665,215082,
268,0.0,1,137,131,406,35836,42909,634583,0.0033163941071360846,168583,1842,0.051400194328452505,19386,58046,38889,10572,107507,64137,0.01838378618992083,23523,0,19157,0,0.415986767925396,0,84323,0,52866,12262,0,149451,31457,0.05583383876262924,383665,215082,
268,0.0,1,137,131,406,35836,42909,634583,0.0033163941071360846,168583,1842,0.051400194328452505,19386,58046,38889,10572,107507,64137,0.01838378618992083,23523,0,19157,0,0.415986767925396,0,84323,0,52866,12262,0,149451,31457,0.05583383876262924,383665,215082,
268,0.0,1,137,131,406,35836,42909,634583,0.0033163941071360846,168583,1842,0.051400194328452505,19386,58046,38889,10572,107507,64137,0.01838378618992083,23523,0,19157,0,0.415986767925396,0,84323,0,52866,12262,0,149451,31457,0.05583383876262924,383665,215082,
268,0.0,1,137,131,406,35836,42909,634583,0.0033163941071360846,168583,1842,0.051400194328452505,19386,58046,38889,10572,107507,64137,0.01838378618992083,23523,0,19157,0,0.415986767925396,0,84323,0,52866,12262,0,149451,31457,0.05583383876262924,383665,215082,
268,0.0,1,137,131,406,35836,42909,634583,0.0033163941071360846,168583,1842,0.051400194328452505,19386,58046,38889,10572,107507,64137,0.01838378618992083,23523,0,19157,0,0.415986767925396,0,84323,0,52866,12262,0,149451,31457,0.05583383876262924,383665,215082,
268,0.0,1,137,131,406,35836,42909,634583,0.0033163941071360846,168583,1842,0.051400194328452505,19386,58046,38889,10572,107507,64137,0.01838378618992083,23523,0,19157,0,0.415986767925396,0,84323,0,52866,12262,0,149451,31457,0.05583383876262924,383665,215082,
268,0.0,1,137,131,406,35836,42909,634583,0.0033163941071360846,168583,1842,0.051400194328452505,19386,58046,38889,10572,107507,64137,0.01838378618992083,23523,0,19157,0,0.415986767925396,0,84323,0,52866,12262,0,149451,31457,0.05583383876262924,383665,215082,
268,0.0,1,137,131,406,35836,42909,634583,0.0033163941071360846,168583,1842,0.051400194328452505,19386,58046,38889,10572,107507,64137,0.01838378618992083,23523,0,19157,0,0.415986767925396,0,84323,0,52866,12262,0,149451,31457,0.05583383876262924,383665,215082,
268,0.0,1,137,131,406,35836,42909,634583,0.0033163941071360846,168583,1842,0.051400194328452505,19386,58046,38889,10572,107507,64137,0.01838378618992083,23523,0,19157,0,0.415986767925396,0,84323,0,52866,12262,0,149451,31457,0.05583383876262924,383665,215082,
268,0.0,1,137,131,406,35836,42909,634583,0.0033163941071360846,168583,1842,0.051400194328452505,19386,58046,38889,10572,107507,64137,0.01838378618992083,23523,0,19157,0,0.415986767925396,0,84323,0,52866,12262,0,149451,31457,0.05583383876262924,383665,215082,
268,0.0,1,137,131,406,35836,42909,634583,0.0033163941071360846,168583,1842,0.051400194328452505,19386,58046,38889,10572,107507,64137,0.01838378618992083,23523,0,19157,0,0.415986767925396,0,84323,0,52866,12262,0,149451,31457,0.05583383876262924,383665,215082,
268,0.0,1,137,131,406,35836,42909,634583,0.0033163941071360846,168583,1842,0.051400194328452505,19386,58046,38889,10572,107507,64137,0.01838378618992083,23523,0,19157,0,0.415986767925396,0,84323,0,52866,12262,0,149451,31457,0.05583383876262924,383665,215082,
268,0.0,1,137,131,406,35836,42909,634583,0.0033163941071360846,168583,1842,0.051400194328452505,19386,58046,38889,10572,107507,64137,0.01838378618992083,23523,0,19157,0,0.415986767925396,0,84323,0,52866,12262,0,149451,31457,0.05583383876262924,383665,215082,
268,0.0,1,137,131,406,35836,42909,634583,0.0033163941071360846,168583,1842,0.051400194328452505,19386,58046,38889,10572,107507,64137,0.01838378618992083,23523,0,19157,0,0.415986767925396,0,84323,0,52866,12262,0,149451,31457,0.05583383876262924,383665,215082,
268,0.0,1,137,131,406,35836,42909,634583,0.0033163941071360846,168583,1842,0.051400194328452505,19386,58046,38889,10572,107507,64137,0.01838378618992083,23523,0,19157,0,0.415986767925396,0,84323,0,52866,12262,0,149451,31457,0.05583383876262924,383665,215082,
268,0.0,1,137,131,406,35836,42909,634583,0.0033163941071360846,168583,1842,0.051400194328452505,19386,58046,38889,10572,107507,64137,0.01838378618992083,23523,0,19157,0,0.415986767925396,0,84323,0,52866,12262,0,149451,31457,0.05583383876262924,383665,215082,
268,0.0,1,137,131,406,35836,42909,634583,0.0033163941071360846,168583,1842,0.051400194328452505,19386,58046,38889,10572,107507,64137,0.01838378618992083,23523,0,19157,0,0.415986767925396,0,84323,0,52866,12262,0,149451,31457,0.05583383876262924,383665,215082,
268,0.0,1,137,131,406,35836,42909,634583,0.0033163941071360846,168583,1842,0.051400194328452505,19386,58046,38889,10572,107507,64137,0.01838378618992083,23523,0,19157,0,0.415986767925396,0,84323,0,52866,12262,0,149451,31457,0.05583383876262924,383665,215082,
268,0.0,1,137,131,406,35836,42909,634583,0.0033163941071360846,168583,1842,0.051400194328452505,19386,58046,38889,10572,107507,64137,0.01838378618992083,23523,0,19157,0,0.415986767925396,0,84323,0,52866,12262,0,149451,31457,0.05583383876262924,383665,215082,
268,0.0,1,137,131,406,35836,42909,634583,0.0033163941071360846,168583,1842,0.051400194328452505,19386,58046,38889,10572,107507,64137,0.01838378618992083,23523,0,19157,0,0.415986767925396,0,84323,0,52866,12262,0,149451,31457,0.05583383876262924,383665,215082,
268,0.0,1,137,131,406,35836,42909,634583,0.0033163941071360846,168583,1842,0.051400194328452505,19386,58046,38889,10572,107507,64137,0.01838378618992083,23523,0,19157,0,0.415986767925396,0,84323,0,52866,12262,0,149451,31457,0.05583383876262924,383665,215082,
268,0.0,1,137,131,406,35836,42909,634583,0.0033163941071360846,168583,1842,0.051400194328452505,19386,58046,38889,10572,107507,64137,0.01838378618992083,23523,0,19157,0,0.415986767925396,0,84323,0,52866,12262,0,149451,31457,0.05583383876262924,383665,215082,
268,0.0,1,137,131,406,35836,42909,634583,0.0033163941071360846,168583,1842,0.051400194328452505,19386,58046,38889,10572,107507,64137,0.01838378618992083,23523,0,19157,0,0.415986767925396,0,84323,0,52866,12262,0,149451,31457,0.05583383876262924,383665,215082,
268,0.0,1,137,131,406,35836,42909,634583,0.0033163941071360846,168583,1842,0.051400194328452505,19386,58046,38889,10572,107507,64137,0.01838378618992083,23523,0,19157,0,0.415986767925396,0,84323,0,52866,12262,0,149451,31457,0.05583383876262924,383665,215082,
268,0.0,1,137,131,406,35836,42909,634583,0.0033163941071360846,168583,1842,0.051400194328452505,19386,58046,38889,10572,107507,64137,0.01838378618992083,23523,0,19157,0,0.415986767925396,0,84323,0,52866,12262,0,149451,31457,0.05583383876262924,383665,215082,
268,0.0,1,137,131,406,35836,42909,634583,0.0033163941071360846,168583,1842,0.051400194328452505,19386,58046,38889,10572,107507,64137,0.01838378618992083,23523,0,19157,0,0.415986767925396,0,84323,0,52866,12262,0,149451,31457,0.05583383876262924,383665,215082,
268,0.0,1,137,131,406,35836,42909,634583,0.0033163941071360846,168583,1842,0.051400194328452505,19386,58046,38889,10572,107507,64137,0.01838378618992083,23523,0,19157,0,0.415986767925396,0,84323,0,52866,12262,0,149451,31457,0.05583383876262924,383665,215082,
268,0.0,1,137,131,406,35836,42909,634583,0.0033163941071360846,168583,1842,0.051400194328452505,19386,58046,38889,10572,107507,64137,0.01838378618992083,23523,0,19157,0,0.415986767925396,0,84323,0,52866,12262,0,149451,31457,0.05583383876262924,383665,215082,
268,0.0,1,137,131,406,35836,42909,634583,0.0033163941071360846,168583,1842,0.051400194328452505,19386,58046,38889,10572,107507,64137,0.01838378618992083,23523,0,19157,0,0.415986767925396,0,84323,0,52866,12262,0,149451,31457,0.05583383876262924,383665,215082,
268,0.0,1,137,131,406,35836,42909,634583,0.0033163941071360846,168583,1842,0.051400194328452505,19386,58046,38889,10572,107507,64137,0.01838378618992083,23523,0,19157,0,0.415986767925396,0,84323,0,52866,12262,0,149451,31457,0.05583383876262924,383665,215082,
268,0.0,1,137,131,406,35836,42909,634583,0.0033163941071360846,168583,1842,0.051400194328452505,19386,58046,38889,10572,107507,64137,0.01838378618992083,23523,0,19157,0,0.415986767925396,0,84323,0,52866,12262,0,149451,31457,0.05583383876262924,383665,215082,
268,0.0,1,137,131,406,35836,42909,634583,0.0033163941071360846,168583,1842,0.051400194328452505,19386,58046,38889,10572,107507,64137,0.01838378618992083,23523,0,19157,0,0.415986767925396,0,84323,0,52866,12262,0,149451,31457,0.05583383876262924,383665,215082,
268,0.0,1,137,131,406,35836,42909,634583,0.0033163941071360846,168583,1842,0.051400194328452505,19386,58046,38889,10572,107507,64137,0.01838378618992083,23523,0,19157,0,0.415986767925396,0,84323,0,52866,12262,0,149451,31457,0.05583383876262924,383665,215082,
268,0.0,1,137,131,406,35836,42909,634583,0.0033163941071360846,168583,1842,0.051400194328452505,19386,58046,38889,10572,107507,64137,0.01838378618992083,23523,0,19157,0,0.415986767925396,0,84323,0,52866,12262,0,149451,31457,0.05583383876262924,383665,215082,
268,0.0,1,137,131,406,35836,42909,634583,0.0033163941071360846,168583,1842,0.051400194328452505,19386,58046,38889,10572,107507,64137,0.01838378618992083,23523,0,19157,0,0.415986767925396,0,84323,0,52866,12262,0,149451,31457,0.05583383876262924,383665,215082,
268,0.0,1,137,131,406,35836,42909,634583,0.0033163941071360846,168583,1842,0.051400194328452505,19386,58046,38889,10572,107507,64137,0.01838378618992083,23523,0,19157,0,0.415986767925396,0,84323,0,52866,12262,0,149451,31457,0.05583383876262924,383665,215082,
268,0.0,1,137,131,406,35836,42909,634583,0.0033163941071360846,168583,1842,0.051400194328452505,19386,58046,38889,10572,107507,64137,0.01838378618992083,23523,0,19157,0,0.415986767925396,0,84323,0,52866,12262,0,149451,31457,0.05583383876262924,383665,215082,
268,0.0,1,137,131,406,35836,42909,634583,0.0033163941071360846,168583,1842,0.051400194328452505,19386,58046,38889,10572,107507,64137,0.01838378618992083,23523,0,19157,0,0.415986767925396,0,84323,0,52866,12262,0,149451,31457,0.05583383876262924,383665,215082,
268,0.0,1,137,131,406,35836,42909,634583,0.0033163941071360846,168583,1842,0.051400194328452505,19386,58046,38889,10572,107507,64137,0.01838378618992083,23523,0,19157,0,0.415986767925396,0,84323,0,52866,12262,0,149451,31457,0.05583383876262924,383665,215082,
268,0.0,1,137,131,406,35836,42909,634583,0.0033163941071360846,168583,1842,0.051400194328452505,19386,58046,38889,10572,107507,64137,0.01838378618992083,23523,0,19157,0,0.415986767925396,0,84323,0,52866,12262,0,149451,31457,0.05583383876262924,383665,215082,
268,0.0,1,137,131,406,35836,42909,634583,0.0033163941071360846,168583,1842,0.051400194328452505,19386,58046,38889,10572,107507,64137,0.01838378618992083,23523,0,19157,0,0.415986767925396,0,84323,0,52866,12262,0,149451,31457,0.05583383876262924,383665,215082,
268,0.0,1,137,131,406,35836,42909,634583,0.0033163941071360846,168583,1842,0.051400194328452505,19386,58046,38889,10572,107507,64137,0.01838378618992083,23523,0,19157,0,0.415986767925396,0,84323,0,52866,12262,0,149451,31457,0.05583383876262924,383665,215082,
268,0.0,1,137,131,406,35836,42909,634583,0.0033163941071360846,168583,1842,0.051400194328452505,19386,58046,38889,10572,107507,64137,0.01838378618992083,23523,0,19157,0,0.415986767925396,0,84323,0,52866,12262,0,149451,31457,0.05583383876262924,383665,215082,
268,0.0,1,137,131,406,35836,42909,634583,0.0033163941071360846,168583,1842,0.051400194328452505,19386,58046,38889,10572,107507,64137,0.01838378618992083,23523,0,19157,0,0.415986767925396,0,84323,0,52866,12262,0,149451,31457,0.05583383876262924,383665,215082,
268,0.0,1,137,131,406,35836,42909,634583,0.0033163941071360846,168583,1842,0.051400194328452505,19386,58046,38889,10572,107507,64137,0.01838378618992083,23523,0,19157,0,0.415986767925396,0,84323,0,52866,12262,0,149451,31457,0.05583383876262924,383665,215082,
268,0.0,1,137,131,406,35836,42909,634583,0.0033163941071360846,168583,1842,0.051400194328452505,19386,58046,38889,10572,107507,64137,0.01838378618992083,23523,0,19157,0,0.415986767925396,0,84323,0,52866,12262,0,149451,31457,0.05583383876262924,383665,215082,
268,0.0,1,137,131,406,35836,42909,634583,0.0033163941071360846,168583,1842,0.051400194328452505,19386,58046,38889,10572,107507,64137,0.01838378618992083,23523,0,19157,0,0.415986767925396,0,84323,0,52866,12262,0,149451,31457,0.05583383876262924,383665,215082,
268,0.0,1,137,131,406,35836,42909,634583,0.0033163941071360846,168583,1842,0.051400194328452505,19386,58046,38889,10572,107507,64137,0.01838378618992083,23523,0,19157,0,0.415986767925396,0,84323,0,52866,12262,0,149451,31457,0.05583383876262924,383665,215082,
268,0.0,1,137,131,406,35836,42909,634583,0.0033163941071360846,168583,1842,0.051400194328452505,19386,58046,38889,10572,107507,64137,0.01838378618992083,23523,0,19157,0,0.415986767925396,0,84323,0,52866,12262,0,149451,31457,0.05583383876262924,383665,215082,
268,0.0,1,137,131,406,35836,42909,634583,0.0033163941071360846,168583,1842,0.051400194328452505,19386,58046,38889,10572,107507,64137,0.01838378618992083,23523,0,19157,0,0.415986767925396,0,84323,0,52866,12262,0,149451,31457,0.05583383876262924,383665,215082,
268,0.0,1,137,131,406,35836,42909,634583,0.0033163941071360846,168583,1842,0.051400194328452505,19386,58046,38889,10572,107507,64137,0.01838378618992083,23523,0,19157,0,0.415986767925396,0,84323,0,52866,12262,0,149451,31457,0.05583383876262924,383665,215082,
268,0.0,1,137,131,406,35836,42909,634583,0.0033163941071360846,168583,1842,0.051400194328452505,19386,58046,38889,10572,107507,64137,0.01838378618992083,23523,0,19157,0,0.415986767925396,0,84323,0,52866,12262,0,149451,31457,0.05583383876262924,383665,215082,
268,0.0,1,137,131,406,35836,42909,634583,0.0033163941071360846,168583,1842,0.051400194328452505,19386,58046,38889,10572,107507,64137,0.01838378618992083,23523,0,19157,0,0.415986767925396,0,84323,0,52866,12262,0,149451,31457,0.05583383876262924,383665,215082,
268,0.0,1,137,131,406,35836,42909,634583,0.0033163941071360846,168583,1842,0.051400194328452505,19386,58046,38889,10572,107507,64137,0.01838378618992083,23523,0,19157,0,0.415986767925396,0,84323,0,52866,12262,0,149451,31457,0.05583383876262924,383665,215082,
268,0.0,1,137,131,406,35836,42909,634583,0.0033163941071360846,168583,1842,0.051400194328452505,19386,58046,38889,10572,107507,64137,0.01838378618992083,23523,0,19157,0,0.415986767925396,0,84323,0,52866,12262,0,149451,31457,0.05583383876262924,383665,215082,
268,0.0,1,137,131,406,35836,42909,634583,0.0033163941071360846,168583,1842,0.051400194328452505,19386,58046,38889,10572,107507,64137,0.01838378618992083,23523,0,19157,0,0.415986767925396,0,84323,0,52866,12262,0,149451,31457,0.05583383876262924,383665,215082,
268,0.0,1,137,131,406,35836,42909,634583,0.0033163941071360846,168583,1842,0.051400194328452505,19386,58046,38889,10572,107507,64137,0.01838378618992083,23523,0,19157,0,0.415986767925396,0,84323,0,52866,12262,0,149451,31457,0.05583383876262924,383665,215082,
268,0.0,1,137,131,406,35836,42909,634583,0.0033163941071360846,168583,1842,0.051400194328452505,19386,58046,38889,10572,107507,64137,0.01838378618992083,23523,0,19157,0,0.415986767925396,0,84323,0,52866,12262,0,149451,31457,0.05583383876262924,383665,215082,
268,0.0,1,137,131,406,35836,42909,634583,0.0033163941071360846,168583,1842,0.051400194328452505,19386,58046,38889,10572,107507,64137,0.01838378618992083,23523,0,19157,0,0.415986767925396,0,84323,0,52866,12262,0,149451,31457,0.05583383876262924,383665,215082,
268,0.0,1,137,131,406,35836,42909,634583,0.0033163941071360846,168583,1842,0.051400194328452505,19386,58046,38889,10572,107507,64137,0.01838378618992083,23523,0,19157,0,0.415986767925396,0,84323,0,52866,12262,0,149451,31457,0.05583383876262924,383665,215082,
268,0.0,1,137,131,406,35836,42909,634583,0.0033163941071360846,168583,1842,0.051400194328452505,19386,58046,38889,10572,107507,64137,0.01838378618992083,23523,0,19157,0,0.415986767925396,0,84323,0,52866,12262,0,149451,31457,0.05583383876262924,383665,215082,
268,0.0,1,137,131,406,35836,42909,634583,0.0033163941071360846,168583,1842,0.051400194328452505,19386,58046,38889,10572,107507,64137,0.01838378618992083,23523,0,19157,0,0.415986767925396,0,84323,0,52866,12262,0,149451,31457,0.05583383876262924,383665,215082,
268,0.0,1,137,131,406,35836,42909,634583,0.0033163941071360846,168583,1842,0.051400194328452505,19386,58046,38889,10572,107507,64137,0.01838378618992083,23523,0,19157,0,0.415986767925396,0,84323,0,52866,12262,0,149451,31457,0.05583383876262924,383665,215082,
268,0.0,1,137,131,406,35836,42909,634583,0.0033163941071360846,168583,1842,0.051400194328452505,19386,58046,38889,10572,107507,64137,0.01838378618992083,23523,0,19157,0,0.415986767925396,0,84323,0,52866,12262,0,149451,31457,0.05583383876262924,383665,215082,
268,0.0,1,137,131,406,35836,42909,634583,0.0033163941071360846,168583,1842,0.051400194328452505,19386,58046,38889,10572,107507,64137,0.01838378618992083,23523,0,19157,0,0.415986767925396,0,84323,0,52866,12262,0,149451,31457,0.05583383876262924,383665,215082,
268,0.0,1,137,131,406,35836,42909,634583,0.0033163941071360846,168583,1842,0.051400194328452505,19386,58046,38889,10572,107507,64137,0.01838378618992083,23523,0,19157,0,0.415986767925396,0,84323,0,52866,12262,0,149451,31457,0.05583383876262924,383665,215082,
268,0.0,1,137,131,406,35836,42909,634583,0.0033163941071360846,168583,1842,0.051400194328452505,19386,58046,38889,10572,107507,64137,0.01838378618992083,23523,0,19157,0,0.415986767925396,0,84323,0,52866,12262,0,149451,31457,0.05583383876262924,383665,215082,
268,0.0,1,137,131,406,35836,42909,634583,0.0033163941071360846,168583,1842,0.051400194328452505,19386,58046,38889,10572,107507,64137,0.01838378618992083,23523,0,19157,0,0.415986767925396,0,84323,0,52866,12262,0,149451,31457,0.05583383876262924,383665,215082,
268,0.0,1,137,131,406,35836,42909,634583,0.0033163941071360846,168583,1842,0.051400194328452505,19386,58046,38889,10572,107507,64137,0.01838378618992083,23523,0,19157,0,0.415986767925396,0,84323,0,52866,12262,0,149451,31457,0.05583383876262924,383665,215082,
268,0.0,1,137,131,406,35836,42909,634583,0.0033163941071360846,168583,1842,0.051400194328452505,19386,58046,38889,10572,107507,64137,0.01838378618992083,23523,0,19157,0,0.415986767925396,0,84323,0,52866,12262,0,149451,31457,0.05583383876262924,383665,215082,
268,0.0,1,137,131,406,35836,42909,634583,0.0033163941071360846,168583,1842,0.051400194328452505,19386,58046,38889,10572,107507,64137,0.01838378618992083,23523,0,19157,0,0.415986767925396,0,84323,0,52866,12262,0,149451,31457,0.05583383876262924,383665,215082,
268,0.0,1,137,131,406,35836,42909,634583,0.0033163941071360846,168583,1842,0.051400194328452505,19386,58046,38889,10572,107507,64137,0.01838378618992083,23523,0,19157,0,0.415986767925396,0,84323,0,52866,12262,0,149451,31457,0.05583383876262924,383665,215082,
268,0.0,1,137,131,406,35836,42909,634583,0.0033163941071360846,168583,1842,0.051400194328452505,19386,58046,38889,10572,107507,64137,0.01838378618992083,23523,0,19157,0,0.415986767925396,0,84323,0,52866,12262,0,149451,31457,0.05583383876262924,383665,215082,
268,0.0,1,137,131,406,35836,42909,634583,0.0033163941071360846,168583,1842,0.051400194328452505,19386,58046,38889,10572,107507,64137,0.01838378618992083,23523,0,19157,0,0.415986767925396,0,84323,0,52866,12262,0,149451,31457,0.05583383876262924,383665,215082,
268,0.0,1,137,131,406,35836,42909,634583,0.0033163941071360846,168583,1842,0.051400194328452505,19386,58046,38889,10572,107507,64137,0.01838378618992083,23523,0,19157,0,0.415986767925396,0,84323,0,52866,12262,0,149451,31457,0.05583383876262924,383665,215082,
268,0.0,1,137,131,406,35836,42909,634583,0.0033163941071360846,168583,1842,0.051400194328452505,19386,58046,38889,10572,107507,64137,0.01838378618992083,23523,0,19157,0,0.415986767925396,0,84323,0,52866,12262,0,149451,31457,0.05583383876262924,383665,215082,
268,0.0,1,137,131,406,35836,42909,634583,0.0033163941071360846,168583,1842,0.051400194328452505,19386,58046,38889,10572,107507,64137,0.01838378618992083,23523,0,19157,0,0.415986767925396,0,84323,0,52866,12262,0,149451,31457,0.05583383876262924,383665,215082,
268,0.0,1,137,131,406,35836,42909,634583,0.0033163941071360846,168583,1842,0.051400194328452505,19386,58046,38889,10572,107507,64137,0.01838378618992083,23523,0,19157,0,0.415986767925396,0,84323,0,52866,12262,0,149451,31457,0.05583383876262924,383665,215082,
268,0.0,1,137,131,406,35836,42909,634583,0.0033163941071360846,168583,1842,0.051400194328452505,19386,58046,38889,10572,107507,64137,0.01838378618992083,23523,0,19157,0,0.415986767925396,0,84323,0,52866,12262,0,149451,31457,0.05583383876262924,383665,215082,
268,0.0,1,137,131,406,35836,42909,634583,0.0033163941071360846,168583,1842,0.051400194328452505,19386,58046,38889,10572,107507,64137,0.01838378618992083,23523,0,19157,0,0.415986767925396,0,84323,0,52866,12262,0,149451,31457,0.05583383876262924,383665,215082,
268,0.0,1,137,131,406,35836,42909,634583,0.0033163941071360846,168583,1842,0.051400194328452505,19386,58046,38889,10572,107507,64137,0.01838378618992083,23523,0,19157,0,0.415986767925396,0,84323,0,52866,12262,0,149451,31457,0.05583383876262924,383665,215082,
268,0.0,1,137,131,406,35836,42909,634583,0.0033163941071360846,168583,1842,0.051400194328452505,19386,58046,38889,10572,107507,64137,0.01838378618992083,23523,0,19157,0,0.415986767925396,0,84323,0,52866,12262,0,149451,31457,0.05583383876262924,383665,215082,
268,0.0,1,137,131,406,35836,42909,634583,0.0033163941071360846,168583,1842,0.051400194328452505,19386,58046,38889,10572,107507,64137,0.01838378618992083,23523,0,19157,0,0.415986767925396,0,84323,0,52866,12262,0,149451,31457,0.05583383876262924,383665,215082,
268,0.0,1,137,131,406,35836,42909,634583,0.0033163941071360846,168583,1842,0.051400194328452505,19386,58046,38889,10572,107507,64137,0.01838378618992083,23523,0,19157,0,0.415986767925396,0,84323,0,52866,12262,0,149451,31457,0.05583383876262924,383665,215082,
268,0.0,1,137,131,406,35836,42909,634583,0.0033163941071360846,168583,1842,0.051400194328452505,19386,58046,38889,10572,107507,64137,0.01838378618992083,23523,0,19157,0,0.415986767925396,0,84323,0,52866,12262,0,149451,31457,0.05583383876262924,383665,215082,
268,0.0,1,137,131,406,35836,42909,634583,0.0033163941071360846,168583,1842,0.051400194328452505,19386,58046,38889,10572,107507,64137,0.01838378618992083,23523,0,19157,0,0.415986767925396,0,84323,0,52866,12262,0,149451,31457,0.05583383876262924,383665,215082,
268,0.0,1,137,131,406,35836,42909,634583,0.0033163941071360846,168583,1842,0.051400194328452505,19386,58046,38889,10572,107507,64137,0.01838378618992083,23523,0,19157,0,0.415986767925396,0,84323,0,52866,12262,0,149451,31457,0.05583383876262924,383665,215082,
268,0.0,1,137,131,406,35836,42909,634583,0.0033163941071360846,168583,1842,0.051400194328452505,19386,58046,38889,10572,107507,64137,0.01838378618992083,23523,0,19157,0,0.415986767925396,0,84323,0,52866,12262,0,149451,31457,0.05583383876262924,383665,215082,
268,0.0,1,137,131,406,35836,42909,634583,0.0033163941071360846,168583,1842,0.051400194328452505,19386,58046,38889,10572,107507,64137,0.01838378618992083,23523,0,19157,0,0.415986767925396,0,84323,0,52866,12262,0,149451,31457,0.05583383876262924,383665,215082,
268,0.0,1,137,131,406,35836,42909,634583,0.0033163941071360846,168583,1842,0.051400194328452505,19386,58046,38889,10572,107507,64137,0.01838378618992083,23523,0,19157,0,0.415986767925396,0,84323,0,52866,12262,0,149451,31457,0.05583383876262924,383665,215082,
268,0.0,1,137,131,406,35836,42909,634583,0.0033163941071360846,168583,1842,0.051400194328452505,19386,58046,38889,10572,107507,64137,0.01838378618992083,23523,0,19157,0,0.415986767925396,0,84323,0,52866,12262,0,149451,31457,0.05583383876262924,383665,215082,
268,0.0,1,137,131,406,35836,42909,634583,0.0033163941071360846,168583,1842,0.051400194328452505,19386,58046,38889,10572,107507,64137,0.01838378618992083,23523,0,19157,0,0.415986767925396,0,84323,0,52866,12262,0,149451,31457,0.05583383876262924,383665,215082,
268,0.0,1,137,131,406,35836,42909,634583,0.0033163941071360846,168583,1842,0.051400194328452505,19386,58046,38889,10572,107507,64137,0.01838378618992083,23523,0,19157,0,0.415986767925396,0,84323,0,52866,12262,0,149451,31457,0.05583383876262924,383665,215082,
268,0.0,1,137,131,406,35836,42909,634583,0.0033163941071360846,168583,1842,0.051400194328452505,19386,58046,38889,10572,107507,64137,0.01838378618992083,23523,0,19157,0,0.415986767925396,0,84323,0,52866,12262,0,149451,31457,0.05583383876262924,383665,215082,
268,0.0,1,137,131,406,35836,42909,634583,0.0033163941071360846,168583,1842,0.051400194328452505,19386,58046,38889,10572,107507,64137,0.01838378618992083,23523,0,19157,0,0.415986767925396,0,84323,0,52866,12262,0,149451,31457,0.05583383876262924,383665,215082,
268,0.0,1,137,131,406,35836,42909,634583,0.0033163941071360846,168583,1842,0.051400194328452505,19386,58046,38889,10572,107507,64137,0.01838378618992083,23523,0,19157,0,0.415986767925396,0,84323,0,52866,12262,0,149451,31457,0.05583383876262924,383665,215082,
268,0.0,1,137,131,406,35836,42909,634583,0.0033163941071360846,168583,1842,0.051400194328452505,19386,58046,38889,10572,107507,64137,0.01838378618992083,23523,0,19157,0,0.415986767925396,0,84323,0,52866,12262,0,149451,31457,0.05583383876262924,383665,215082,
268,0.0,1,137,131,406,35836,42909,634583,0.0033163941071360846,168583,1842,0.051400194328452505,19386,58046,38889,10572,107507,64137,0.01838378618992083,23523,0,19157,0,0.415986767925396,0,84323,0,52866,12262,0,149451,31457,0.05583383876262924,383665,215082,
268,0.0,1,137,131,406,35836,42909,634583,0.0033163941071360846,168583,1842,0.051400194328452505,19386,58046,38889,10572,107507,64137,0.01838378618992083,23523,0,19157,0,0.415986767925396,0,84323,0,52866,12262,0,149451,31457,0.05583383876262924,383665,215082,
268,0.0,1,137,131,406,35836,42909,634583,0.0033163941071360846,168583,1842,0.051400194328452505,19386,58046,38889,10572,107507,64137,0.01838378618992083,23523,0,19157,0,0.415986767925396,0,84323,0,52866,12262,0,149451,31457,0.05583383876262924,383665,215082,
268,0.0,1,137,131,406,35836,42909,634583,0.0033163941071360846,168583,1842,0.051400194328452505,19386,58046,38889,10572,107507,64137,0.01838378618992083,23523,0,19157,0,0.415986767925396,0,84323,0,52866,12262,0,149451,31457,0.05583383876262924,383665,215082,
268,0.0,1,137,131,406,35836,42909,634583,0.0033163941071360846,168583,1842,0.051400194328452505,19386,58046,38889,10572,107507,64137,0.01838378618992083,23523,0,19157,0,0.415986767925396,0,84323,0,52866,12262,0,149451,31457,0.05583383876262924,383665,215082,
268,0.0,1,137,131,406,35836,42909,634583,0.0033163941071360846,168583,1842,0.051400194328452505,19386,58046,38889,10572,107507,64137,0.01838378618992083,23523,0,19157,0,0.415986767925396,0,84323,0,52866,12262,0,149451,31457,0.05583383876262924,383665,215082,
268,0.0,1,137,131,406,35836,42909,634583,0.0033163941071360846,168583,1842,0.051400194328452505,19386,58046,38889,10572,107507,64137,0.01838378618992083,23523,0,19157,0,0.415986767925396,0,84323,0,52866,12262,0,149451,31457,0.05583383876262924,383665,215082,
268,0.0,1,137,131,406,35836,42909,634583,0.0033163941071360846,168583,1842,0.051400194328452505,19386,58046,38889,10572,107507,64137,0.01838378618992083,23523,0,19157,0,0.415986767925396,0,84323,0,52866,12262,0,149451,31457,0.05583383876262924,383665,215082,
268,0.0,1,137,131,406,35836,42909,634583,0.0033163941071360846,168583,1842,0.051400194328452505,19386,58046,38889,10572,107507,64137,0.01838378618992083,23523,0,19157,0,0.415986767925396,0,84323,0,52866,12262,0,149451,31457,0.05583383876262924,383665,215082,
268,0.0,1,137,131,406,35836,42909,634583,0.0033163941071360846,168583,1842,0.051400194328452505,19386,58046,38889,10572,107507,64137,0.01838378618992083,23523,0,19157,0,0.415986767925396,0,84323,0,52866,12262,0,149451,31457,0.05583383876262924,383665,215082,
268,0.0,1,137,131,406,35836,42909,634583,0.0033163941071360846,168583,1842,0.051400194328452505,19386,58046,38889,10572,107507,64137,0.01838378618992083,23523,0,19157,0,0.415986767925396,0,84323,0,52866,12262,0,149451,31457,0.05583383876262924,383665,215082,
268,0.0,1,137,131,406,35836,42909,634583,0.0033163941071360846,168583,1842,0.051400194328452505,19386,58046,38889,10572,107507,64137,0.01838378618992083,23523,0,19157,0,0.415986767925396,0,84323,0,52866,12262,0,149451,31457,0.05583383876262924,383665,215082,
268,0.0,1,137,131,406,35836,42909,634583,0.0033163941071360846,168583,1842,0.051400194328452505,19386,58046,38889,10572,107507,64137,0.01838378618992083,23523,0,19157,0,0.415986767925396,0,84323,0,52866,12262,0,149451,31457,0.05583383876262924,383665,215082,
268,0.0,1,137,131,406,35836,42909,634583,0.0033163941071360846,168583,1842,0.051400194328452505,19386,58046,38889,10572,107507,64137,0.01838378618992083,23523,0,19157,0,0.415986767925396,0,84323,0,52866,12262,0,149451,31457,0.05583383876262924,383665,215082,
268,0.0,1,137,131,406,35836,42909,634583,0.0033163941071360846,168583,1842,0.051400194328452505,19386,58046,38889,10572,107507,64137,0.01838378618992083,23523,0,19157,0,0.415986767925396,0,84323,0,52866,12262,0,149451,31457,0.05583383876262924,383665,215082,
268,0.0,1,137,131,406,35836,42909,634583,0.0033163941071360846,168583,1842,0.051400194328452505,19386,58046,38889,10572,107507,64137,0.01838378618992083,23523,0,19157,0,0.415986767925396,0,84323,0,52866,12262,0,149451,31457,0.05583383876262924,383665,215082,
268,0.0,1,137,131,406,35836,42909,634583,0.0033163941071360846,168583,1842,0.051400194328452505,19386,58046,38889,10572,107507,64137,0.01838378618992083,23523,0,19157,0,0.415986767925396,0,84323,0,52866,12262,0,149451,31457,0.05583383876262924,383665,215082,
268,0.0,1,137,131,406,35836,42909,634583,0.0033163941071360846,168583,1842,0.051400194328452505,19386,58046,38889,10572,107507,64137,0.01838378618992083,23523,0,19157,0,0.415986767925396,0,84323,0,52866,12262,0,149451,31457,0.05583383876262924,383665,215082,
268,0.0,1,137,131,406,35836,42909,634583,0.0033163941071360846,168583,1842,0.051400194328452505,19386,58046,38889,10572,107507,64137,0.01838378618992083,23523,0,19157,0,0.415986767925396,0,84323,0,52866,12262,0,149451,31457,0.05583383876262924,383665,215082,
268,0.0,1,137,131,406,35836,42909,634583,0.0033163941071360846,168583,1842,0.051400194328452505,19386,58046,38889,10572,107507,64137,0.01838378618992083,23523,0,19157,0,0.415986767925396,0,84323,0,52866,12262,0,149451,31457,0.05583383876262924,383665,215082,
268,0.0,1,137,131,406,35836,42909,634583,0.0033163941071360846,168583,1842,0.051400194328452505,19386,58046,38889,10572,107507,64137,0.01838378618992083,23523,0,19157,0,0.415986767925396,0,84323,0,52866,12262,0,149451,31457,0.05583383876262924,383665,215082,
268,0.0,1,137,131,406,35836,42909,634583,0.0033163941071360846,168583,1842,0.051400194328452505,19386,58046,38889,10572,107507,64137,0.01838378618992083,23523,0,19157,0,0.415986767925396,0,84323,0,52866,12262,0,149451,31457,0.05583383876262924,383665,215082,
268,0.0,1,137,131,406,35836,42909,634583,0.0033163941071360846,168583,1842,0.051400194328452505,19386,58046,38889,10572,107507,64137,0.01838378618992083,23523,0,19157,0,0.415986767925396,0,84323,0,52866,12262,0,149451,31457,0.05583383876262924,383665,215082,
268,0.0,1,137,131,406,35836,42909,634583,0.0033163941071360846,168583,1842,0.051400194328452505,19386,58046,38889,10572,107507,64137,0.01838378618992083,23523,0,19157,0,0.415986767925396,0,84323,0,52866,12262,0,149451,31457,0.05583383876262924,383665,215082,
268,0.0,1,137,131,406,35836,42909,634583,0.0033163941071360846,168583,1842,0.051400194328452505,19386,58046,38889,10572,107507,64137,0.01838378618992083,23523,0,19157,0,0.415986767925396,0,84323,0,52866,12262,0,149451,31457,0.05583383876262924,383665,215082,
268,0.0,1,137,131,406,35836,42909,634583,0.0033163941071360846,168583,1842,0.051400194328452505,19386,58046,38889,10572,107507,64137,0.01838378618992083,23523,0,19157,0,0.415986767925396,0,84323,0,52866,12262,0,149451,31457,0.05583383876262924,383665,215082,
268,0.0,1,137,131,406,35836,42909,634583,0.0033163941071360846,168583,1842,0.051400194328452505,19386,58046,38889,10572,107507,64137,0.01838378618992083,23523,0,19157,0,0.415986767925396,0,84323,0,52866,12262,0,149451,31457,0.05583383876262924,383665,215082,
268,0.0,1,137,131,406,35836,42909,634583,0.0033163941071360846,168583,1842,0.051400194328452505,19386,58046,38889,10572,107507,64137,0.01838378618992083,23523,0,19157,0,0.415986767925396,0,84323,0,52866,12262,0,149451,31457,0.05583383876262924,383665,215082,
268,0.0,1,137,131,406,35836,42909,634583,0.0033163941071360846,168583,1842,0.051400194328452505,19386,58046,38889,10572,107507,64137,0.01838378618992083,23523,0,19157,0,0.415986767925396,0,84323,0,52866,12262,0,149451,31457,0.05583383876262924,383665,215082,
268,0.0,1,137,131,406,35836,42909,634583,0.0033163941071360846,168583,1842,0.051400194328452505,19386,58046,38889,10572,107507,64137,0.01838378618992083,23523,0,19157,0,0.415986767925396,0,84323,0,52866,12262,0,149451,31457,0.05583383876262924,383665,215082,
268,0.0,1,137,131,406,35836,42909,634583,0.0033163941071360846,168583,1842,0.051400194328452505,19386,58046,38889,10572,107507,64137,0.01838378618992083,23523,0,19157,0,0.415986767925396,0,84323,0,52866,12262,0,149451,31457,0.05583383876262924,383665,215082,
268,0.0,1,137,131,406,35836,42909,634583,0.0033163941071360846,168583,1842,0.051400194328452505,19386,58046,38889,10572,107507,64137,0.01838378618992083,23523,0,19157,0,0.415986767925396,0,84323,0,52866,12262,0,149451,31457,0.05583383876262924,383665,215082,
268,0.0,1,137,131,406,35836,42909,634583,0.0033163941071360846,168583,1842,0.051400194328452505,19386,58046,38889,10572,107507,64137,0.01838378618992083,23523,0,19157,0,0.415986767925396,0,84323,0,52866,12262,0,149451,31457,0.05583383876262924,383665,215082,
268,0.0,1,137,131,406,35836,42909,634583,0.0033163941071360846,168583,1842,0.051400194328452505,19386,58046,38889,10572,107507,64137,0.01838378618992083,23523,0,19157,0,0.415986767925396,0,84323,0,52866,12262,0,149451,31457,0.05583383876262924,383665,215082,
268,0.0,1,137,131,406,35836,42909,634583,0.0033163941071360846,168583,1842,0.051400194328452505,19386,58046,38889,10572,107507,64137,0.01838378618992083,23523,0,19157,0,0.415986767925396,0,84323,0,52866,12262,0,149451,31457,0.05583383876262924,383665,215082,
268,0.0,1,137,131,406,35836,42909,634583,0.0033163941071360846,168583,1842,0.051400194328452505,19386,58046,38889,10572,107507,64137,0.01838378618992083,23523,0,19157,0,0.415986767925396,0,84323,0,52866,12262,0,149451,31457,0.05583383876262924,383665,215082,
268,0.0,1,137,131,406,35836,42909,634583,0.0033163941071360846,168583,1842,0.051400194328452505,19386,58046,38889,10572,107507,64137,0.01838378618992083,23523,0,19157,0,0.415986767925396,0,84323,0,52866,12262,0,149451,31457,0.05583383876262924,383665,215082,
268,0.0,1,137,131,406,35836,42909,634583,0.0033163941071360846,168583,1842,0.051400194328452505,19386,58046,38889,10572,107507,64137,0.01838378618992083,23523,0,19157,0,0.415986767925396,0,84323,0,52866,12262,0,149451,31457,0.05583383876262924,383665,215082,
268,0.0,1,137,131,406,35836,42909,634583,0.0033163941071360846,168583,1842,0.051400194328452505,19386,58046,38889,10572,107507,64137,0.01838378618992083,23523,0,19157,0,0.415986767925396,0,84323,0,52866,12262,0,149451,31457,0.05583383876262924,383665,215082,
268,0.0,1,137,131,406,35836,42909,634583,0.0033163941071360846,168583,1842,0.051400194328452505,19386,58046,38889,10572,107507,64137,0.01838378618992083,23523,0,19157,0,0.415986767925396,0,84323,0,52866,12262,0,149451,31457,0.05583383876262924,383665,215082,
268,0.0,1,137,131,406,35836,42909,634583,0.0033163941071360846,168583,1842,0.051400194328452505,19386,58046,38889,10572,107507,64137,0.01838378618992083,23523,0,19157,0,0.415986767925396,0,84323,0,52866,12262,0,149451,31457,0.05583383876262924,383665,215082,
268,0.0,1,137,131,406,35836,42909,634583,0.0033163941071360846,168583,1842,0.051400194328452505,19386,58046,38889,10572,107507,64137,0.01838378618992083,23523,0,19157,0,0.415986767925396,0,84323,0,52866,12262,0,149451,31457,0.05583383876262924,383665,215082,
268,0.0,1,137,131,406,35836,42909,634583,0.0033163941071360846,168583,1842,0.051400194328452505,19386,58046,38889,10572,107507,64137,0.01838378618992083,23523,0,19157,0,0.415986767925396,0,84323,0,52866,12262,0,149451,31457,0.05583383876262924,383665,215082,
268,0.0,1,137,131,406,35836,42909,634583,0.0033163941071360846,168583,1842,0.051400194328452505,19386,58046,38889,10572,107507,64137,0.01838378618992083,23523,0,19157,0,0.415986767925396,0,84323,0,52866,12262,0,149451,31457,0.05583383876262924,383665,215082,
268,0.0,1,137,131,406,35836,42909,634583,0.0033163941071360846,168583,1842,0.051400194328452505,19386,58046,38889,10572,107507,64137,0.01838378618992083,23523,0,19157,0,0.415986767925396,0,84323,0,52866,12262,0,149451,31457,0.05583383876262924,383665,215082,
268,0.0,1,137,131,406,35836,42909,634583,0.0033163941071360846,168583,1842,0.051400194328452505,19386,58046,38889,10572,107507,64137,0.01838378618992083,23523,0,19157,0,0.415986767925396,0,84323,0,52866,12262,0,149451,31457,0.05583383876262924,383665,215082,
268,0.0,1,137,131,406,35836,42909,634583,0.0033163941071360846,168583,1842,0.051400194328452505,19386,58046,38889,10572,107507,64137,0.01838378618992083,23523,0,19157,0,0.415986767925396,0,84323,0,52866,12262,0,149451,31457,0.05583383876262924,383665,215082,
268,0.0,1,137,131,406,35836,42909,634583,0.0033163941071360846,168583,1842,0.051400194328452505,19386,58046,38889,10572,107507,64137,0.01838378618992083,23523,0,19157,0,0.415986767925396,0,84323,0,52866,12262,0,149451,31457,0.05583383876262924,383665,215082,
268,0.0,1,137,131,406,35836,42909,634583,0.0033163941071360846,168583,1842,0.051400194328452505,19386,58046,38889,10572,107507,64137,0.01838378618992083,23523,0,19157,0,0.415986767925396,0,84323,0,52866,12262,0,149451,31457,0.05583383876262924,383665,215082,
268,0.0,1,137,131,406,35836,42909,634583,0.0033163941071360846,168583,1842,0.051400194328452505,19386,58046,38889,10572,107507,64137,0.01838378618992083,23523,0,19157,0,0.415986767925396,0,84323,0,52866,12262,0,149451,31457,0.05583383876262924,383665,215082,
268,0.0,1,137,131,406,35836,42909,634583,0.0033163941071360846,168583,1842,0.051400194328452505,19386,58046,38889,10572,107507,64137,0.01838378618992083,23523,0,19157,0,0.415986767925396,0,84323,0,52866,12262,0,149451,31457,0.05583383876262924,383665,215082,
268,0.0,1,137,131,406,35836,42909,634583,0.0033163941071360846,168583,1842,0.051400194328452505,19386,58046,38889,10572,107507,64137,0.01838378618992083,23523,0,19157,0,0.415986767925396,0,84323,0,52866,12262,0,149451,31457,0.05583383876262924,383665,215082,
268,0.0,1,137,131,406,35836,42909,634583,0.0033163941071360846,168583,1842,0.051400194328452505,19386,58046,38889,10572,107507,64137,0.01838378618992083,23523,0,19157,0,0.415986767925396,0,84323,0,52866,12262,0,149451,31457,0.05583383876262924,383665,215082,
268,0.0,1,137,131,406,35836,42909,634583,0.0033163941071360846,168583,1842,0.051400194328452505,19386,58046,38889,10572,107507,64137,0.01838378618992083,23523,0,19157,0,0.415986767925396,0,84323,0,52866,12262,0,149451,31457,0.05583383876262924,383665,215082,
268,0.0,1,137,131,406,35836,42909,634583,0.0033163941071360846,168583,1842,0.051400194328452505,19386,58046,38889,10572,107507,64137,0.01838378618992083,23523,0,19157,0,0.415986767925396,0,84323,0,52866,12262,0,149451,31457,0.05583383876262924,383665,215082,
268,0.0,1,137,131,406,35836,42909,634583,0.0033163941071360846,168583,1842,0.051400194328452505,19386,58046,38889,10572,107507,64137,0.01838378618992083,23523,0,19157,0,0.415986767925396,0,84323,0,52866,12262,0,149451,31457,0.05583383876262924,383665,215082,
268,0.0,1,137,131,406,35836,42909,634583,0.0033163941071360846,168583,1842,0.051400194328452505,19386,58046,38889,10572,107507,64137,0.01838378618992083,23523,0,19157,0,0.415986767925396,0,84323,0,52866,12262,0,149451,31457,0.05583383876262924,383665,215082,
268,0.0,1,137,131,406,35836,42909,634583,0.0033163941071360846,168583,1842,0.051400194328452505,19386,58046,38889,10572,107507,64137,0.01838378618992083,23523,0,19157,0,0.415986767925396,0,84323,0,52866,12262,0,149451,31457,0.05583383876262924,383665,215082,
268,0.0,1,137,131,406,35836,42909,634583,0.0033163941071360846,168583,1842,0.051400194328452505,19386,58046,38889,10572,107507,64137,0.01838378618992083,23523,0,19157,0,0.415986767925396,0,84323,0,52866,12262,0,149451,31457,0.05583383876262924,383665,215082,
268,0.0,1,137,131,406,35836,42909,634583,0.0033163941071360846,168583,1842,0.051400194328452505,19386,58046,38889,10572,107507,64137,0.01838378618992083,23523,0,19157,0,0.415986767925396,0,84323,0,52866,12262,0,149451,31457,0.05583383876262924,383665,215082,
268,0.0,1,137,131,406,35836,42909,634583,0.0033163941071360846,168583,1842,0.051400194328452505,19386,58046,38889,10572,107507,64137,0.01838378618992083,23523,0,19157,0,0.415986767925396,0,84323,0,52866,12262,0,149451,31457,0.05583383876262924,383665,215082,
268,0.0,1,137,131,406,35836,42909,634583,0.0033163941071360846,168583,1842,0.051400194328452505,19386,58046,38889,10572,107507,64137,0.01838378618992083,23523,0,19157,0,0.415986767925396,0,84323,0,52866,12262,0,149451,31457,0.05583383876262924,383665,215082,
268,0.0,1,137,131,406,35836,42909,634583,0.0033163941071360846,168583,1842,0.051400194328452505,19386,58046,38889,10572,107507,64137,0.01838378618992083,23523,0,19157,0,0.415986767925396,0,84323,0,52866,12262,0,149451,31457,0.05583383876262924,383665,215082,
268,0.0,1,137,131,406,35836,42909,634583,0.0033163941071360846,168583,1842,0.051400194328452505,19386,58046,38889,10572,107507,64137,0.01838378618992083,23523,0,19157,0,0.415986767925396,0,84323,0,52866,12262,0,149451,31457,0.05583383876262924,383665,215082,
268,0.0,1,137,131,406,35836,42909,634583,0.0033163941071360846,168583,1842,0.051400194328452505,19386,58046,38889,10572,107507,64137,0.01838378618992083,23523,0,19157,0,0.415986767925396,0,84323,0,52866,12262,0,149451,31457,0.05583383876262924,383665,215082,
268,0.0,1,137,131,406,35836,42909,634583,0.0033163941071360846,168583,1842,0.051400194328452505,19386,58046,38889,10572,107507,64137,0.01838378618992083,23523,0,19157,0,0.415986767925396,0,84323,0,52866,12262,0,149451,31457,0.05583383876262924,383665,215082,
268,0.0,1,137,131,406,35836,42909,634583,0.0033163941071360846,168583,1842,0.051400194328452505,19386,58046,38889,10572,107507,64137,0.01838378618992083,23523,0,19157,0,0.415986767925396,0,84323,0,52866,12262,0,149451,31457,0.05583383876262924,383665,215082,
268,0.0,1,137,131,406,35836,42909,634583,0.0033163941071360846,168583,1842,0.051400194328452505,19386,58046,38889,10572,107507,64137,0.01838378618992083,23523,0,19157,0,0.415986767925396,0,84323,0,52866,12262,0,149451,31457,0.05583383876262924,383665,215082,
268,0.0,1,137,131,406,35836,42909,634583,0.0033163941071360846,168583,1842,0.051400194328452505,19386,58046,38889,10572,107507,64137,0.01838378618992083,23523,0,19157,0,0.415986767925396,0,84323,0,52866,12262,0,149451,31457,0.05583383876262924,383665,215082,
268,0.0,1,137,131,406,35836,42909,634583,0.0033163941071360846,168583,1842,0.051400194328452505,19386,58046,38889,10572,107507,64137,0.01838378618992083,23523,0,19157,0,0.415986767925396,0,84323,0,52866,12262,0,149451,31457,0.05583383876262924,383665,215082,
268,0.0,1,137,131,406,35836,42909,634583,0.0033163941071360846,168583,1842,0.051400194328452505,19386,58046,38889,10572,107507,64137,0.01838378618992083,23523,0,19157,0,0.415986767925396,0,84323,0,52866,12262,0,149451,31457,0.05583383876262924,383665,215082,
268,0.0,1,137,131,406,35836,42909,634583,0.0033163941071360846,168583,1842,0.051400194328452505,19386,58046,38889,10572,107507,64137,0.01838378618992083,23523,0,19157,0,0.415986767925396,0,84323,0,52866,12262,0,149451,31457,0.05583383876262924,383665,215082,
268,0.0,1,137,131,406,35836,42909,634583,0.0033163941071360846,168583,1842,0.051400194328452505,19386,58046,38889,10572,107507,64137,0.01838378618992083,23523,0,19157,0,0.415986767925396,0,84323,0,52866,12262,0,149451,31457,0.05583383876262924,383665,215082,
268,0.0,1,137,131,406,35836,42909,634583,0.0033163941071360846,168583,1842,0.051400194328452505,19386,58046,38889,10572,107507,64137,0.01838378618992083,23523,0,19157,0,0.415986767925396,0,84323,0,52866,12262,0,149451,31457,0.05583383876262924,383665,215082,
268,0.0,1,137,131,406,35836,42909,634583,0.0033163941071360846,168583,1842,0.051400194328452505,19386,58046,38889,10572,107507,64137,0.01838378618992083,23523,0,19157,0,0.415986767925396,0,84323,0,52866,12262,0,149451,31457,0.05583383876262924,383665,215082,
268,0.0,1,137,131,406,35836,42909,634583,0.0033163941071360846,168583,1842,0.051400194328452505,19386,58046,38889,10572,107507,64137,0.01838378618992083,23523,0,19157,0,0.415986767925396,0,84323,0,52866,12262,0,149451,31457,0.05583383876262924,383665,215082,
268,0.0,1,137,131,406,35836,42909,634583,0.0033163941071360846,168583,1842,0.051400194328452505,19386,58046,38889,10572,107507,64137,0.01838378618992083,23523,0,19157,0,0.415986767925396,0,84323,0,52866,12262,0,149451,31457,0.05583383876262924,383665,215082,
268,0.0,1,137,131,406,35836,42909,634583,0.0033163941071360846,168583,1842,0.051400194328452505,19386,58046,38889,10572,107507,64137,0.01838378618992083,23523,0,19157,0,0.415986767925396,0,84323,0,52866,12262,0,149451,31457,0.05583383876262924,383665,215082,
268,0.0,1,137,131,406,35836,42909,634583,0.0033163941071360846,168583,1842,0.051400194328452505,19386,58046,38889,10572,107507,64137,0.01838378618992083,23523,0,19157,0,0.415986767925396,0,84323,0,52866,12262,0,149451,31457,0.05583383876262924,383665,215082,
268,0.0,1,137,131,406,35836,42909,634583,0.0033163941071360846,168583,1842,0.051400194328452505,19386,58046,38889,10572,107507,64137,0.01838378618992083,23523,0,19157,0,0.415986767925396,0,84323,0,52866,12262,0,149451,31457,0.05583383876262924,383665,215082,
268,0.0,1,137,131,406,35836,42909,634583,0.0033163941071360846,168583,1842,0.051400194328452505,19386,58046,38889,10572,107507,64137,0.01838378618992083,23523,0,19157,0,0.415986767925396,0,84323,0,52866,12262,0,149451,31457,0.05583383876262924,383665,215082,
268,0.0,1,137,131,406,35836,42909,634583,0.0033163941071360846,168583,1842,0.051400194328452505,19386,58046,38889,10572,107507,64137,0.01838378618992083,23523,0,19157,0,0.415986767925396,0,84323,0,52866,12262,0,149451,31457,0.05583383876262924,383665,215082,
268,0.0,1,137,131,406,35836,42909,634583,0.0033163941071360846,168583,1842,0.051400194328452505,19386,58046,38889,10572,107507,64137,0.01838378618992083,23523,0,19157,0,0.415986767925396,0,84323,0,52866,12262,0,149451,31457,0.05583383876262924,383665,215082,
268,0.0,1,137,131,406,35836,42909,634583,0.0033163941071360846,168583,1842,0.051400194328452505,19386,58046,38889,10572,107507,64137,0.01838378618992083,23523,0,19157,0,0.415986767925396,0,84323,0,52866,12262,0,149451,31457,0.05583383876262924,383665,215082,
268,0.0,1,137,131,406,35836,42909,634583,0.0033163941071360846,168583,1842,0.051400194328452505,19386,58046,38889,10572,107507,64137,0.01838378618992083,23523,0,19157,0,0.415986767925396,0,84323,0,52866,12262,0,149451,31457,0.05583383876262924,383665,215082,
268,0.0,1,137,131,406,35836,42909,634583,0.0033163941071360846,168583,1842,0.051400194328452505,19386,58046,38889,10572,107507,64137,0.01838378618992083,23523,0,19157,0,0.415986767925396,0,84323,0,52866,12262,0,149451,31457,0.05583383876262924,383665,215082,
268,0.0,1,137,131,406,35836,42909,634583,0.0033163941071360846,168583,1842,0.051400194328452505,19386,58046,38889,10572,107507,64137,0.01838378618992083,23523,0,19157,0,0.415986767925396,0,84323,0,52866,12262,0,149451,31457,0.05583383876262924,383665,215082,
268,0.0,1,137,131,406,35836,42909,634583,0.0033163941071360846,168583,1842,0.051400194328452505,19386,58046,38889,10572,107507,64137,0.01838378618992083,23523,0,19157,0,0.415986767925396,0,84323,0,52866,12262,0,149451,31457,0.05583383876262924,383665,215082,
268,0.0,1,137,131,406,35836,42909,634583,0.0033163941071360846,168583,1842,0.051400194328452505,19386,58046,38889,10572,107507,64137,0.01838378618992083,23523,0,19157,0,0.415986767925396,0,84323,0,52866,12262,0,149451,31457,0.05583383876262924,383665,215082,
268,0.0,1,137,131,406,35836,42909,634583,0.0033163941071360846,168583,1842,0.051400194328452505,19386,58046,38889,10572,107507,64137,0.01838378618992083,23523,0,19157,0,0.415986767925396,0,84323,0,52866,12262,0,149451,31457,0.05583383876262924,383665,215082,
268,0.0,1,137,131,406,35836,42909,634583,0.0033163941071360846,168583,1842,0.051400194328452505,19386,58046,38889,10572,107507,64137,0.01838378618992083,23523,0,19157,0,0.415986767925396,0,84323,0,52866,12262,0,149451,31457,0.05583383876262924,383665,215082,
268,0.0,1,137,131,406,35836,42909,634583,0.0033163941071360846,168583,1842,0.051400194328452505,19386,58046,38889,10572,107507,64137,0.01838378618992083,23523,0,19157,0,0.415986767925396,0,84323,0,52866,12262,0,149451,31457,0.05583383876262924,383665,215082,
268,0.0,1,137,131,406,35836,42909,634583,0.0033163941071360846,168583,1842,0.051400194328452505,19386,58046,38889,10572,107507,64137,0.01838378618992083,23523,0,19157,0,0.415986767925396,0,84323,0,52866,12262,0,149451,31457,0.05583383876262924,383665,215082,
268,0.0,1,137,131,406,35836,42909,634583,0.0033163941071360846,168583,1842,0.051400194328452505,19386,58046,38889,10572,107507,64137,0.01838378618992083,23523,0,19157,0,0.415986767925396,0,84323,0,52866,12262,0,149451,31457,0.05583383876262924,383665,215082,
268,0.0,1,137,131,406,35836,42909,634583,0.0033163941071360846,168583,1842,0.051400194328452505,19386,58046,38889,10572,107507,64137,0.01838378618992083,23523,0,19157,0,0.415986767925396,0,84323,0,52866,12262,0,149451,31457,0.05583383876262924,383665,215082,
268,0.0,1,137,131,406,35836,42909,634583,0.0033163941071360846,168583,1842,0.051400194328452505,19386,58046,38889,10572,107507,64137,0.01838378618992083,23523,0,19157,0,0.415986767925396,0,84323,0,52866,12262,0,149451,31457,0.05583383876262924,383665,215082,
268,0.0,1,137,131,406,35836,42909,634583,0.0033163941071360846,168583,1842,0.051400194328452505,19386,58046,38889,10572,107507,64137,0.01838378618992083,23523,0,19157,0,0.415986767925396,0,84323,0,52866,12262,0,149451,31457,0.05583383876262924,383665,215082,
268,0.0,1,137,131,406,35836,42909,634583,0.0033163941071360846,168583,1842,0.051400194328452505,19386,58046,38889,10572,107507,64137,0.01838378618992083,23523,0,19157,0,0.415986767925396,0,84323,0,52866,12262,0,149451,31457,0.05583383876262924,383665,215082,
268,0.0,1,137,131,406,35836,42909,634583,0.0033163941071360846,168583,1842,0.051400194328452505,19386,58046,38889,10572,107507,64137,0.01838378618992083,23523,0,19157,0,0.415986767925396,0,84323,0,52866,12262,0,149451,31457,0.05583383876262924,383665,215082,
268,0.0,1,137,131,406,35836,42909,634583,0.0033163941071360846,168583,1842,0.051400194328452505,19386,58046,38889,10572,107507,64137,0.01838378618992083,23523,0,19157,0,0.415986767925396,0,84323,0,52866,12262,0,149451,31457,0.05583383876262924,383665,215082,
268,0.0,1,137,131,406,35836,42909,634583,0.0033163941071360846,168583,1842,0.051400194328452505,19386,58046,38889,10572,107507,64137,0.01838378618992083,23523,0,19157,0,0.415986767925396,0,84323,0,52866,12262,0,149451,31457,0.05583383876262924,383665,215082,
268,0.0,1,137,131,406,35836,42909,634583,0.0033163941071360846,168583,1842,0.051400194328452505,19386,58046,38889,10572,107507,64137,0.01838378618992083,23523,0,19157,0,0.415986767925396,0,84323,0,52866,12262,0,149451,31457,0.05583383876262924,383665,215082,
268,0.0,1,137,131,406,35836,42909,634583,0.0033163941071360846,168583,1842,0.051400194328452505,19386,58046,38889,10572,107507,64137,0.01838378618992083,23523,0,19157,0,0.415986767925396,0,84323,0,52866,12262,0,149451,31457,0.05583383876262924,383665,215082,
268,0.0,1,137,131,406,35836,42909,634583,0.0033163941071360846,168583,1842,0.051400194328452505,19386,58046,38889,10572,107507,64137,0.01838378618992083,23523,0,19157,0,0.415986767925396,0,84323,0,52866,12262,0,149451,31457,0.05583383876262924,383665,215082,
268,0.0,1,137,131,406,35836,42909,634583,0.0033163941071360846,168583,1842,0.051400194328452505,19386,58046,38889,10572,107507,64137,0.01838378618992083,23523,0,19157,0,0.415986767925396,0,84323,0,52866,12262,0,149451,31457,0.05583383876262924,383665,215082,
268,0.0,1,137,131,406,35836,42909,634583,0.0033163941071360846,168583,1842,0.051400194328452505,19386,58046,38889,10572,107507,64137,0.01838378618992083,23523,0,19157,0,0.415986767925396,0,84323,0,52866,12262,0,149451,31457,0.05583383876262924,383665,215082,
268,0.0,1,137,131,406,35836,42909,634583,0.0033163941071360846,168583,1842,0.051400194328452505,19386,58046,38889,10572,107507,64137,0.01838378618992083,23523,0,19157,0,0.415986767925396,0,84323,0,52866,12262,0,149451,31457,0.05583383876262924,383665,215082,
268,0.0,1,137,131,406,35836,42909,634583,0.0033163941071360846,168583,1842,0.051400194328452505,19386,58046,38889,10572,107507,64137,0.01838378618992083,23523,0,19157,0,0.415986767925396,0,84323,0,52866,12262,0,149451,31457,0.05583383876262924,383665,215082,
268,0.0,1,137,131,406,35836,42909,634583,0.0033163941071360846,168583,1842,0.051400194328452505,19386,58046,38889,10572,107507,64137,0.01838378618992083,23523,0,19157,0,0.415986767925396,0,84323,0,52866,12262,0,149451,31457,0.05583383876262924,383665,215082,
268,0.0,1,137,131,406,35836,42909,634583,0.0033163941071360846,168583,1842,0.051400194328452505,19386,58046,38889,10572,107507,64137,0.01838378618992083,23523,0,19157,0,0.415986767925396,0,84323,0,52866,12262,0,149451,31457,0.05583383876262924,383665,215082,
268,0.0,1,137,131,406,35836,42909,634583,0.0033163941071360846,168583,1842,0.051400194328452505,19386,58046,38889,10572,107507,64137,0.01838378618992083,23523,0,19157,0,0.415986767925396,0,84323,0,52866,12262,0,149451,31457,0.05583383876262924,383665,215082,
268,0.0,1,137,131,406,35836,42909,634583,0.0033163941071360846,168583,1842,0.051400194328452505,19386,58046,38889,10572,107507,64137,0.01838378618992083,23523,0,19157,0,0.415986767925396,0,84323,0,52866,12262,0,149451,31457,0.05583383876262924,383665,215082,
268,0.0,1,137,131,406,35836,42909,634583,0.0033163941071360846,168583,1842,0.051400194328452505,19386,58046,38889,10572,107507,64137,0.01838378618992083,23523,0,19157,0,0.415986767925396,0,84323,0,52866,12262,0,149451,31457,0.05583383876262924,383665,215082,
268,0.0,1,137,131,406,35836,42909,634583,0.0033163941071360846,168583,1842,0.051400194328452505,19386,58046,38889,10572,107507,64137,0.01838378618992083,23523,0,19157,0,0.415986767925396,0,84323,0,52866,12262,0,149451,31457,0.05583383876262924,383665,215082,
268,0.0,1,137,131,406,35836,42909,634583,0.0033163941071360846,168583,1842,0.051400194328452505,19386,58046,38889,10572,107507,64137,0.01838378618992083,23523,0,19157,0,0.415986767925396,0,84323,0,52866,12262,0,149451,31457,0.05583383876262924,383665,215082,
268,0.0,1,137,131,406,35836,42909,634583,0.0033163941071360846,168583,1842,0.051400194328452505,19386,58046,38889,10572,107507,64137,0.01838378618992083,23523,0,19157,0,0.415986767925396,0,84323,0,52866,12262,0,149451,31457,0.05583383876262924,383665,215082,
268,0.0,1,137,131,406,35836,42909,634583,0.0033163941071360846,168583,1842,0.051400194328452505,19386,58046,38889,10572,107507,64137,0.01838378618992083,23523,0,19157,0,0.415986767925396,0,84323,0,52866,12262,0,149451,31457,0.05583383876262924,383665,215082,
268,0.0,1,137,131,406,35836,42909,634583,0.0033163941071360846,168583,1842,0.051400194328452505,19386,58046,38889,10572,107507,64137,0.01838378618992083,23523,0,19157,0,0.415986767925396,0,84323,0,52866,12262,0,149451,31457,0.05583383876262924,383665,215082,
268,0.0,1,137,131,406,35836,42909,634583,0.0033163941071360846,168583,1842,0.051400194328452505,19386,58046,38889,10572,107507,64137,0.01838378618992083,23523,0,19157,0,0.415986767925396,0,84323,0,52866,12262,0,149451,31457,0.05583383876262924,383665,215082,
268,0.0,1,137,131,406,35836,42909,634583,0.0033163941071360846,168583,1842,0.051400194328452505,19386,58046,38889,10572,107507,64137,0.01838378618992083,23523,0,19157,0,0.415986767925396,0,84323,0,52866,12262,0,149451,31457,0.05583383876262924,383665,215082,
268,0.0,1,137,131,406,35836,42909,634583,0.0033163941071360846,168583,1842,0.051400194328452505,19386,58046,38889,10572,107507,64137,0.01838378618992083,23523,0,19157,0,0.415986767925396,0,84323,0,52866,12262,0,149451,31457,0.05583383876262924,383665,215082,
268,0.0,1,137,131,406,35836,42909,634583,0.0033163941071360846,168583,1842,0.051400194328452505,19386,58046,38889,10572,107507,64137,0.01838378618992083,23523,0,19157,0,0.415986767925396,0,84323,0,52866,12262,0,149451,31457,0.05583383876262924,383665,215082,
268,0.0,1,137,131,406,35836,42909,634583,0.0033163941071360846,168583,1842,0.051400194328452505,19386,58046,38889,10572,107507,64137,0.01838378618992083,23523,0,19157,0,0.415986767925396,0,84323,0,52866,12262,0,149451,31457,0.05583383876262924,383665,215082,
268,0.0,1,137,131,406,35836,42909,634583,0.0033163941071360846,168583,1842,0.051400194328452505,19386,58046,38889,10572,107507,64137,0.01838378618992083,23523,0,19157,0,0.415986767925396,0,84323,0,52866,12262,0,149451,31457,0.05583383876262924,383665,215082,
268,0.0,1,137,131,406,35836,42909,634583,0.0033163941071360846,168583,1842,0.051400194328452505,19386,58046,38889,10572,107507,64137,0.01838378618992083,23523,0,19157,0,0.415986767925396,0,84323,0,52866,12262,0,149451,31457,0.05583383876262924,383665,215082,
268,0.0,1,137,131,406,35836,42909,634583,0.0033163941071360846,168583,1842,0.051400194328452505,19386,58046,38889,10572,107507,64137,0.01838378618992083,23523,0,19157,0,0.415986767925396,0,84323,0,52866,12262,0,149451,31457,0.05583383876262924,383665,215082,
268,0.0,1,137,131,406,35836,42909,634583,0.0033163941071360846,168583,1842,0.051400194328452505,19386,58046,38889,10572,107507,64137,0.01838378618992083,23523,0,19157,0,0.415986767925396,0,84323,0,52866,12262,0,149451,31457,0.05583383876262924,383665,215082,
268,0.0,1,137,131,406,35836,42909,634583,0.0033163941071360846,168583,1842,0.051400194328452505,19386,58046,38889,10572,107507,64137,0.01838378618992083,23523,0,19157,0,0.415986767925396,0,84323,0,52866,12262,0,149451,31457,0.05583383876262924,383665,215082,
268,0.0,1,137,131,406,35836,42909,634583,0.0033163941071360846,168583,1842,0.051400194328452505,19386,58046,38889,10572,107507,64137,0.01838378618992083,23523,0,19157,0,0.415986767925396,0,84323,0,52866,12262,0,149451,31457,0.05583383876262924,383665,215082,
268,0.0,1,137,131,406,35836,42909,634583,0.0033163941071360846,168583,1842,0.051400194328452505,19386,58046,38889,10572,107507,64137,0.01838378618992083,23523,0,19157,0,0.415986767925396,0,84323,0,52866,12262,0,149451,31457,0.05583383876262924,383665,215082,
268,0.0,1,137,131,406,35836,42909,634583,0.0033163941071360846,168583,1842,0.051400194328452505,19386,58046,38889,10572,107507,64137,0.01838378618992083,23523,0,19157,0,0.415986767925396,0,84323,0,52866,12262,0,149451,31457,0.05583383876262924,383665,215082,
268,0.0,1,137,131,406,35836,42909,634583,0.0033163941071360846,168583,1842,0.051400194328452505,19386,58046,38889,10572,107507,64137,0.01838378618992083,23523,0,19157,0,0.415986767925396,0,84323,0,52866,12262,0,149451,31457,0.05583383876262924,383665,215082,
268,0.0,1,137,131,406,35836,42909,634583,0.0033163941071360846,168583,1842,0.051400194328452505,19386,58046,38889,10572,107507,64137,0.01838378618992083,23523,0,19157,0,0.415986767925396,0,84323,0,52866,12262,0,149451,31457,0.05583383876262924,383665,215082,
268,0.0,1,137,131,406,35836,42909,634583,0.0033163941071360846,168583,1842,0.051400194328452505,19386,58046,38889,10572,107507,64137,0.01838378618992083,23523,0,19157,0,0.415986767925396,0,84323,0,52866,12262,0,149451,31457,0.05583383876262924,383665,215082,
268,0.0,1,137,131,406,35836,42909,634583,0.0033163941071360846,168583,1842,0.051400194328452505,19386,58046,38889,10572,107507,64137,0.01838378618992083,23523,0,19157,0,0.415986767925396,0,84323,0,52866,12262,0,149451,31457,0.05583383876262924,383665,215082,
268,0.0,1,137,131,406,35836,42909,634583,0.0033163941071360846,168583,1842,0.051400194328452505,19386,58046,38889,10572,107507,64137,0.01838378618992083,23523,0,19157,0,0.415986767925396,0,84323,0,52866,12262,0,149451,31457,0.05583383876262924,383665,215082,
268,0.0,1,137,131,406,35836,42909,634583,0.0033163941071360846,168583,1842,0.051400194328452505,19386,58046,38889,10572,107507,64137,0.01838378618992083,23523,0,19157,0,0.415986767925396,0,84323,0,52866,12262,0,149451,31457,0.05583383876262924,383665,215082,
268,0.0,1,137,131,406,35836,42909,634583,0.0033163941071360846,168583,1842,0.051400194328452505,19386,58046,38889,10572,107507,64137,0.01838378618992083,23523,0,19157,0,0.415986767925396,0,84323,0,52866,12262,0,149451,31457,0.05583383876262924,383665,215082,
268,0.0,1,137,131,406,35836,42909,634583,0.0033163941071360846,168583,1842,0.051400194328452505,19386,58046,38889,10572,107507,64137,0.01838378618992083,23523,0,19157,0,0.415986767925396,0,84323,0,52866,12262,0,149451,31457,0.05583383876262924,383665,215082,
268,0.0,1,137,131,406,35836,42909,634583,0.0033163941071360846,168583,1842,0.051400194328452505,19386,58046,38889,10572,107507,64137,0.01838378618992083,23523,0,19157,0,0.415986767925396,0,84323,0,52866,12262,0,149451,31457,0.05583383876262924,383665,215082,
268,0.0,1,137,131,406,35836,42909,634583,0.0033163941071360846,168583,1842,0.051400194328452505,19386,58046,38889,10572,107507,64137,0.01838378618992083,23523,0,19157,0,0.415986767925396,0,84323,0,52866,12262,0,149451,31457,0.05583383876262924,383665,215082,
268,0.0,1,137,131,406,35836,42909,634583,0.0033163941071360846,168583,1842,0.051400194328452505,19386,58046,38889,10572,107507,64137,0.01838378618992083,23523,0,19157,0,0.415986767925396,0,84323,0,52866,12262,0,149451,31457,0.05583383876262924,383665,215082,
268,0.0,1,137,131,406,35836,42909,634583,0.0033163941071360846,168583,1842,0.051400194328452505,19386,58046,38889,10572,107507,64137,0.01838378618992083,23523,0,19157,0,0.415986767925396,0,84323,0,52866,12262,0,149451,31457,0.05583383876262924,383665,215082,
268,0.0,1,137,131,406,35836,42909,634583,0.0033163941071360846,168583,1842,0.051400194328452505,19386,58046,38889,10572,107507,64137,0.01838378618992083,23523,0,19157,0,0.415986767925396,0,84323,0,52866,12262,0,149451,31457,0.05583383876262924,383665,215082,
268,0.0,1,137,131,406,35836,42909,634583,0.0033163941071360846,168583,1842,0.051400194328452505,19386,58046,38889,10572,107507,64137,0.01838378618992083,23523,0,19157,0,0.415986767925396,0,84323,0,52866,12262,0,149451,31457,0.05583383876262924,383665,215082,
268,0.0,1,137,131,406,35836,42909,634583,0.0033163941071360846,168583,1842,0.051400194328452505,19386,58046,38889,10572,107507,64137,0.01838378618992083,23523,0,19157,0,0.415986767925396,0,84323,0,52866,12262,0,149451,31457,0.05583383876262924,383665,215082,
268,0.0,1,137,131,406,35836,42909,634583,0.0033163941071360846,168583,1842,0.051400194328452505,19386,58046,38889,10572,107507,64137,0.01838378618992083,23523,0,19157,0,0.415986767925396,0,84323,0,52866,12262,0,149451,31457,0.05583383876262924,383665,215082,
268,0.0,1,137,131,406,35836,42909,634583,0.0033163941071360846,168583,1842,0.051400194328452505,19386,58046,38889,10572,107507,64137,0.01838378618992083,23523,0,19157,0,0.415986767925396,0,84323,0,52866,12262,0,149451,31457,0.05583383876262924,383665,215082,
268,0.0,1,137,131,406,35836,42909,634583,0.0033163941071360846,168583,1842,0.051400194328452505,19386,58046,38889,10572,107507,64137,0.01838378618992083,23523,0,19157,0,0.415986767925396,0,84323,0,52866,12262,0,149451,31457,0.05583383876262924,383665,215082,
268,0.0,1,137,131,406,35836,42909,634583,0.0033163941071360846,168583,1842,0.051400194328452505,19386,58046,38889,10572,107507,64137,0.01838378618992083,23523,0,19157,0,0.415986767925396,0,84323,0,52866,12262,0,149451,31457,0.05583383876262924,383665,215082,
268,0.0,1,137,131,406,35836,42909,634583,0.0033163941071360846,168583,1842,0.051400194328452505,19386,58046,38889,10572,107507,64137,0.01838378618992083,23523,0,19157,0,0.415986767925396,0,84323,0,52866,12262,0,149451,31457,0.05583383876262924,383665,215082,
268,0.0,1,137,131,406,35836,42909,634583,0.0033163941071360846,168583,1842,0.051400194328452505,19386,58046,38889,10572,107507,64137,0.01838378618992083,23523,0,19157,0,0.415986767925396,0,84323,0,52866,12262,0,149451,31457,0.05583383876262924,383665,215082,
268,0.0,1,137,131,406,35836,42909,634583,0.0033163941071360846,168583,1842,0.051400194328452505,19386,58046,38889,10572,107507,64137,0.01838378618992083,23523,0,19157,0,0.415986767925396,0,84323,0,52866,12262,0,149451,31457,0.05583383876262924,383665,215082,
268,0.0,1,137,131,406,35836,42909,634583,0.0033163941071360846,168583,1842,0.051400194328452505,19386,58046,38889,10572,107507,64137,0.01838378618992083,23523,0,19157,0,0.415986767925396,0,84323,0,52866,12262,0,149451,31457,0.05583383876262924,383665,215082,
268,0.0,1,137,131,406,35836,42909,634583,0.0033163941071360846,168583,1842,0.051400194328452505,19386,58046,38889,10572,107507,64137,0.01838378618992083,23523,0,19157,0,0.415986767925396,0,84323,0,52866,12262,0,149451,31457,0.05583383876262924,383665,215082,
268,0.0,1,137,131,406,35836,42909,634583,0.0033163941071360846,168583,1842,0.051400194328452505,19386,58046,38889,10572,107507,64137,0.01838378618992083,23523,0,19157,0,0.415986767925396,0,84323,0,52866,12262,0,149451,31457,0.05583383876262924,383665,215082,
268,0.0,1,137,131,406,35836,42909,634583,0.0033163941071360846,168583,1842,0.051400194328452505,19386,58046,38889,10572,107507,64137,0.01838378618992083,23523,0,19157,0,0.415986767925396,0,84323,0,52866,12262,0,149451,31457,0.05583383876262924,383665,215082,
268,0.0,1,137,131,406,35836,42909,634583,0.0033163941071360846,168583,1842,0.051400194328452505,19386,58046,38889,10572,107507,64137,0.01838378618992083,23523,0,19157,0,0.415986767925396,0,84323,0,52866,12262,0,149451,31457,0.05583383876262924,383665,215082,
268,0.0,1,137,131,406,35836,42909,634583,0.0033163941071360846,168583,1842,0.051400194328452505,19386,58046,38889,10572,107507,64137,0.01838378618992083,23523,0,19157,0,0.415986767925396,0,84323,0,52866,12262,0,149451,31457,0.05583383876262924,383665,215082,
268,0.0,1,137,131,406,35836,42909,634583,0.0033163941071360846,168583,1842,0.051400194328452505,19386,58046,38889,10572,107507,64137,0.01838378618992083,23523,0,19157,0,0.415986767925396,0,84323,0,52866,12262,0,149451,31457,0.05583383876262924,383665,215082,
268,0.0,1,137,131,406,35836,42909,634583,0.0033163941071360846,168583,1842,0.051400194328452505,19386,58046,38889,10572,107507,64137,0.01838378618992083,23523,0,19157,0,0.415986767925396,0,84323,0,52866,12262,0,149451,31457,0.05583383876262924,383665,215082,
268,0.0,1,137,131,406,35836,42909,634583,0.0033163941071360846,168583,1842,0.051400194328452505,19386,58046,38889,10572,107507,64137,0.01838378618992083,23523,0,19157,0,0.415986767925396,0,84323,0,52866,12262,0,149451,31457,0.05583383876262924,383665,215082,
268,0.0,1,137,131,406,35836,42909,634583,0.0033163941071360846,168583,1842,0.051400194328452505,19386,58046,38889,10572,107507,64137,0.01838378618992083,23523,0,19157,0,0.415986767925396,0,84323,0,52866,12262,0,149451,31457,0.05583383876262924,383665,215082,
268,0.0,1,137,131,406,35836,42909,634583,0.0033163941071360846,168583,1842,0.051400194328452505,19386,58046,38889,10572,107507,64137,0.01838378618992083,23523,0,19157,0,0.415986767925396,0,84323,0,52866,12262,0,149451,31457,0.05583383876262924,383665,215082,
268,0.0,1,137,131,406,35836,42909,634583,0.0033163941071360846,168583,1842,0.051400194328452505,19386,58046,38889,10572,107507,64137,0.01838378618992083,23523,0,19157,0,0.415986767925396,0,84323,0,52866,12262,0,149451,31457,0.05583383876262924,383665,215082,
268,0.0,1,137,131,406,35836,42909,634583,0.0033163941071360846,168583,1842,0.051400194328452505,19386,58046,38889,10572,107507,64137,0.01838378618992083,23523,0,19157,0,0.415986767925396,0,84323,0,52866,12262,0,149451,31457,0.05583383876262924,383665,215082,
268,0.0,1,137,131,406,35836,42909,634583,0.0033163941071360846,168583,1842,0.051400194328452505,19386,58046,38889,10572,107507,64137,0.01838378618992083,23523,0,19157,0,0.415986767925396,0,84323,0,52866,12262,0,149451,31457,0.05583383876262924,383665,215082,
268,0.0,1,137,131,406,35836,42909,634583,0.0033163941071360846,168583,1842,0.051400194328452505,19386,58046,38889,10572,107507,64137,0.01838378618992083,23523,0,19157,0,0.415986767925396,0,84323,0,52866,12262,0,149451,31457,0.05583383876262924,383665,215082,
268,0.0,1,137,131,406,35836,42909,634583,0.0033163941071360846,168583,1842,0.051400194328452505,19386,58046,38889,10572,107507,64137,0.01838378618992083,23523,0,19157,0,0.415986767925396,0,84323,0,52866,12262,0,149451,31457,0.05583383876262924,383665,215082,
268,0.0,1,137,131,406,35836,42909,634583,0.0033163941071360846,168583,1842,0.051400194328452505,19386,58046,38889,10572,107507,64137,0.01838378618992083,23523,0,19157,0,0.415986767925396,0,84323,0,52866,12262,0,149451,31457,0.05583383876262924,383665,215082,
268,0.0,1,137,131,406,35836,42909,634583,0.0033163941071360846,168583,1842,0.051400194328452505,19386,58046,38889,10572,107507,64137,0.01838378618992083,23523,0,19157,0,0.415986767925396,0,84323,0,52866,12262,0,149451,31457,0.05583383876262924,383665,215082,
268,0.0,1,137,131,406,35836,42909,634583,0.0033163941071360846,168583,1842,0.051400194328452505,19386,58046,38889,10572,107507,64137,0.01838378618992083,23523,0,19157,0,0.415986767925396,0,84323,0,52866,12262,0,149451,31457,0.05583383876262924,383665,215082,
268,0.0,1,137,131,406,35836,42909,634583,0.0033163941071360846,168583,1842,0.051400194328452505,19386,58046,38889,10572,107507,64137,0.01838378618992083,23523,0,19157,0,0.415986767925396,0,84323,0,52866,12262,0,149451,31457,0.05583383876262924,383665,215082,
268,0.0,1,137,131,406,35836,42909,634583,0.0033163941071360846,168583,1842,0.051400194328452505,19386,58046,38889,10572,107507,64137,0.01838378618992083,23523,0,19157,0,0.415986767925396,0,84323,0,52866,12262,0,149451,31457,0.05583383876262924,383665,215082,
268,0.0,1,137,131,406,35836,42909,634583,0.0033163941071360846,168583,1842,0.051400194328452505,19386,58046,38889,10572,107507,64137,0.01838378618992083,23523,0,19157,0,0.415986767925396,0,84323,0,52866,12262,0,149451,31457,0.05583383876262924,383665,215082,
268,0.0,1,137,131,406,35836,42909,634583,0.0033163941071360846,168583,1842,0.051400194328452505,19386,58046,38889,10572,107507,64137,0.01838378618992083,23523,0,19157,0,0.415986767925396,0,84323,0,52866,12262,0,149451,31457,0.05583383876262924,383665,215082,
268,0.0,1,137,131,406,35836,42909,634583,0.0033163941071360846,168583,1842,0.051400194328452505,19386,58046,38889,10572,107507,64137,0.01838378618992083,23523,0,19157,0,0.415986767925396,0,84323,0,52866,12262,0,149451,31457,0.05583383876262924,383665,215082,
268,0.0,1,137,131,406,35836,42909,634583,0.0033163941071360846,168583,1842,0.051400194328452505,19386,58046,38889,10572,107507,64137,0.01838378618992083,23523,0,19157,0,0.415986767925396,0,84323,0,52866,12262,0,149451,31457,0.05583383876262924,383665,215082,
268,0.0,1,137,131,406,35836,42909,634583,0.0033163941071360846,168583,1842,0.051400194328452505,19386,58046,38889,10572,107507,64137,0.01838378618992083,23523,0,19157,0,0.415986767925396,0,84323,0,52866,12262,0,149451,31457,0.05583383876262924,383665,215082,
268,0.0,1,137,131,406,35836,42909,634583,0.0033163941071360846,168583,1842,0.051400194328452505,19386,58046,38889,10572,107507,64137,0.01838378618992083,23523,0,19157,0,0.415986767925396,0,84323,0,52866,12262,0,149451,31457,0.05583383876262924,383665,215082,
268,0.0,1,137,131,406,35836,42909,634583,0.0033163941071360846,168583,1842,0.051400194328452505,19386,58046,38889,10572,107507,64137,0.01838378618992083,23523,0,19157,0,0.415986767925396,0,84323,0,52866,12262,0,149451,31457,0.05583383876262924,383665,215082,
268,0.0,1,137,131,406,35836,42909,634583,0.0033163941071360846,168583,1842,0.051400194328452505,19386,58046,38889,10572,107507,64137,0.01838378618992083,23523,0,19157,0,0.415986767925396,0,84323,0,52866,12262,0,149451,31457,0.05583383876262924,383665,215082,
268,0.0,1,137,131,406,35836,42909,634583,0.0033163941071360846,168583,1842,0.051400194328452505,19386,58046,38889,10572,107507,64137,0.01838378618992083,23523,0,19157,0,0.415986767925396,0,84323,0,52866,12262,0,149451,31457,0.05583383876262924,383665,215082,
268,0.0,1,137,131,406,35836,42909,634583,0.0033163941071360846,168583,1842,0.051400194328452505,19386,58046,38889,10572,107507,64137,0.01838378618992083,23523,0,19157,0,0.415986767925396,0,84323,0,52866,12262,0,149451,31457,0.05583383876262924,383665,215082,
268,0.0,1,137,131,406,35836,42909,634583,0.0033163941071360846,168583,1842,0.051400194328452505,19386,58046,38889,10572,107507,64137,0.01838378618992083,23523,0,19157,0,0.415986767925396,0,84323,0,52866,12262,0,149451,31457,0.05583383876262924,383665,215082,
268,0.0,1,137,131,406,35836,42909,634583,0.0033163941071360846,168583,1842,0.051400194328452505,19386,58046,38889,10572,107507,64137,0.01838378618992083,23523,0,19157,0,0.415986767925396,0,84323,0,52866,12262,0,149451,31457,0.05583383876262924,383665,215082,
268,0.0,1,137,131,406,35836,42909,634583,0.0033163941071360846,168583,1842,0.051400194328452505,19386,58046,38889,10572,107507,64137,0.01838378618992083,23523,0,19157,0,0.415986767925396,0,84323,0,52866,12262,0,149451,31457,0.05583383876262924,383665,215082,
268,0.0,1,137,131,406,35836,42909,634583,0.0033163941071360846,168583,1842,0.051400194328452505,19386,58046,38889,10572,107507,64137,0.01838378618992083,23523,0,19157,0,0.415986767925396,0,84323,0,52866,12262,0,149451,31457,0.05583383876262924,383665,215082,
268,0.0,1,137,131,406,35836,42909,634583,0.0033163941071360846,168583,1842,0.051400194328452505,19386,58046,38889,10572,107507,64137,0.01838378618992083,23523,0,19157,0,0.415986767925396,0,84323,0,52866,12262,0,149451,31457,0.05583383876262924,383665,215082,
268,0.0,1,137,131,406,35836,42909,634583,0.0033163941071360846,168583,1842,0.051400194328452505,19386,58046,38889,10572,107507,64137,0.01838378618992083,23523,0,19157,0,0.415986767925396,0,84323,0,52866,12262,0,149451,31457,0.05583383876262924,383665,215082,
268,0.0,1,137,131,406,35836,42909,634583,0.0033163941071360846,168583,1842,0.051400194328452505,19386,58046,38889,10572,107507,64137,0.01838378618992083,23523,0,19157,0,0.415986767925396,0,84323,0,52866,12262,0,149451,31457,0.05583383876262924,383665,215082,
268,0.0,1,137,131,406,35836,42909,634583,0.0033163941071360846,168583,1842,0.051400194328452505,19386,58046,38889,10572,107507,64137,0.01838378618992083,23523,0,19157,0,0.415986767925396,0,84323,0,52866,12262,0,149451,31457,0.05583383876262924,383665,215082,
268,0.0,1,137,131,406,35836,42909,634583,0.0033163941071360846,168583,1842,0.051400194328452505,19386,58046,38889,10572,107507,64137,0.01838378618992083,23523,0,19157,0,0.415986767925396,0,84323,0,52866,12262,0,149451,31457,0.05583383876262924,383665,215082,
268,0.0435772231050569,1,137,131,406,35836,42909,634583,0.0033163941071360846,168583,1842,0.051400194328452505,19386,3192,1795,460,5447,64137,0.01838378618992083,23523,79,1397,131,0.06357695948248036,210,84323,0,52866,12262,52,149451,31457,0.05583383876262924,383665,215082,
268,0.0435772231050569,1,137,131,406,35836,42909,634583,0.0033163941071360846,168583,1842,0.051400194328452505,19386,3192,1795,460,5447,64137,0.01838378618992083,23523,79,1397,131,0.06357695948248036,210,84323,0,52866,12262,52,149451,31457,0.05583383876262924,383665,215082,
268,0.0435772231050569,1,137,131,406,35836,42909,634583,0.0033163941071360846,168583,1842,0.051400194328452505,19386,3192,1795,460,5447,64137,0.01838378618992083,23523,79,1397,131,0.06357695948248036,210,84323,0,52866,12262,52,149451,31457,0.05583383876262924,383665,215082,
268,0.0435772231050569,1,137,131,406,35836,42909,634583,0.0033163941071360846,168583,1842,0.051400194328452505,19386,3192,1795,460,5447,64137,0.01838378618992083,23523,79,1397,131,0.06357695948248036,210,84323,0,52866,12262,52,149451,31457,0.05583383876262924,383665,215082,
268,0.0,1,137,131,406,35836,42909,634583,0.0033163941071360846,168583,1842,0.051400194328452505,19386,4153,1290,332,5775,64137,0.01838378618992083,23523,0,2863,0,0.20506535231927892,0,84323,0,52866,12262,0,149451,31457,0.05583383876262924,383665,215082,
268,0.0,1,137,131,406,35836,42909,634583,0.0033163941071360846,168583,1842,0.051400194328452505,19386,4153,1290,332,5775,64137,0.01838378618992083,23523,0,2863,0,0.20506535231927892,0,84323,0,52866,12262,0,149451,31457,0.05583383876262924,383665,215082,
268,0.0,1,137,131,406,35836,42909,634583,0.0033163941071360846,168583,1842,0.051400194328452505,19386,4153,1290,332,5775,64137,0.01838378618992083,23523,0,2863,0,0.20506535231927892,0,84323,0,52866,12262,0,149451,31457,0.05583383876262924,383665,215082,
268,0.0,1,137,131,406,35836,42909,634583,0.0033163941071360846,168583,1842,0.051400194328452505,19386,4153,1290,332,5775,64137,0.01838378618992083,23523,0,2863,0,0.20506535231927892,0,84323,0,52866,12262,0,149451,31457,0.05583383876262924,383665,215082,
268,0.0,1,137,131,406,35836,42909,634583,0.0033163941071360846,168583,1842,0.051400194328452505,19386,464,9,0,473,64137,0.01838378618992083,23523,0,455,0,0.05992142661692834,0,84323,0,52866,12262,0,149451,31457,0.05583383876262924,383665,215082,
268,0.0,1,137,131,406,35836,42909,634583,0.0033163941071360846,168583,1842,0.051400194328452505,19386,464,9,0,473,64137,0.01838378618992083,23523,0,455,0,0.05992142661692834,0,84323,0,52866,12262,0,149451,31457,0.05583383876262924,383665,215082,
268,0.0,1,137,131,406,35836,42909,634583,0.0033163941071360846,168583,1842,0.051400194328452505,19386,464,9,0,473,64137,0.01838378618992083,23523,0,455,0,0.05992142661692834,0,84323,0,52866,12262,0,149451,31457,0.05583383876262924,383665,215082,
268,0.0,1,137,131,406,35836,42909,634583,0.0033163941071360846,168583,1842,0.051400194328452505,19386,726,630,50,1406,64137,0.01838378618992083,23523,0,96,0,0.07979886127609757,0,84323,0,52866,12262,0,149451,31457,0.05583383876262924,383665,215082,
268,0.0,1,137,131,406,35836,42909,634583,0.0033163941071360846,168583,1842,0.051400194328452505,19386,726,630,50,1406,64137,0.01838378618992083,23523,0,96,0,0.07979886127609757,0,84323,0,52866,12262,0,149451,31457,0.05583383876262924,383665,215082,
268,0.0,1,137,131,406,35836,42909,634583,0.0033163941071360846,168583,1842,0.051400194328452505,19386,726,630,50,1406,64137,0.01838378618992083,23523,0,96,0,0.07979886127609757,0,84323,0,52866,12262,0,149451,31457,0.05583383876262924,383665,215082,
268,0.0,1,137,131,406,35836,42909,634583,0.0033163941071360846,168583,1842,0.051400194328452505,19386,726,630,50,1406,64137,0.01838378618992083,23523,0,96,0,0.07979886127609757,0,84323,0,52866,12262,0,149451,31457,0.05583383876262924,383665,215082,
268,0.0,1,137,131,406,35836,42909,634583,0.0033163941071360846,168583,1842,0.051400194328452505,19386,879,161,71,1111,64137,0.01838378618992083,23523,0,718,0,0.04294791074333831,0,84323,0,52866,12262,0,149451,31457,0.05583383876262924,383665,215082,
268,0.0,1,137,131,406,35836,42909,634583,0.0033163941071360846,168583,1842,0.051400194328452505,19386,879,161,71,1111,64137,0.01838378618992083,23523,0,718,0,0.04294791074333831,0,84323,0,52866,12262,0,149451,31457,0.05583383876262924,383665,215082,
268,0.0,1,137,131,406,35836,42909,634583,0.0033163941071360846,168583,1842,0.051400194328452505,19386,879,161,71,1111,64137,0.01838378618992083,23523,0,718,0,0.04294791074333831,0,84323,0,52866,12262,0,149451,31457,0.05583383876262924,383665,215082,
268,0.0,1,137,131,406,35836,42909,634583,0.0033163941071360846,168583,1842,0.051400194328452505,19386,272,379,3,654,64137,0.01838378618992083,23523,0,-107,0,0.01653289190303147,0,84323,0,52866,12262,0,149451,31457,0.05583383876262924,383665,215082,
268,0.0,1,137,131,406,35836,42909,634583,0.0033163941071360846,168583,1842,0.051400194328452505,19386,272,379,3,654,64137,0.01838378618992083,23523,0,-107,0,0.01653289190303147,0,84323,0,52866,12262,0,149451,31457,0.05583383876262924,383665,215082,
268,0.0,1,137,131,406,35836,42909,634583,0.0033163941071360846,168583,1842,0.051400194328452505,19386,272,379,3,654,64137,0.01838378618992083,23523,0,-107,0,0.01653289190303147,0,84323,0,52866,12262,0,149451,31457,0.05583383876262924,383665,215082,
268,0.0,1,137,131,406,35836,42909,634583,0.0033163941071360846,168583,1842,0.051400194328452505,19386,450,381,19,850,64137,0.01838378618992083,23523,0,69,0,0.006601586156609657,0,84323,0,52866,12262,0,149451,31457,0.05583383876262924,383665,215082,
268,0.0,1,137,131,406,35836,42909,634583,0.0033163941071360846,168583,1842,0.051400194328452505,19386,450,381,19,850,64137,0.01838378618992083,23523,0,69,0,0.006601586156609657,0,84323,0,52866,12262,0,149451,31457,0.05583383876262924,383665,215082,
268,0.0,1,137,131,406,35836,42909,634583,0.0033163941071360846,168583,1842,0.051400194328452505,19386,450,381,19,850,64137,0.01838378618992083,23523,0,69,0,0.006601586156609657,0,84323,0,52866,12262,0,149451,31457,0.05583383876262924,383665,215082,
268,0.0,1,137,131,406,35836,42909,634583,0.0033163941071360846,168583,1842,0.051400194328452505,19386,562,488,27,1077,64137,0.01838378618992083,23523,0,74,0,0.007670647314184903,0,84323,0,52866,12262,0,149451,31457,0.05583383876262924,383665,215082,
268,0.0,1,137,131,406,35836,42909,634583,0.0033163941071360846,168583,1842,0.051400194328452505,19386,562,488,27,1077,64137,0.01838378618992083,23523,0,74,0,0.007670647314184903,0,84323,0,52866,12262,0,149451,31457,0.05583383876262924,383665,215082,
268,0.0,1,137,131,406,35836,42909,634583,0.0033163941071360846,168583,1842,0.051400194328452505,19386,562,488,27,1077,64137,0.01838378618992083,23523,0,74,0,0.007670647314184903,0,84323,0,52866,12262,0,149451,31457,0.05583383876262924,383665,215082,
268,0.0,1,137,131,406,35836,42909,634583,0.0033163941071360846,168583,1842,0.051400194328452505,19386,882,0,0,882,64137,0.01838378618992083,23523,0,882,0,0.07816578567725357,0,84323,0,52866,12262,0,149451,31457,0.05583383876262924,383665,215082,
268,0.0,1,137,131,406,35836,42909,634583,0.0033163941071360846,168583,1842,0.051400194328452505,19386,882,0,0,882,64137,0.01838378618992083,23523,0,882,0,0.07816578567725357,0,84323,0,52866,12262,0,149451,31457,0.05583383876262924,383665,215082,
268,0.0,1,137,131,406,35836,42909,634583,0.0033163941071360846,168583,1842,0.051400194328452505,19386,882,0,0,882,64137,0.01838378618992083,23523,0,882,0,0.07816578567725357,0,84323,0,52866,12262,0,149451,31457,0.05583383876262924,383665,215082,
268,0.0,1,137,131,406,35836,42909,634583,0.0033163941071360846,168583,1842,0.051400194328452505,19386,93,45,0,138,64137,0.01838378618992083,23523,0,48,0,0.004153629953178826,0,84323,0,52866,12262,0,149451,31457,0.05583383876262924,383665,215082,
268,0.0,1,137,131,406,35836,42909,634583,0.0033163941071360846,168583,1842,0.051400194328452505,19386,93,45,0,138,64137,0.01838378618992083,23523,0,48,0,0.004153629953178826,0,84323,0,52866,12262,0,149451,31457,0.05583383876262924,383665,215082,
268,0.0,1,137,131,406,35836,42909,634583,0.0033163941071360846,168583,1842,0.051400194328452505,19386,93,45,0,138,64137,0.01838378618992083,23523,0,48,0,0.004153629953178826,0,84323,0,52866,12262,0,149451,31457,0.05583383876262924,383665,215082,
268,0.0,1,137,131,406,35836,42909,634583,0.0033163941071360846,168583,1842,0.051400194328452505,19386,95,53,0,148,64137,0.01838378618992083,23523,0,42,0,0.0035965281181097384,0,84323,0,52866,12262,0,149451,31457,0.05583383876262924,383665,215082,
268,0.0,1,137,131,406,35836,42909,634583,0.0033163941071360846,168583,1842,0.051400194328452505,19386,95,53,0,148,64137,0.01838378618992083,23523,0,42,0,0.0035965281181097384,0,84323,0,52866,12262,0,149451,31457,0.05583383876262924,383665,215082,
268,0.0,1,137,131,406,35836,42909,634583,0.0033163941071360846,168583,1842,0.051400194328452505,19386,95,53,0,148,64137,0.01838378618992083,23523,0,42,0,0.0035965281181097384,0,84323,0,52866,12262,0,149451,31457,0.05583383876262924,383665,215082,
268,0.0,1,137,131,406,35836,42909,634583,0.0033163941071360846,168583,1842,0.051400194328452505,19386,281,208,100,589,64137,0.01838378618992083,23523,0,73,0,0.024351084093805396,0,84323,0,52866,12262,0,149451,31457,0.05583383876262924,383665,215082,
268,0.0,1,137,131,406,35836,42909,634583,0.0033163941071360846,168583,1842,0.051400194328452505,19386,281,208,100,589,64137,0.01838378618992083,23523,0,73,0,0.024351084093805396,0,84323,0,52866,12262,0,149451,31457,0.05583383876262924,383665,215082,
268,0.0,1,137,131,406,35836,42909,634583,0.0033163941071360846,168583,1842,0.051400194328452505,19386,281,208,100,589,64137,0.01838378618992083,23523,0,73,0,0.024351084093805396,0,84323,0,52866,12262,0,149451,31457,0.05583383876262924,383665,215082,
268,0.0,1,137,131,406,35836,42909,634583,0.0033163941071360846,168583,1842,0.051400194328452505,19386,726,154,66,946,64137,0.01838378618992083,23523,0,572,0,0.045051629519949205,0,84323,0,52866,12262,0,149451,31457,0.05583383876262924,383665,215082,
268,0.0,1,137,131,406,35836,42909,634583,0.0033163941071360846,168583,1842,0.051400194328452505,19386,726,154,66,946,64137,0.01838378618992083,23523,0,572,0,0.045051629519949205,0,84323,0,52866,12262,0,149451,31457,0.05583383876262924,383665,215082,
268,0.0,1,137,131,406,35836,42909,634583,0.0033163941071360846,168583,1842,0.051400194328452505,19386,726,154,66,946,64137,0.01838378618992083,23523,0,572,0,0.045051629519949205,0,84323,0,52866,12262,0,149451,31457,0.05583383876262924,383665,215082,
268,0.0,1,137,131,406,35836,42909,634583,0.0033163941071360846,168583,1842,0.051400194328452505,19386,397,215,54,666,64137,0.01838378618992083,23523,0,182,0,0.013857628563040894,0,84323,0,52866,12262,0,149451,31457,0.05583383876262924,383665,215082,
268,0.0,1,137,131,406,35836,42909,634583,0.0033163941071360846,168583,1842,0.051400194328452505,19386,397,215,54,666,64137,0.01838378618992083,23523,0,182,0,0.013857628563040894,0,84323,0,52866,12262,0,149451,31457,0.05583383876262924,383665,215082,
268,0.0,1,137,131,406,35836,42909,634583,0.0033163941071360846,168583,1842,0.051400194328452505,19386,397,215,54,666,64137,0.01838378618992083,23523,0,182,0,0.013857628563040894,0,84323,0,52866,12262,0,149451,31457,0.05583383876262924,383665,215082,
268,0.0,1,137,131,406,35836,42909,634583,0.0033163941071360846,168583,1842,0.051400194328452505,19386,173,154,0,327,64137,0.01838378618992083,23523,0,19,0,0.010206567631251152,0,84323,0,52866,12262,0,149451,31457,0.05583383876262924,383665,215082,
268,0.0,1,137,131,406,35836,42909,634583,0.0033163941071360846,168583,1842,0.051400194328452505,19386,173,154,0,327,64137,0.01838378618992083,23523,0,19,0,0.010206567631251152,0,84323,0,52866,12262,0,149451,31457,0.05583383876262924,383665,215082,
268,0.0,1,137,131,406,35836,42909,634583,0.0033163941071360846,168583,1842,0.051400194328452505,19386,173,154,0,327,64137,0.01838378618992083,23523,0,19,0,0.010206567631251152,0,84323,0,52866,12262,0,149451,31457,0.05583383876262924,383665,215082,
268,0.0012763241863433313,1,137,131,406,35836,42909,634583,0.0033163941071360846,168583,1842,0.051400194328452505,19386,72,66,8,146,64137,0.01838378618992083,23523,2,6,2,0.03438545298818811,4,84323,0,52866,12262,0,149451,31457,0.05583383876262924,383665,215082,
268,0.0,1,137,131,406,35836,42909,634583,0.0033163941071360846,168583,1842,0.051400194328452505,19386,167,505,5,677,64137,0.01838378618992083,23523,0,-338,0,0.011773656997188676,0,84323,0,52866,12262,0,149451,31457,0.05583383876262924,383665,215082,
268,0.0,1,137,131,406,35836,42909,634583,0.0033163941071360846,168583,1842,0.051400194328452505,19386,167,505,5,677,64137,0.01838378618992083,23523,0,-338,0,0.011773656997188676,0,84323,0,52866,12262,0,149451,31457,0.05583383876262924,383665,215082,
268,0.0,1,137,131,406,35836,42909,634583,0.0033163941071360846,168583,1842,0.051400194328452505,19386,167,505,5,677,64137,0.01838378618992083,23523,0,-338,0,0.011773656997188676,0,84323,0,52866,12262,0,149451,31457,0.05583383876262924,383665,215082,
268,0.0,1,137,131,406,35836,42909,634583,0.0033163941071360846,168583,1842,0.051400194328452505,19386,460,102,0,562,64137,0.01838378618992083,23523,0,358,0,0.13233934518142446,0,84323,0,52866,12262,0,149451,31457,0.05583383876262924,383665,215082,
268,0.0,1,137,131,406,35836,42909,634583,0.0033163941071360846,168583,1842,0.051400194328452505,19386,460,102,0,562,64137,0.01838378618992083,23523,0,358,0,0.13233934518142446,0,84323,0,52866,12262,0,149451,31457,0.05583383876262924,383665,215082,
268,0.0,1,137,131,406,35836,42909,634583,0.0033163941071360846,168583,1842,0.051400194328452505,19386,460,102,0,562,64137,0.01838378618992083,23523,0,358,0,0.13233934518142446,0,84323,0,52866,12262,0,149451,31457,0.05583383876262924,383665,215082,
268,0.0,1,137,131,406,35836,42909,634583,0.0033163941071360846,168583,1842,0.051400194328452505,19386,460,102,0,562,64137,0.01838378618992083,23523,0,358,0,0.13233934518142446,0,84323,0,52866,12262,0,149451,31457,0.05583383876262924,383665,215082,
268,0.0,1,137,131,406,35836,42909,634583,0.0033163941071360846,168583,1842,0.051400194328452505,19386,171,108,73,352,64137,0.01838378618992083,23523,0,63,0,0.0049341438318201555,0,84323,0,52866,12262,0,149451,31457,0.05583383876262924,383665,215082,
268,0.0,1,137,131,406,35836,42909,634583,0.0033163941071360846,168583,1842,0.051400194328452505,19386,171,108,73,352,64137,0.01838378618992083,23523,0,63,0,0.0049341438318201555,0,84323,0,52866,12262,0,149451,31457,0.05583383876262924,383665,215082,
268,0.0,1,137,131,406,35836,42909,634583,0.0033163941071360846,168583,1842,0.051400194328452505,19386,171,108,73,352,64137,0.01838378618992083,23523,0,63,0,0.0049341438318201555,0,84323,0,52866,12262,0,149451,31457,0.05583383876262924,383665,215082,
268,0.0,1,137,131,406,35836,42909,634583,0.0033163941071360846,168583,1842,0.051400194328452505,19386,560,62,0,622,64137,0.01838378618992083,23523,0,498,0,0.016022896130518775,0,84323,0,52866,12262,0,149451,31457,0.05583383876262924,383665,215082,
268,0.0,1,137,131,406,35836,42909,634583,0.0033163941071360846,168583,1842,0.051400194328452505,19386,560,62,0,622,64137,0.01838378618992083,23523,0,498,0,0.016022896130518775,0,84323,0,52866,12262,0,149451,31457,0.05583383876262924,383665,215082,
268,0.0,1,137,131,406,35836,42909,634583,0.0033163941071360846,168583,1842,0.051400194328452505,19386,560,62,0,622,64137,0.01838378618992083,23523,0,498,0,0.016022896130518775,0,84323,0,52866,12262,0,149451,31457,0.05583383876262924,383665,215082,
268,0.0,1,137,131,406,35836,42909,634583,0.0033163941071360846,168583,1842,0.051400194328452505,19386,359,276,11,646,64137,0.01838378618992083,23523,0,83,0,0.028342474560881226,0,84323,0,52866,12262,0,149451,31457,0.05583383876262924,383665,215082,
268,0.0,1,137,131,406,35836,42909,634583,0.0033163941071360846,168583,1842,0.051400194328452505,19386,359,276,11,646,64137,0.01838378618992083,23523,0,83,0,0.028342474560881226,0,84323,0,52866,12262,0,149451,31457,0.05583383876262924,383665,215082,
268,0.0,1,137,131,406,35836,42909,634583,0.0033163941071360846,168583,1842,0.051400194328452505,19386,359,276,11,646,64137,0.01838378618992083,23523,0,83,0,0.028342474560881226,0,84323,0,52866,12262,0,149451,31457,0.05583383876262924,383665,215082,
268,0.0,1,137,131,406,35836,42909,634583,0.0033163941071360846,168583,1842,0.051400194328452505,19386,442,46,0,488,64137,0.01838378618992083,23523,0,396,0,0.011875825244738345,0,84323,0,52866,12262,0,149451,31457,0.05583383876262924,383665,215082,
268,0.0,1,137,131,406,35836,42909,634583,0.0033163941071360846,168583,1842,0.051400194328452505,19386,442,46,0,488,64137,0.01838378618992083,23523,0,396,0,0.011875825244738345,0,84323,0,52866,12262,0,149451,31457,0.05583383876262924,383665,215082,
268,0.0,1,137,131,406,35836,42909,634583,0.0033163941071360846,168583,1842,0.051400194328452505,19386,442,46,0,488,64137,0.01838378618992083,23523,0,396,0,0.011875825244738345,0,84323,0,52866,12262,0,149451,31457,0.05583383876262924,383665,215082,
268,0.0,1,137,131,406,35836,42909,634583,0.0033163941071360846,168583,1842,0.051400194328452505,19386,695,150,50,895,64137,0.01838378618992083,23523,0,545,0,0.023132821742193308,0,84323,0,52866,12262,0,149451,31457,0.05583383876262924,383665,215082,
268,0.0,1,137,131,406,35836,42909,634583,0.0033163941071360846,168583,1842,0.051400194328452505,19386,695,150,50,895,64137,0.01838378618992083,23523,0,545,0,0.023132821742193308,0,84323,0,52866,12262,0,149451,31457,0.05583383876262924,383665,215082,
268,0.0,1,137,131,406,35836,42909,634583,0.0033163941071360846,168583,1842,0.051400194328452505,19386,695,150,50,895,64137,0.01838378618992083,23523,0,545,0,0.023132821742193308,0,84323,0,52866,12262,0,149451,31457,0.05583383876262924,383665,215082,
268,0.0,1,137,131,406,35836,42909,634583,0.0033163941071360846,168583,1842,0.051400194328452505,19386,95,458,0,553,64137,0.01838378618992083,23523,0,-363,0,0.010416468806001094,0,84323,0,52866,12262,0,149451,31457,0.05583383876262924,383665,215082,
268,0.0,1,137,131,406,35836,42909,634583,0.0033163941071360846,168583,1842,0.051400194328452505,19386,95,458,0,553,64137,0.01838378618992083,23523,0,-363,0,0.010416468806001094,0,84323,0,52866,12262,0,149451,31457,0.05583383876262924,383665,215082,
268,0.0,1,137,131,406,35836,42909,634583,0.0033163941071360846,168583,1842,0.051400194328452505,19386,95,458,0,553,64137,0.01838378618992083,23523,0,-363,0,0.010416468806001094,0,84323,0,52866,12262,0,149451,31457,0.05583383876262924,383665,215082,
268,0.0,1,137,131,406,35836,42909,634583,0.0033163941071360846,168583,1842,0.051400194328452505,19386,1188,763,2,1953,64137,0.01838378618992083,23523,0,425,0,0.06737963370378139,0,84323,0,52866,12262,0,149451,31457,0.05583383876262924,383665,215082,
268,0.0,1,137,131,406,35836,42909,634583,0.0033163941071360846,168583,1842,0.051400194328452505,19386,1188,763,2,1953,64137,0.01838378618992083,23523,0,425,0,0.06737963370378139,0,84323,0,52866,12262,0,149451,31457,0.05583383876262924,383665,215082,
268,0.0,1,137,131,406,35836,42909,634583,0.0033163941071360846,168583,1842,0.051400194328452505,19386,1188,763,2,1953,64137,0.01838378618992083,23523,0,425,0,0.06737963370378139,0,84323,0,52866,12262,0,149451,31457,0.05583383876262924,383665,215082,
268,0.0,1,137,131,406,35836,42909,634583,0.0033163941071360846,168583,1842,0.051400194328452505,19386,1780,0,0,1780,64137,0.01838378618992083,23523,0,1780,0,0.13281520846212524,0,84323,0,52866,12262,0,149451,31457,0.05583383876262924,383665,215082,
268,0.0,1,137,131,406,35836,42909,634583,0.0033163941071360846,168583,1842,0.051400194328452505,19386,1780,0,0,1780,64137,0.01838378618992083,23523,0,1780,0,0.13281520846212524,0,84323,0,52866,12262,0,149451,31457,0.05583383876262924,383665,215082,
268,0.0,1,137,131,406,35836,42909,634583,0.0033163941071360846,168583,1842,0.051400194328452505,19386,1780,0,0,1780,64137,0.01838378618992083,23523,0,1780,0,0.13281520846212524,0,84323,0,52866,12262,0,149451,31457,0.05583383876262924,383665,215082,
268,0.0,1,137,131,406,35836,42909,634583,0.0033163941071360846,168583,1842,0.051400194328452505,19386,130,294,0,424,64137,0.01838378618992083,23523,0,-164,0,0.04813781446021607,0,84323,0,52866,12262,0,149451,31457,0.05583383876262924,383665,215082,
268,0.0,1,137,131,406,35836,42909,634583,0.0033163941071360846,168583,1842,0.051400194328452505,19386,130,294,0,424,64137,0.01838378618992083,23523,0,-164,0,0.04813781446021607,0,84323,0,52866,12262,0,149451,31457,0.05583383876262924,383665,215082,
268,0.0,1,137,131,406,35836,42909,634583,0.0033163941071360846,168583,1842,0.051400194328452505,19386,130,294,0,424,64137,0.01838378618992083,23523,0,-164,0,0.04813781446021607,0,84323,0,52866,12262,0,149451,31457,0.05583383876262924,383665,215082,
268,0.0,1,137,131,406,35836,42909,634583,0.0033163941071360846,168583,1842,0.051400194328452505,19386,130,294,0,424,64137,0.01838378618992083,23523,0,-164,0,0.04813781446021607,0,84323,0,52866,12262,0,149451,31457,0.05583383876262924,383665,215082,
268,0.0,1,137,131,406,35836,42909,634583,0.0033163941071360846,168583,1842,0.051400194328452505,19386,130,294,0,424,64137,0.01838378618992083,23523,0,-164,0,0.04813781446021607,0,84323,0,52866,12262,0,149451,31457,0.05583383876262924,383665,215082,
268,0.0,1,137,131,406,35836,42909,634583,0.0033163941071360846,168583,1842,0.051400194328452505,19386,130,294,0,424,64137,0.01838378618992083,23523,0,-164,0,0.04813781446021607,0,84323,0,52866,12262,0,149451,31457,0.05583383876262924,383665,215082,
268,0.0,1,137,131,406,35836,42909,634583,0.0033163941071360846,168583,1842,0.051400194328452505,19386,130,294,0,424,64137,0.01838378618992083,23523,0,-164,0,0.04813781446021607,0,84323,0,52866,12262,0,149451,31457,0.05583383876262924,383665,215082,
268,0.0,1,137,131,406,35836,42909,634583,0.0033163941071360846,168583,1842,0.051400194328452505,19386,130,294,0,424,64137,0.01838378618992083,23523,0,-164,0,0.04813781446021607,0,84323,0,52866,12262,0,149451,31457,0.05583383876262924,383665,215082,
268,0.0,1,137,131,406,35836,42909,634583,0.0033163941071360846,168583,1842,0.051400194328452505,19386,487,432,21,940,64137,0.01838378618992083,23523,0,55,0,0.008419601116209178,0,84323,0,52866,12262,0,149451,31457,0.05583383876262924,383665,215082,
268,0.0,1,137,131,406,35836,42909,634583,0.0033163941071360846,168583,1842,0.051400194328452505,19386,487,432,21,940,64137,0.01838378618992083,23523,0,55,0,0.008419601116209178,0,84323,0,52866,12262,0,149451,31457,0.05583383876262924,383665,215082,
268,0.0,1,137,131,406,35836,42909,634583,0.0033163941071360846,168583,1842,0.051400194328452505,19386,487,432,21,940,64137,0.01838378618992083,23523,0,55,0,0.008419601116209178,0,84323,0,52866,12262,0,149451,31457,0.05583383876262924,383665,215082,
268,0.0,1,137,131,406,35836,42909,634583,0.0033163941071360846,168583,1842,0.051400194328452505,19386,257,179,2,438,64137,0.01838378618992083,23523,0,78,0,0.019334316607573444,0,84323,0,52866,12262,0,149451,31457,0.05583383876262924,383665,215082,
268,0.0,1,137,131,406,35836,42909,634583,0.0033163941071360846,168583,1842,0.051400194328452505,19386,257,179,2,438,64137,0.01838378618992083,23523,0,78,0,0.019334316607573444,0,84323,0,52866,12262,0,149451,31457,0.05583383876262924,383665,215082,
268,0.0,1,137,131,406,35836,42909,634583,0.0033163941071360846,168583,1842,0.051400194328452505,19386,257,179,2,438,64137,0.01838378618992083,23523,0,78,0,0.019334316607573444,0,84323,0,52866,12262,0,149451,31457,0.05583383876262924,383665,215082,
268,0.0,1,137,131,406,35836,42909,634583,0.0033163941071360846,168583,1842,0.051400194328452505,19386,257,179,2,438,64137,0.01838378618992083,23523,0,78,0,0.019334316607573444,0,84323,0,52866,12262,0,149451,31457,0.05583383876262924,383665,215082,
268,0.0,1,137,131,406,35836,42909,634583,0.0033163941071360846,168583,1842,0.051400194328452505,19386,257,179,2,438,64137,0.01838378618992083,23523,0,78,0,0.019334316607573444,0,84323,0,52866,12262,0,149451,31457,0.05583383876262924,383665,215082,
268,0.0,1,137,131,406,35836,42909,634583,0.0033163941071360846,168583,1842,0.051400194328452505,19386,257,179,2,438,64137,0.01838378618992083,23523,0,78,0,0.019334316607573444,0,84323,0,52866,12262,0,149451,31457,0.05583383876262924,383665,215082,
268,0.0,1,137,131,406,35836,42909,634583,0.0033163941071360846,168583,1842,0.051400194328452505,19386,257,179,2,438,64137,0.01838378618992083,23523,0,78,0,0.019334316607573444,0,84323,0,52866,12262,0,149451,31457,0.05583383876262924,383665,215082,
268,0.0,1,137,131,406,35836,42909,634583,0.0033163941071360846,168583,1842,0.051400194328452505,19386,192,31,0,223,64137,0.01838378618992083,23523,0,161,0,0.01694210022151688,0,84323,0,52866,12262,0,149451,31457,0.05583383876262924,383665,215082,
268,0.0,1,137,131,406,35836,42909,634583,0.0033163941071360846,168583,1842,0.051400194328452505,19386,192,31,0,223,64137,0.01838378618992083,23523,0,161,0,0.01694210022151688,0,84323,0,52866,12262,0,149451,31457,0.05583383876262924,383665,215082,
268,0.0,1,137,131,406,35836,42909,634583,0.0033163941071360846,168583,1842,0.051400194328452505,19386,192,31,0,223,64137,0.01838378618992083,23523,0,161,0,0.01694210022151688,0,84323,0,52866,12262,0,149451,31457,0.05583383876262924,383665,215082,
268,0.0,1,137,131,406,35836,42909,634583,0.0033163941071360846,168583,1842,0.051400194328452505,19386,192,31,0,223,64137,0.01838378618992083,23523,0,161,0,0.01694210022151688,0,84323,0,52866,12262,0,149451,31457,0.05583383876262924,383665,215082,
268,0.0,1,137,131,406,35836,42909,634583,0.0033163941071360846,168583,1842,0.051400194328452505,19386,192,31,0,223,64137,0.01838378618992083,23523,0,161,0,0.01694210022151688,0,84323,0,52866,12262,0,149451,31457,0.05583383876262924,383665,215082,
268,0.0,1,137,131,406,35836,42909,634583,0.0033163941071360846,168583,1842,0.051400194328452505,19386,192,31,0,223,64137,0.01838378618992083,23523,0,161,0,0.01694210022151688,0,84323,0,52866,12262,0,149451,31457,0.05583383876262924,383665,215082,
268,0.0,1,137,131,406,35836,42909,634583,0.0033163941071360846,168583,1842,0.051400194328452505,19386,192,31,0,223,64137,0.01838378618992083,23523,0,161,0,0.01694210022151688,0,84323,0,52866,12262,0,149451,31457,0.05583383876262924,383665,215082,
268,0.0,1,137,131,406,35836,42909,634583,0.0033163941071360846,168583,1842,0.051400194328452505,19386,167,451,2,620,64137,0.01838378618992083,23523,0,-284,0,0.009422920735794841,0,84323,0,52866,12262,0,149451,31457,0.05583383876262924,383665,215082,
268,0.0,1,137,131,406,35836,42909,634583,0.0033163941071360846,168583,1842,0.051400194328452505,19386,167,451,2,620,64137,0.01838378618992083,23523,0,-284,0,0.009422920735794841,0,84323,0,52866,12262,0,149451,31457,0.05583383876262924,383665,215082,
268,0.0,1,137,131,406,35836,42909,634583,0.0033163941071360846,168583,1842,0.051400194328452505,19386,167,451,2,620,64137,0.01838378618992083,23523,0,-284,0,0.009422920735794841,0,84323,0,52866,12262,0,149451,31457,0.05583383876262924,383665,215082,
268,0.0,1,137,131,406,35836,42909,634583,0.0033163941071360846,168583,1842,0.051400194328452505,19386,303,607,1,911,64137,0.01838378618992083,23523,0,-304,0,0.018446022513876704,0,84323,0,52866,12262,0,149451,31457,0.05583383876262924,383665,215082,
268,0.0,1,137,131,406,35836,42909,634583,0.0033163941071360846,168583,1842,0.051400194328452505,19386,303,607,1,911,64137,0.01838378618992083,23523,0,-304,0,0.018446022513876704,0,84323,0,52866,12262,0,149451,31457,0.05583383876262924,383665,215082,
268,0.0,1,137,131,406,35836,42909,634583,0.0033163941071360846,168583,1842,0.051400194328452505,19386,303,607,1,911,64137,0.01838378618992083,23523,0,-304,0,0.018446022513876704,0,84323,0,52866,12262,0,149451,31457,0.05583383876262924,383665,215082,
268,0.0,1,137,131,406,35836,42909,634583,0.0033163941071360846,168583,1842,0.051400194328452505,19386,515,427,27,969,64137,0.01838378618992083,23523,0,88,0,0.01616129167672354,0,84323,0,52866,12262,0,149451,31457,0.05583383876262924,383665,215082,
268,0.0,1,137,131,406,35836,42909,634583,0.0033163941071360846,168583,1842,0.051400194328452505,19386,515,427,27,969,64137,0.01838378618992083,23523,0,88,0,0.01616129167672354,0,84323,0,52866,12262,0,149451,31457,0.05583383876262924,383665,215082,
268,0.0,1,137,131,406,35836,42909,634583,0.0033163941071360846,168583,1842,0.051400194328452505,19386,515,427,27,969,64137,0.01838378618992083,23523,0,88,0,0.01616129167672354,0,84323,0,52866,12262,0,149451,31457,0.05583383876262924,383665,215082,
268,0.0,1,137,131,406,35836,42909,634583,0.0033163941071360846,168583,1842,0.051400194328452505,19386,7,5,0,12,64137,0.01838378618992083,23523,0,2,0,0.013390115876002773,0,84323,0,52866,12262,0,149451,31457,0.05583383876262924,383665,215082,
268,0.0,1,137,131,406,35836,42909,634583,0.0033163941071360846,168583,1842,0.051400194328452505,19386,251,262,30,543,64137,0.01838378618992083,23523,0,-11,0,0.03429005382400407,0,84323,0,52866,12262,0,149451,31457,0.05583383876262924,383665,215082,
268,0.0,1,137,131,406,35836,42909,634583,0.0033163941071360846,168583,1842,0.051400194328452505,19386,251,262,30,543,64137,0.01838378618992083,23523,0,-11,0,0.03429005382400407,0,84323,0,52866,12262,0,149451,31457,0.05583383876262924,383665,215082,
268,0.0,1,137,131,406,35836,42909,634583,0.0033163941071360846,168583,1842,0.051400194328452505,19386,251,262,30,543,64137,0.01838378618992083,23523,0,-11,0,0.03429005382400407,0,84323,0,52866,12262,0,149451,31457,0.05583383876262924,383665,215082,
268,0.0,1,137,131,406,35836,42909,634583,0.0033163941071360846,168583,1842,0.051400194328452505,19386,512,178,3,693,64137,0.01838378618992083,23523,0,334,0,0.018677541495202874,0,84323,0,52866,12262,0,149451,31457,0.05583383876262924,383665,215082,
268,0.0,1,137,131,406,35836,42909,634583,0.0033163941071360846,168583,1842,0.051400194328452505,19386,512,178,3,693,64137,0.01838378618992083,23523,0,334,0,0.018677541495202874,0,84323,0,52866,12262,0,149451,31457,0.05583383876262924,383665,215082,
268,0.0,1,137,131,406,35836,42909,634583,0.0033163941071360846,168583,1842,0.051400194328452505,19386,512,178,3,693,64137,0.01838378618992083,23523,0,334,0,0.018677541495202874,0,84323,0,52866,12262,0,149451,31457,0.05583383876262924,383665,215082,
268,0.0,1,137,131,406,35836,42909,634583,0.0033163941071360846,168583,1842,0.051400194328452505,19386,479,18,0,497,64137,0.01838378618992083,23523,0,461,0,0.07077446117342194,0,84323,0,52866,12262,0,149451,31457,0.05583383876262924,383665,215082,
268,0.0,1,137,131,406,35836,42909,634583,0.0033163941071360846,168583,1842,0.051400194328452505,19386,479,18,0,497,64137,0.01838378618992083,23523,0,461,0,0.07077446117342194,0,84323,0,52866,12262,0,149451,31457,0.05583383876262924,383665,215082,
268,0.0,1,137,131,406,35836,42909,634583,0.0033163941071360846,168583,1842,0.051400194328452505,19386,479,18,0,497,64137,0.01838378618992083,23523,0,461,0,0.07077446117342194,0,84323,0,52866,12262,0,149451,31457,0.05583383876262924,383665,215082,
268,0.0,1,137,131,406,35836,42909,634583,0.0033163941071360846,168583,1842,0.051400194328452505,19386,92,230,16,338,64137,0.01838378618992083,23523,0,-138,0,0.006643917948547717,0,84323,0,52866,12262,0,149451,31457,0.05583383876262924,383665,215082,
268,0.0,1,137,131,406,35836,42909,634583,0.0033163941071360846,168583,1842,0.051400194328452505,19386,92,230,16,338,64137,0.01838378618992083,23523,0,-138,0,0.006643917948547717,0,84323,0,52866,12262,0,149451,31457,0.05583383876262924,383665,215082,
268,0.0,1,137,131,406,35836,42909,634583,0.0033163941071360846,168583,1842,0.051400194328452505,19386,92,230,16,338,64137,0.01838378618992083,23523,0,-138,0,0.006643917948547717,0,84323,0,52866,12262,0,149451,31457,0.05583383876262924,383665,215082,
268,0.0,1,137,131,406,35836,42909,634583,0.0033163941071360846,168583,1842,0.051400194328452505,19386,92,230,16,338,64137,0.01838378618992083,23523,0,-138,0,0.006643917948547717,0,84323,0,52866,12262,0,149451,31457,0.05583383876262924,383665,215082,
268,0.0,1,137,131,406,35836,42909,634583,0.0033163941071360846,168583,1842,0.051400194328452505,19386,92,230,16,338,64137,0.01838378618992083,23523,0,-138,0,0.006643917948547717,0,84323,0,52866,12262,0,149451,31457,0.05583383876262924,383665,215082,
268,0.0,1,137,131,406,35836,42909,634583,0.0033163941071360846,168583,1842,0.051400194328452505,19386,92,230,16,338,64137,0.01838378618992083,23523,0,-138,0,0.006643917948547717,0,84323,0,52866,12262,0,149451,31457,0.05583383876262924,383665,215082,
268,0.0,1,137,131,406,35836,42909,634583,0.0033163941071360846,168583,1842,0.051400194328452505,19386,92,230,16,338,64137,0.01838378618992083,23523,0,-138,0,0.006643917948547717,0,84323,0,52866,12262,0,149451,31457,0.05583383876262924,383665,215082,
268,0.0,1,137,131,406,35836,42909,634583,0.0033163941071360846,168583,1842,0.051400194328452505,19386,6,6,0,12,64137,0.01838378618992083,23523,0,0,0,0.0030619202936166753,0,84323,0,52866,12262,0,149451,31457,0.05583383876262924,383665,215082,
276,0.0,5,72,204,353,35836,42909,634583,0.00839335429057448,168583,1842,0.051400194328452505,19386,109,4,0,113,64137,0.01838378618992083,23523,0,105,0,0.31547619047619047,0,6167,0,4517,479,0,11163,1650,0.0447589358721208,383665,215082,
276,0.0,5,72,204,353,35836,42909,634583,0.00839335429057448,168583,1842,0.051400194328452505,19386,109,4,0,113,64137,0.01838378618992083,23523,0,105,0,0.31547619047619047,0,6167,0,4517,479,0,11163,1650,0.0447589358721208,383665,215082,
276,0.0034071550255536627,5,72,204,353,35836,42909,634583,0.00839335429057448,168583,1842,0.051400194328452505,19386,292,278,50,620,64137,0.01838378618992083,23523,1,14,1,0.07574085783905396,2,6167,0,4517,479,0,11163,1650,0.0447589358721208,383665,215082,
276,0.0034071550255536627,5,72,204,353,35836,42909,634583,0.00839335429057448,168583,1842,0.051400194328452505,19386,292,278,50,620,64137,0.01838378618992083,23523,1,14,1,0.07574085783905396,2,6167,0,4517,479,0,11163,1650,0.0447589358721208,383665,215082,
276,0.0034071550255536627,5,72,204,353,35836,42909,634583,0.00839335429057448,168583,1842,0.051400194328452505,19386,292,278,50,620,64137,0.01838378618992083,23523,1,14,1,0.07574085783905396,2,6167,0,4517,479,0,11163,1650,0.0447589358721208,383665,215082,
276,0.0034071550255536627,5,72,204,353,35836,42909,634583,0.00839335429057448,168583,1842,0.051400194328452505,19386,292,278,50,620,64137,0.01838378618992083,23523,1,14,1,0.07574085783905396,2,6167,0,4517,479,0,11163,1650,0.0447589358721208,383665,215082,
276,0.0034071550255536627,5,72,204,353,35836,42909,634583,0.00839335429057448,168583,1842,0.051400194328452505,19386,292,278,50,620,64137,0.01838378618992083,23523,1,14,1,0.07574085783905396,2,6167,0,4517,479,0,11163,1650,0.0447589358721208,383665,215082,
276,0.0034071550255536627,5,72,204,353,35836,42909,634583,0.00839335429057448,168583,1842,0.051400194328452505,19386,292,278,50,620,64137,0.01838378618992083,23523,1,14,1,0.07574085783905396,2,6167,0,4517,479,0,11163,1650,0.0447589358721208,383665,215082,
276,0.0034071550255536627,5,72,204,353,35836,42909,634583,0.00839335429057448,168583,1842,0.051400194328452505,19386,292,278,50,620,64137,0.01838378618992083,23523,1,14,1,0.07574085783905396,2,6167,0,4517,479,0,11163,1650,0.0447589358721208,383665,215082,
276,0.0034071550255536627,5,72,204,353,35836,42909,634583,0.00839335429057448,168583,1842,0.051400194328452505,19386,292,278,50,620,64137,0.01838378618992083,23523,1,14,1,0.07574085783905396,2,6167,0,4517,479,0,11163,1650,0.0447589358721208,383665,215082,
276,0.0034071550255536627,5,72,204,353,35836,42909,634583,0.00839335429057448,168583,1842,0.051400194328452505,19386,292,278,50,620,64137,0.01838378618992083,23523,1,14,1,0.07574085783905396,2,6167,0,4517,479,0,11163,1650,0.0447589358721208,383665,215082,
276,0.03038912448157945,5,72,204,353,35836,42909,634583,0.00839335429057448,168583,1842,0.051400194328452505,19386,1124,730,91,1945,64137,0.01838378618992083,23523,45,394,44,0.05628296519002976,89,6167,0,4517,479,-1,11163,1650,0.0447589358721208,383665,215082,
276,0.03038912448157945,5,72,204,353,35836,42909,634583,0.00839335429057448,168583,1842,0.051400194328452505,19386,1124,730,91,1945,64137,0.01838378618992083,23523,45,394,44,0.05628296519002976,89,6167,0,4517,479,-1,11163,1650,0.0447589358721208,383665,215082,
276,0.07981845930947727,5,72,204,353,35836,42909,634583,0.00839335429057448,168583,1842,0.051400194328452505,19386,2313,121,42,2476,64137,0.01838378618992083,23523,2,2192,17,0.14268878502278323,24,6167,5,4517,479,15,11163,1650,0.0447589358721208,383665,215082,
276,0.07981845930947727,5,72,204,353,35836,42909,634583,0.00839335429057448,168583,1842,0.051400194328452505,19386,2313,121,42,2476,64137,0.01838378618992083,23523,2,2192,17,0.14268878502278323,24,6167,5,4517,479,15,11163,1650,0.0447589358721208,383665,215082,
276,0.07981845930947727,5,72,204,353,35836,42909,634583,0.00839335429057448,168583,1842,0.051400194328452505,19386,2313,121,42,2476,64137,0.01838378618992083,23523,2,2192,17,0.14268878502278323,24,6167,5,4517,479,15,11163,1650,0.0447589358721208,383665,215082,
276,0.07981845930947727,5,72,204,353,35836,42909,634583,0.00839335429057448,168583,1842,0.051400194328452505,19386,2313,121,42,2476,64137,0.01838378618992083,23523,2,2192,17,0.14268878502278323,24,6167,5,4517,479,15,11163,1650,0.0447589358721208,383665,215082,
276,0.07981845930947727,5,72,204,353,35836,42909,634583,0.00839335429057448,168583,1842,0.051400194328452505,19386,2313,121,42,2476,64137,0.01838378618992083,23523,2,2192,17,0.14268878502278323,24,6167,5,4517,479,15,11163,1650,0.0447589358721208,383665,215082,
276,0.07981845930947727,5,72,204,353,35836,42909,634583,0.00839335429057448,168583,1842,0.051400194328452505,19386,2313,121,42,2476,64137,0.01838378618992083,23523,2,2192,17,0.14268878502278323,24,6167,5,4517,479,15,11163,1650,0.0447589358721208,383665,215082,
276,0.07981845930947727,5,72,204,353,35836,42909,634583,0.00839335429057448,168583,1842,0.051400194328452505,19386,2313,121,42,2476,64137,0.01838378618992083,23523,2,2192,17,0.14268878502278323,24,6167,5,4517,479,15,11163,1650,0.0447589358721208,383665,215082,
276,0.07981845930947727,5,72,204,353,35836,42909,634583,0.00839335429057448,168583,1842,0.051400194328452505,19386,2313,121,42,2476,64137,0.01838378618992083,23523,2,2192,17,0.14268878502278323,24,6167,5,4517,479,15,11163,1650,0.0447589358721208,383665,215082,
276,0.07981845930947727,5,72,204,353,35836,42909,634583,0.00839335429057448,168583,1842,0.051400194328452505,19386,2313,121,42,2476,64137,0.01838378618992083,23523,2,2192,17,0.14268878502278323,24,6167,5,4517,479,15,11163,1650,0.0447589358721208,383665,215082,
276,0.07981845930947727,5,72,204,353,35836,42909,634583,0.00839335429057448,168583,1842,0.051400194328452505,19386,2313,121,42,2476,64137,0.01838378618992083,23523,2,2192,17,0.14268878502278323,24,6167,5,4517,479,15,11163,1650,0.0447589358721208,383665,215082,
276,0.07981845930947727,5,72,204,353,35836,42909,634583,0.00839335429057448,168583,1842,0.051400194328452505,19386,2313,121,42,2476,64137,0.01838378618992083,23523,2,2192,17,0.14268878502278323,24,6167,5,4517,479,15,11163,1650,0.0447589358721208,383665,215082,
276,0.0,5,72,204,353,35836,42909,634583,0.00839335429057448,168583,1842,0.051400194328452505,19386,363,469,6,838,64137,0.01838378618992083,23523,0,-106,0,0.044055192967058183,0,6167,0,4517,479,0,11163,1650,0.0447589358721208,383665,215082,
276,0.0,5,72,204,353,35836,42909,634583,0.00839335429057448,168583,1842,0.051400194328452505,19386,363,469,6,838,64137,0.01838378618992083,23523,0,-106,0,0.044055192967058183,0,6167,0,4517,479,0,11163,1650,0.0447589358721208,383665,215082,
276,0.0,5,72,204,353,35836,42909,634583,0.00839335429057448,168583,1842,0.051400194328452505,19386,363,469,6,838,64137,0.01838378618992083,23523,0,-106,0,0.044055192967058183,0,6167,0,4517,479,0,11163,1650,0.0447589358721208,383665,215082,
276,0.0,5,72,204,353,35836,42909,634583,0.00839335429057448,168583,1842,0.051400194328452505,19386,363,469,6,838,64137,0.01838378618992083,23523,0,-106,0,0.044055192967058183,0,6167,0,4517,479,0,11163,1650,0.0447589358721208,383665,215082,
276,0.0,5,72,204,353,35836,42909,634583,0.00839335429057448,168583,1842,0.051400194328452505,19386,363,469,6,838,64137,0.01838378618992083,23523,0,-106,0,0.044055192967058183,0,6167,0,4517,479,0,11163,1650,0.0447589358721208,383665,215082,
276,0.0,5,72,204,353,35836,42909,634583,0.00839335429057448,168583,1842,0.051400194328452505,19386,363,469,6,838,64137,0.01838378618992083,23523,0,-106,0,0.044055192967058183,0,6167,0,4517,479,0,11163,1650,0.0447589358721208,383665,215082,
276,0.0,5,72,204,353,35836,42909,634583,0.00839335429057448,168583,1842,0.051400194328452505,19386,363,469,6,838,64137,0.01838378618992083,23523,0,-106,0,0.044055192967058183,0,6167,0,4517,479,0,11163,1650,0.0447589358721208,383665,215082,
276,0.0,5,72,204,353,35836,42909,634583,0.00839335429057448,168583,1842,0.051400194328452505,19386,363,469,6,838,64137,0.01838378618992083,23523,0,-106,0,0.044055192967058183,0,6167,0,4517,479,0,11163,1650,0.0447589358721208,383665,215082,
276,0.0,5,72,204,353,35836,42909,634583,0.00839335429057448,168583,1842,0.051400194328452505,19386,363,469,6,838,64137,0.01838378618992083,23523,0,-106,0,0.044055192967058183,0,6167,0,4517,479,0,11163,1650,0.0447589358721208,383665,215082,
276,0.0,5,72,204,353,35836,42909,634583,0.00839335429057448,168583,1842,0.051400194328452505,19386,363,469,6,838,64137,0.01838378618992083,23523,0,-106,0,0.044055192967058183,0,6167,0,4517,479,0,11163,1650,0.0447589358721208,383665,215082,
276,0.0,5,72,204,353,35836,42909,634583,0.00839335429057448,168583,1842,0.051400194328452505,19386,363,469,6,838,64137,0.01838378618992083,23523,0,-106,0,0.044055192967058183,0,6167,0,4517,479,0,11163,1650,0.0447589358721208,383665,215082,
276,0.0,5,72,204,353,35836,42909,634583,0.00839335429057448,168583,1842,0.051400194328452505,19386,363,469,6,838,64137,0.01838378618992083,23523,0,-106,0,0.044055192967058183,0,6167,0,4517,479,0,11163,1650,0.0447589358721208,383665,215082,
276,0.0,5,72,204,353,35836,42909,634583,0.00839335429057448,168583,1842,0.051400194328452505,19386,363,469,6,838,64137,0.01838378618992083,23523,0,-106,0,0.044055192967058183,0,6167,0,4517,479,0,11163,1650,0.0447589358721208,383665,215082,
276,0.0,5,72,204,353,35836,42909,634583,0.00839335429057448,168583,1842,0.051400194328452505,19386,363,469,6,838,64137,0.01838378618992083,23523,0,-106,0,0.044055192967058183,0,6167,0,4517,479,0,11163,1650,0.0447589358721208,383665,215082,
276,0.0,5,72,204,353,35836,42909,634583,0.00839335429057448,168583,1842,0.051400194328452505,19386,363,469,6,838,64137,0.01838378618992083,23523,0,-106,0,0.044055192967058183,0,6167,0,4517,479,0,11163,1650,0.0447589358721208,383665,215082,
276,0.0,5,72,204,353,35836,42909,634583,0.00839335429057448,168583,1842,0.051400194328452505,19386,363,469,6,838,64137,0.01838378618992083,23523,0,-106,0,0.044055192967058183,0,6167,0,4517,479,0,11163,1650,0.0447589358721208,383665,215082,
276,0.0,5,72,204,353,35836,42909,634583,0.00839335429057448,168583,1842,0.051400194328452505,19386,503,1161,106,1770,64137,0.01838378618992083,23523,0,-658,0,0.06504211699557044,0,6167,0,4517,479,0,11163,1650,0.0447589358721208,383665,215082,
276,0.0,5,72,204,353,35836,42909,634583,0.00839335429057448,168583,1842,0.051400194328452505,19386,503,1161,106,1770,64137,0.01838378618992083,23523,0,-658,0,0.06504211699557044,0,6167,0,4517,479,0,11163,1650,0.0447589358721208,383665,215082,
276,0.0,5,72,204,353,35836,42909,634583,0.00839335429057448,168583,1842,0.051400194328452505,19386,503,1161,106,1770,64137,0.01838378618992083,23523,0,-658,0,0.06504211699557044,0,6167,0,4517,479,0,11163,1650,0.0447589358721208,383665,215082,
276,0.0,5,72,204,353,35836,42909,634583,0.00839335429057448,168583,1842,0.051400194328452505,19386,503,1161,106,1770,64137,0.01838378618992083,23523,0,-658,0,0.06504211699557044,0,6167,0,4517,479,0,11163,1650,0.0447589358721208,383665,215082,
276,9.94530084535057E-4,5,72,204,353,35836,42909,634583,0.00839335429057448,168583,1842,0.051400194328452505,19386,10,2,2,14,64137,0.01838378618992083,23523,1,8,1,0.12294624463410427,2,6167,0,4517,479,0,11163,1650,0.0447589358721208,383665,215082,
276,0.002676068666136403,5,72,204,353,35836,42909,634583,0.00839335429057448,168583,1842,0.051400194328452505,19386,93,43,9,145,64137,0.01838378618992083,23523,6,50,6,0.04286076727098882,12,6167,0,4517,479,0,11163,1650,0.0447589358721208,383665,215082,
276,0.002676068666136403,5,72,204,353,35836,42909,634583,0.00839335429057448,168583,1842,0.051400194328452505,19386,93,43,9,145,64137,0.01838378618992083,23523,6,50,6,0.04286076727098882,12,6167,0,4517,479,0,11163,1650,0.0447589358721208,383665,215082,
276,0.002676068666136403,5,72,204,353,35836,42909,634583,0.00839335429057448,168583,1842,0.051400194328452505,19386,93,43,9,145,64137,0.01838378618992083,23523,6,50,6,0.04286076727098882,12,6167,0,4517,479,0,11163,1650,0.0447589358721208,383665,215082,
276,0.002676068666136403,5,72,204,353,35836,42909,634583,0.00839335429057448,168583,1842,0.051400194328452505,19386,93,43,9,145,64137,0.01838378618992083,23523,6,50,6,0.04286076727098882,12,6167,0,4517,479,0,11163,1650,0.0447589358721208,383665,215082,
276,0.005223440375366374,5,72,204,353,35836,42909,634583,0.00839335429057448,168583,1842,0.051400194328452505,19386,24,18,0,42,64137,0.01838378618992083,23523,7,6,2,0.05193819598477709,9,6167,0,4517,479,-5,11163,1650,0.0447589358721208,383665,215082,
276,0.005223440375366374,5,72,204,353,35836,42909,634583,0.00839335429057448,168583,1842,0.051400194328452505,19386,24,18,0,42,64137,0.01838378618992083,23523,7,6,2,0.05193819598477709,9,6167,0,4517,479,-5,11163,1650,0.0447589358721208,383665,215082,
276,0.005223440375366374,5,72,204,353,35836,42909,634583,0.00839335429057448,168583,1842,0.051400194328452505,19386,24,18,0,42,64137,0.01838378618992083,23523,7,6,2,0.05193819598477709,9,6167,0,4517,479,-5,11163,1650,0.0447589358721208,383665,215082,
276,0.005223440375366374,5,72,204,353,35836,42909,634583,0.00839335429057448,168583,1842,0.051400194328452505,19386,24,18,0,42,64137,0.01838378618992083,23523,7,6,2,0.05193819598477709,9,6167,0,4517,479,-5,11163,1650,0.0447589358721208,383665,215082,
276,0.0017870067670864482,5,72,204,353,35836,42909,634583,0.00839335429057448,168583,1842,0.051400194328452505,19386,10,13,0,23,64137,0.01838378618992083,23523,4,-3,4,0.025237121118501665,8,6167,0,4517,479,0,11163,1650,0.0447589358721208,383665,215082,
276,0.0017870067670864482,5,72,204,353,35836,42909,634583,0.00839335429057448,168583,1842,0.051400194328452505,19386,10,13,0,23,64137,0.01838378618992083,23523,4,-3,4,0.025237121118501665,8,6167,0,4517,479,0,11163,1650,0.0447589358721208,383665,215082,
276,0.0017870067670864482,5,72,204,353,35836,42909,634583,0.00839335429057448,168583,1842,0.051400194328452505,19386,10,13,0,23,64137,0.01838378618992083,23523,4,-3,4,0.025237121118501665,8,6167,0,4517,479,0,11163,1650,0.0447589358721208,383665,215082,
3,6.325110689437065E-4,0,3,0,6,35836,42909,634583,4.956272145096887E-4,168583,1842,0.051400194328452505,19386,146,143,6,295,64137,0.01838378618992083,23523,1,3,1,0.07983355659443059,2,440,0,239,14,0,693,201,0.040219889640397535,383665,215082,
3,6.325110689437065E-4,0,3,0,6,35836,42909,634583,4.956272145096887E-4,168583,1842,0.051400194328452505,19386,146,143,6,295,64137,0.01838378618992083,23523,1,3,1,0.07983355659443059,2,440,0,239,14,0,693,201,0.040219889640397535,383665,215082,
160,0.006122448979591836,26,166,-6,352,35836,42909,634583,0.03415450585016038,168583,1842,0.051400194328452505,19386,174,66,1,241,64137,0.01838378618992083,23523,0,108,6,0.141166061066654,6,2811,0,778,119,6,3708,2033,0.08116610673656853,383665,215082,
160,0.006122448979591836,26,166,-6,352,35836,42909,634583,0.03415450585016038,168583,1842,0.051400194328452505,19386,174,66,1,241,64137,0.01838378618992083,23523,0,108,6,0.141166061066654,6,2811,0,778,119,6,3708,2033,0.08116610673656853,383665,215082,
160,0.0,26,166,-6,352,35836,42909,634583,0.03415450585016038,168583,1842,0.051400194328452505,19386,97,27,6,130,64137,0.01838378618992083,23523,0,70,0,0.02706515695798261,0,2811,0,778,119,0,3708,2033,0.08116610673656853,383665,215082,
160,0.0,26,166,-6,352,35836,42909,634583,0.03415450585016038,168583,1842,0.051400194328452505,19386,97,27,6,130,64137,0.01838378618992083,23523,0,70,0,0.02706515695798261,0,2811,0,778,119,0,3708,2033,0.08116610673656853,383665,215082,
160,0.0,26,166,-6,352,35836,42909,634583,0.03415450585016038,168583,1842,0.051400194328452505,19386,97,27,6,130,64137,0.01838378618992083,23523,0,70,0,0.02706515695798261,0,2811,0,778,119,0,3708,2033,0.08116610673656853,383665,215082,
160,0.0,26,166,-6,352,35836,42909,634583,0.03415450585016038,168583,1842,0.051400194328452505,19386,131,27,0,158,64137,0.01838378618992083,23523,0,104,0,0.028866888607678238,0,2811,0,778,119,0,3708,2033,0.08116610673656853,383665,215082,
160,0.0,26,166,-6,352,35836,42909,634583,0.03415450585016038,168583,1842,0.051400194328452505,19386,131,27,0,158,64137,0.01838378618992083,23523,0,104,0,0.028866888607678238,0,2811,0,778,119,0,3708,2033,0.08116610673656853,383665,215082,
160,0.0,26,166,-6,352,35836,42909,634583,0.03415450585016038,168583,1842,0.051400194328452505,19386,131,27,0,158,64137,0.01838378618992083,23523,0,104,0,0.028866888607678238,0,2811,0,778,119,0,3708,2033,0.08116610673656853,383665,215082,
160,0.0018791105543376136,26,166,-6,352,35836,42909,634583,0.03415450585016038,168583,1842,0.051400194328452505,19386,295,78,47,420,64137,0.01838378618992083,23523,3,217,3,0.14454190340189516,6,2811,0,778,119,0,3708,2033,0.08116610673656853,383665,215082,
160,0.0018791105543376136,26,166,-6,352,35836,42909,634583,0.03415450585016038,168583,1842,0.051400194328452505,19386,295,78,47,420,64137,0.01838378618992083,23523,3,217,3,0.14454190340189516,6,2811,0,778,119,0,3708,2033,0.08116610673656853,383665,215082,
160,0.0018791105543376136,26,166,-6,352,35836,42909,634583,0.03415450585016038,168583,1842,0.051400194328452505,19386,295,78,47,420,64137,0.01838378618992083,23523,3,217,3,0.14454190340189516,6,2811,0,778,119,0,3708,2033,0.08116610673656853,383665,215082,
12,0.0,3,26,-14,41,35836,42909,634583,0.019430554156885226,168583,1842,0.051400194328452505,19386,53,5,0,58,64137,0.01838378618992083,23523,0,48,0,0.12642857271047,0,1688,0,413,45,0,2146,1275,0.03700224072794024,383665,215082,
12,0.0,3,26,-14,41,35836,42909,634583,0.019430554156885226,168583,1842,0.051400194328452505,19386,53,5,0,58,64137,0.01838378618992083,23523,0,48,0,0.12642857271047,0,1688,0,413,45,0,2146,1275,0.03700224072794024,383665,215082,
12,0.0,3,26,-14,41,35836,42909,634583,0.019430554156885226,168583,1842,0.051400194328452505,19386,78,6,0,84,64137,0.01838378618992083,23523,0,72,0,0.08238147194047406,0,1688,0,413,45,0,2146,1275,0.03700224072794024,383665,215082,
12,0.0,3,26,-14,41,35836,42909,634583,0.019430554156885226,168583,1842,0.051400194328452505,19386,78,6,0,84,64137,0.01838378618992083,23523,0,72,0,0.08238147194047406,0,1688,0,413,45,0,2146,1275,0.03700224072794024,383665,215082,
12,0.22580645161290322,3,26,-14,41,35836,42909,634583,0.019430554156885226,168583,1842,0.051400194328452505,19386,60,9,3,72,64137,0.01838378618992083,23523,1,51,5,0.12007617149217863,7,1688,1,413,45,4,2146,1275,0.03700224072794024,383665,215082,
12,0.22580645161290322,3,26,-14,41,35836,42909,634583,0.019430554156885226,168583,1842,0.051400194328452505,19386,60,9,3,72,64137,0.01838378618992083,23523,1,51,5,0.12007617149217863,7,1688,1,413,45,4,2146,1275,0.03700224072794024,383665,215082,
12,0.0054497120070890566,3,26,-14,41,35836,42909,634583,0.019430554156885226,168583,1842,0.051400194328452505,19386,222,30,0,252,64137,0.01838378618992083,23523,6,192,2,0.05410437502808754,8,1688,0,413,45,-4,2146,1275,0.03700224072794024,383665,215082,
12,0.0,3,26,-14,41,35836,42909,634583,0.019430554156885226,168583,1842,0.051400194328452505,19386,305,72,7,384,64137,0.01838378618992083,23523,0,233,0,0.039789690283163155,0,1688,0,413,45,0,2146,1275,0.03700224072794024,383665,215082,
12,0.0,3,26,-14,41,35836,42909,634583,0.019430554156885226,168583,1842,0.051400194328452505,19386,305,72,7,384,64137,0.01838378618992083,23523,0,233,0,0.039789690283163155,0,1688,0,413,45,0,2146,1275,0.03700224072794024,383665,215082,
12,0.0,3,26,-14,41,35836,42909,634583,0.019430554156885226,168583,1842,0.051400194328452505,19386,305,72,7,384,64137,0.01838378618992083,23523,0,233,0,0.039789690283163155,0,1688,0,413,45,0,2146,1275,0.03700224072794024,383665,215082,
12,0.0,3,26,-14,41,35836,42909,634583,0.019430554156885226,168583,1842,0.051400194328452505,19386,305,72,7,384,64137,0.01838378618992083,23523,0,233,0,0.039789690283163155,0,1688,0,413,45,0,2146,1275,0.03700224072794024,383665,215082,
12,0.0,3,26,-14,41,35836,42909,634583,0.019430554156885226,168583,1842,0.051400194328452505,19386,305,72,7,384,64137,0.01838378618992083,23523,0,233,0,0.039789690283163155,0,1688,0,413,45,0,2146,1275,0.03700224072794024,383665,215082,
12,0.011828753362617905,3,26,-14,41,35836,42909,634583,0.019430554156885226,168583,1842,0.051400194328452505,19386,145,45,3,193,64137,0.01838378618992083,23523,10,100,4,0.026525060629223773,15,1688,1,413,45,-6,2146,1275,0.03700224072794024,383665,215082,
12,0.011828753362617905,3,26,-14,41,35836,42909,634583,0.019430554156885226,168583,1842,0.051400194328452505,19386,145,45,3,193,64137,0.01838378618992083,23523,10,100,4,0.026525060629223773,15,1688,1,413,45,-6,2146,1275,0.03700224072794024,383665,215082,
12,0.0,3,26,-14,41,35836,42909,634583,0.019430554156885226,168583,1842,0.051400194328452505,19386,13,12,2,27,64137,0.01838378618992083,23523,0,1,0,0.004415080629615922,0,1688,0,413,45,0,2146,1275,0.03700224072794024,383665,215082,
12,0.0039011703511053317,3,26,-14,41,35836,42909,634583,0.019430554156885226,168583,1842,0.051400194328452505,19386,109,46,13,168,64137,0.01838378618992083,23523,8,63,0,0.02130630684079236,9,1688,1,413,45,-8,2146,1275,0.03700224072794024,383665,215082,
12,0.0,3,26,-14,41,35836,42909,634583,0.019430554156885226,168583,1842,0.051400194328452505,19386,155,23,3,181,64137,0.01838378618992083,23523,0,132,0,0.023177260377407062,0,1688,0,413,45,0,2146,1275,0.03700224072794024,383665,215082,
12,0.0,3,26,-14,41,35836,42909,634583,0.019430554156885226,168583,1842,0.051400194328452505,19386,155,23,3,181,64137,0.01838378618992083,23523,0,132,0,0.023177260377407062,0,1688,0,413,45,0,2146,1275,0.03700224072794024,383665,215082,
28,6.238303181534623E-4,0,28,0,56,35836,42909,634583,0.005238538132768887,168583,1842,0.051400194328452505,19386,88,12,1,101,64137,0.01838378618992083,23523,1,76,1,0.1107347038837726,2,1026,0,173,17,0,1216,853,0.11816870556034043,383665,215082,
28,6.238303181534623E-4,0,28,0,56,35836,42909,634583,0.005238538132768887,168583,1842,0.051400194328452505,19386,88,12,1,101,64137,0.01838378618992083,23523,1,76,1,0.1107347038837726,2,1026,0,173,17,0,1216,853,0.11816870556034043,383665,215082,
28,6.238303181534623E-4,0,28,0,56,35836,42909,634583,0.005238538132768887,168583,1842,0.051400194328452505,19386,88,12,1,101,64137,0.01838378618992083,23523,1,76,1,0.1107347038837726,2,1026,0,173,17,0,1216,853,0.11816870556034043,383665,215082,
28,8.600301010535369E-4,0,28,0,56,35836,42909,634583,0.005238538132768887,168583,1842,0.051400194328452505,19386,213,61,13,287,64137,0.01838378618992083,23523,2,152,2,0.10138065292316671,4,1026,0,173,17,0,1216,853,0.11816870556034043,383665,215082,
28,0.008049558158428222,0,28,0,56,35836,42909,634583,0.005238538132768887,168583,1842,0.051400194328452505,19386,277,14,0,291,64137,0.01838378618992083,23523,13,263,13,0.10603819410955843,26,1026,0,173,17,0,1216,853,0.11816870556034043,383665,215082,
28,0.008049558158428222,0,28,0,56,35836,42909,634583,0.005238538132768887,168583,1842,0.051400194328452505,19386,277,14,0,291,64137,0.01838378618992083,23523,13,263,13,0.10603819410955843,26,1026,0,173,17,0,1216,853,0.11816870556034043,383665,215082,
28,0.0,0,28,0,56,35836,42909,634583,0.005238538132768887,168583,1842,0.051400194328452505,19386,310,47,2,359,64137,0.01838378618992083,23523,0,263,0,0.207167970598981,0,1026,0,173,17,0,1216,853,0.11816870556034043,383665,215082,
28,0.0,0,28,0,56,35836,42909,634583,0.005238538132768887,168583,1842,0.051400194328452505,19386,310,47,2,359,64137,0.01838378618992083,23523,0,263,0,0.207167970598981,0,1026,0,173,17,0,1216,853,0.11816870556034043,383665,215082,
28,0.0,0,28,0,56,35836,42909,634583,0.005238538132768887,168583,1842,0.051400194328452505,19386,310,47,2,359,64137,0.01838378618992083,23523,0,263,0,0.207167970598981,0,1026,0,173,17,0,1216,853,0.11816870556034043,383665,215082,
1625,0.011965870545584912,71,1084,541,2780,35836,42909,634583,0.025737096813503276,168583,1842,0.051400194328452505,19386,198,31,0,229,64137,0.01838378618992083,23523,28,167,107,0.13132566931117867,135,13305,0,5197,903,79,19405,8108,0.0738011731733765,383665,215082,
1625,0.011965870545584912,71,1084,541,2780,35836,42909,634583,0.025737096813503276,168583,1842,0.051400194328452505,19386,198,31,0,229,64137,0.01838378618992083,23523,28,167,107,0.13132566931117867,135,13305,0,5197,903,79,19405,8108,0.0738011731733765,383665,215082,
1625,4.0559724193875484E-4,71,1084,541,2780,35836,42909,634583,0.025737096813503276,168583,1842,0.051400194328452505,19386,2,2,0,4,64137,0.01838378618992083,23523,1,0,1,3.256752711224421E-4,2,13305,0,5197,903,0,19405,8108,0.0738011731733765,383665,215082,
1625,0.0,71,1084,541,2780,35836,42909,634583,0.025737096813503276,168583,1842,0.051400194328452505,19386,25,11,0,36,64137,0.01838378618992083,23523,0,14,0,0.017959597970762322,0,13305,0,5197,903,0,19405,8108,0.0738011731733765,383665,215082,
1625,0.0,71,1084,541,2780,35836,42909,634583,0.025737096813503276,168583,1842,0.051400194328452505,19386,25,11,0,36,64137,0.01838378618992083,23523,0,14,0,0.017959597970762322,0,13305,0,5197,903,0,19405,8108,0.0738011731733765,383665,215082,
1625,0.0,71,1084,541,2780,35836,42909,634583,0.025737096813503276,168583,1842,0.051400194328452505,19386,25,11,0,36,64137,0.01838378618992083,23523,0,14,0,0.017959597970762322,0,13305,0,5197,903,0,19405,8108,0.0738011731733765,383665,215082,
1625,0.0,71,1084,541,2780,35836,42909,634583,0.025737096813503276,168583,1842,0.051400194328452505,19386,25,11,0,36,64137,0.01838378618992083,23523,0,14,0,0.017959597970762322,0,13305,0,5197,903,0,19405,8108,0.0738011731733765,383665,215082,
1625,0.0,71,1084,541,2780,35836,42909,634583,0.025737096813503276,168583,1842,0.051400194328452505,19386,179,1,0,180,64137,0.01838378618992083,23523,0,178,0,0.27590885816692273,0,13305,0,5197,903,0,19405,8108,0.0738011731733765,383665,215082,
1625,0.0,71,1084,541,2780,35836,42909,634583,0.025737096813503276,168583,1842,0.051400194328452505,19386,179,1,0,180,64137,0.01838378618992083,23523,0,178,0,0.27590885816692273,0,13305,0,5197,903,0,19405,8108,0.0738011731733765,383665,215082,
1625,0.0,71,1084,541,2780,35836,42909,634583,0.025737096813503276,168583,1842,0.051400194328452505,19386,179,1,0,180,64137,0.01838378618992083,23523,0,178,0,0.27590885816692273,0,13305,0,5197,903,0,19405,8108,0.0738011731733765,383665,215082,
1625,0.0,71,1084,541,2780,35836,42909,634583,0.025737096813503276,168583,1842,0.051400194328452505,19386,179,1,0,180,64137,0.01838378618992083,23523,0,178,0,0.27590885816692273,0,13305,0,5197,903,0,19405,8108,0.0738011731733765,383665,215082,
1625,6.213109661385523E-4,71,1084,541,2780,35836,42909,634583,0.025737096813503276,168583,1842,0.051400194328452505,19386,292,76,11,379,64137,0.01838378618992083,23523,1,216,1,0.0900356398640324,2,13305,0,5197,903,0,19405,8108,0.0738011731733765,383665,215082,
1625,6.213109661385523E-4,71,1084,541,2780,35836,42909,634583,0.025737096813503276,168583,1842,0.051400194328452505,19386,292,76,11,379,64137,0.01838378618992083,23523,1,216,1,0.0900356398640324,2,13305,0,5197,903,0,19405,8108,0.0738011731733765,383665,215082,
1625,6.213109661385523E-4,71,1084,541,2780,35836,42909,634583,0.025737096813503276,168583,1842,0.051400194328452505,19386,292,76,11,379,64137,0.01838378618992083,23523,1,216,1,0.0900356398640324,2,13305,0,5197,903,0,19405,8108,0.0738011731733765,383665,215082,
1625,0.0,71,1084,541,2780,35836,42909,634583,0.025737096813503276,168583,1842,0.051400194328452505,19386,1,1,0,2,64137,0.01838378618992083,23523,0,0,0,0.031746031746031744,0,13305,0,5197,903,0,19405,8108,0.0738011731733765,383665,215082,
1625,0.0,71,1084,541,2780,35836,42909,634583,0.025737096813503276,168583,1842,0.051400194328452505,19386,1,1,0,2,64137,0.01838378618992083,23523,0,0,0,0.031746031746031744,0,13305,0,5197,903,0,19405,8108,0.0738011731733765,383665,215082,
1625,0.0,71,1084,541,2780,35836,42909,634583,0.025737096813503276,168583,1842,0.051400194328452505,19386,1,1,0,2,64137,0.01838378618992083,23523,0,0,0,0.031746031746031744,0,13305,0,5197,903,0,19405,8108,0.0738011731733765,383665,215082,
1625,0.0,71,1084,541,2780,35836,42909,634583,0.025737096813503276,168583,1842,0.051400194328452505,19386,1,1,0,2,64137,0.01838378618992083,23523,0,0,0,0.031746031746031744,0,13305,0,5197,903,0,19405,8108,0.0738011731733765,383665,215082,
1625,0.0,71,1084,541,2780,35836,42909,634583,0.025737096813503276,168583,1842,0.051400194328452505,19386,340,0,0,340,64137,0.01838378618992083,23523,0,340,0,0.2339986235375086,0,13305,0,5197,903,0,19405,8108,0.0738011731733765,383665,215082,
1625,0.0,71,1084,541,2780,35836,42909,634583,0.025737096813503276,168583,1842,0.051400194328452505,19386,340,0,0,340,64137,0.01838378618992083,23523,0,340,0,0.2339986235375086,0,13305,0,5197,903,0,19405,8108,0.0738011731733765,383665,215082,
1625,0.0,71,1084,541,2780,35836,42909,634583,0.025737096813503276,168583,1842,0.051400194328452505,19386,340,0,0,340,64137,0.01838378618992083,23523,0,340,0,0.2339986235375086,0,13305,0,5197,903,0,19405,8108,0.0738011731733765,383665,215082,
1625,0.0,71,1084,541,2780,35836,42909,634583,0.025737096813503276,168583,1842,0.051400194328452505,19386,340,0,0,340,64137,0.01838378618992083,23523,0,340,0,0.2339986235375086,0,13305,0,5197,903,0,19405,8108,0.0738011731733765,383665,215082,
1625,0.0,71,1084,541,2780,35836,42909,634583,0.025737096813503276,168583,1842,0.051400194328452505,19386,340,0,0,340,64137,0.01838378618992083,23523,0,340,0,0.2339986235375086,0,13305,0,5197,903,0,19405,8108,0.0738011731733765,383665,215082,
1625,0.0,71,1084,541,2780,35836,42909,634583,0.025737096813503276,168583,1842,0.051400194328452505,19386,340,0,0,340,64137,0.01838378618992083,23523,0,340,0,0.2339986235375086,0,13305,0,5197,903,0,19405,8108,0.0738011731733765,383665,215082,
1625,0.01840388154592605,71,1084,541,2780,35836,42909,634583,0.025737096813503276,168583,1842,0.051400194328452505,19386,162,163,3,328,64137,0.01838378618992083,23523,110,-1,0,0.011472260136021508,110,13305,0,5197,903,-110,19405,8108,0.0738011731733765,383665,215082,
1625,0.001234186979327368,71,1084,541,2780,35836,42909,634583,0.025737096813503276,168583,1842,0.051400194328452505,19386,122,70,7,199,64137,0.01838378618992083,23523,2,52,2,0.10430745792446289,4,13305,0,5197,903,0,19405,8108,0.0738011731733765,383665,215082,
1625,0.001234186979327368,71,1084,541,2780,35836,42909,634583,0.025737096813503276,168583,1842,0.051400194328452505,19386,122,70,7,199,64137,0.01838378618992083,23523,2,52,2,0.10430745792446289,4,13305,0,5197,903,0,19405,8108,0.0738011731733765,383665,215082,
1625,0.09338708599299819,71,1084,541,2780,35836,42909,634583,0.025737096813503276,168583,1842,0.051400194328452505,19386,1736,839,346,2921,64137,0.01838378618992083,23523,42,897,57,0.079452631340522,99,13305,0,5197,903,15,19405,8108,0.0738011731733765,383665,215082,
1625,0.09338708599299819,71,1084,541,2780,35836,42909,634583,0.025737096813503276,168583,1842,0.051400194328452505,19386,1736,839,346,2921,64137,0.01838378618992083,23523,42,897,57,0.079452631340522,99,13305,0,5197,903,15,19405,8108,0.0738011731733765,383665,215082,
1625,0.09338708599299819,71,1084,541,2780,35836,42909,634583,0.025737096813503276,168583,1842,0.051400194328452505,19386,1736,839,346,2921,64137,0.01838378618992083,23523,42,897,57,0.079452631340522,99,13305,0,5197,903,15,19405,8108,0.0738011731733765,383665,215082,
1625,0.09338708599299819,71,1084,541,2780,35836,42909,634583,0.025737096813503276,168583,1842,0.051400194328452505,19386,1736,839,346,2921,64137,0.01838378618992083,23523,42,897,57,0.079452631340522,99,13305,0,5197,903,15,19405,8108,0.0738011731733765,383665,215082,
1625,0.09338708599299819,71,1084,541,2780,35836,42909,634583,0.025737096813503276,168583,1842,0.051400194328452505,19386,1736,839,346,2921,64137,0.01838378618992083,23523,42,897,57,0.079452631340522,99,13305,0,5197,903,15,19405,8108,0.0738011731733765,383665,215082,
1625,0.09338708599299819,71,1084,541,2780,35836,42909,634583,0.025737096813503276,168583,1842,0.051400194328452505,19386,1736,839,346,2921,64137,0.01838378618992083,23523,42,897,57,0.079452631340522,99,13305,0,5197,903,15,19405,8108,0.0738011731733765,383665,215082,
1625,0.09338708599299819,71,1084,541,2780,35836,42909,634583,0.025737096813503276,168583,1842,0.051400194328452505,19386,1736,839,346,2921,64137,0.01838378618992083,23523,42,897,57,0.079452631340522,99,13305,0,5197,903,15,19405,8108,0.0738011731733765,383665,215082,
1625,0.0,71,1084,541,2780,35836,42909,634583,0.025737096813503276,168583,1842,0.051400194328452505,19386,399,11,0,410,64137,0.01838378618992083,23523,0,388,0,0.056040444087298046,0,13305,0,5197,903,0,19405,8108,0.0738011731733765,383665,215082,
1625,0.046632124352331605,71,1084,541,2780,35836,42909,634583,0.025737096813503276,168583,1842,0.051400194328452505,19386,150,84,4,238,64137,0.01838378618992083,23523,9,66,9,0.03209610930556595,18,13305,0,5197,903,0,19405,8108,0.0738011731733765,383665,215082,
1625,0.0,71,1084,541,2780,35836,42909,634583,0.025737096813503276,168583,1842,0.051400194328452505,19386,127,49,102,278,64137,0.01838378618992083,23523,0,78,0,0.019106233604599947,0,13305,0,5197,903,0,19405,8108,0.0738011731733765,383665,215082,
1625,0.0,71,1084,541,2780,35836,42909,634583,0.025737096813503276,168583,1842,0.051400194328452505,19386,127,49,102,278,64137,0.01838378618992083,23523,0,78,0,0.019106233604599947,0,13305,0,5197,903,0,19405,8108,0.0738011731733765,383665,215082,
1625,0.06179775280898876,71,1084,541,2780,35836,42909,634583,0.025737096813503276,168583,1842,0.051400194328452505,19386,115,5,1,121,64137,0.01838378618992083,23523,3,110,7,0.07589137807719817,11,13305,1,5197,903,4,19405,8108,0.0738011731733765,383665,215082,
1625,0.06179775280898876,71,1084,541,2780,35836,42909,634583,0.025737096813503276,168583,1842,0.051400194328452505,19386,115,5,1,121,64137,0.01838378618992083,23523,3,110,7,0.07589137807719817,11,13305,1,5197,903,4,19405,8108,0.0738011731733765,383665,215082,
1625,0.0,71,1084,541,2780,35836,42909,634583,0.025737096813503276,168583,1842,0.051400194328452505,19386,5,20,0,25,64137,0.01838378618992083,23523,0,-15,0,0.09624101887169262,0,13305,0,5197,903,0,19405,8108,0.0738011731733765,383665,215082,
1625,0.0,71,1084,541,2780,35836,42909,634583,0.025737096813503276,168583,1842,0.051400194328452505,19386,5,20,0,25,64137,0.01838378618992083,23523,0,-15,0,0.09624101887169262,0,13305,0,5197,903,0,19405,8108,0.0738011731733765,383665,215082,
1625,0.0027739251040221915,71,1084,541,2780,35836,42909,634583,0.025737096813503276,168583,1842,0.051400194328452505,19386,251,81,11,343,64137,0.01838378618992083,23523,1,170,1,0.008468501939906965,2,13305,0,5197,903,0,19405,8108,0.0738011731733765,383665,215082,
1625,0.0027739251040221915,71,1084,541,2780,35836,42909,634583,0.025737096813503276,168583,1842,0.051400194328452505,19386,251,81,11,343,64137,0.01838378618992083,23523,1,170,1,0.008468501939906965,2,13305,0,5197,903,0,19405,8108,0.0738011731733765,383665,215082,
1625,0.06647830018083183,71,1084,541,2780,35836,42909,634583,0.025737096813503276,168583,1842,0.051400194328452505,19386,62,0,2,64,64137,0.01838378618992083,23523,0,62,23,0.04975965619861836,25,13305,2,5197,903,23,19405,8108,0.0738011731733765,383665,215082,
1625,0.0,71,1084,541,2780,35836,42909,634583,0.025737096813503276,168583,1842,0.051400194328452505,19386,256,137,0,393,64137,0.01838378618992083,23523,0,119,0,0.040787040901656954,0,13305,0,5197,903,0,19405,8108,0.0738011731733765,383665,215082,
1625,0.0,71,1084,541,2780,35836,42909,634583,0.025737096813503276,168583,1842,0.051400194328452505,19386,256,137,0,393,64137,0.01838378618992083,23523,0,119,0,0.040787040901656954,0,13305,0,5197,903,0,19405,8108,0.0738011731733765,383665,215082,
1625,0.0,71,1084,541,2780,35836,42909,634583,0.025737096813503276,168583,1842,0.051400194328452505,19386,256,137,0,393,64137,0.01838378618992083,23523,0,119,0,0.040787040901656954,0,13305,0,5197,903,0,19405,8108,0.0738011731733765,383665,215082,
1625,0.0,71,1084,541,2780,35836,42909,634583,0.025737096813503276,168583,1842,0.051400194328452505,19386,256,137,0,393,64137,0.01838378618992083,23523,0,119,0,0.040787040901656954,0,13305,0,5197,903,0,19405,8108,0.0738011731733765,383665,215082,
1625,0.0,71,1084,541,2780,35836,42909,634583,0.025737096813503276,168583,1842,0.051400194328452505,19386,256,137,0,393,64137,0.01838378618992083,23523,0,119,0,0.040787040901656954,0,13305,0,5197,903,0,19405,8108,0.0738011731733765,383665,215082,
1625,0.0,71,1084,541,2780,35836,42909,634583,0.025737096813503276,168583,1842,0.051400194328452505,19386,256,137,0,393,64137,0.01838378618992083,23523,0,119,0,0.040787040901656954,0,13305,0,5197,903,0,19405,8108,0.0738011731733765,383665,215082,
1625,0.0,71,1084,541,2780,35836,42909,634583,0.025737096813503276,168583,1842,0.051400194328452505,19386,256,137,0,393,64137,0.01838378618992083,23523,0,119,0,0.040787040901656954,0,13305,0,5197,903,0,19405,8108,0.0738011731733765,383665,215082,
1625,0.0,71,1084,541,2780,35836,42909,634583,0.025737096813503276,168583,1842,0.051400194328452505,19386,256,137,0,393,64137,0.01838378618992083,23523,0,119,0,0.040787040901656954,0,13305,0,5197,903,0,19405,8108,0.0738011731733765,383665,215082,
1625,0.0,71,1084,541,2780,35836,42909,634583,0.025737096813503276,168583,1842,0.051400194328452505,19386,256,137,0,393,64137,0.01838378618992083,23523,0,119,0,0.040787040901656954,0,13305,0,5197,903,0,19405,8108,0.0738011731733765,383665,215082,
1625,0.05458651792739125,71,1084,541,2780,35836,42909,634583,0.025737096813503276,168583,1842,0.051400194328452505,19386,1256,81,34,1371,64137,0.01838378618992083,23523,18,1175,85,0.1942454157328344,134,13305,31,5197,903,67,19405,8108,0.0738011731733765,383665,215082,
1625,0.05458651792739125,71,1084,541,2780,35836,42909,634583,0.025737096813503276,168583,1842,0.051400194328452505,19386,1256,81,34,1371,64137,0.01838378618992083,23523,18,1175,85,0.1942454157328344,134,13305,31,5197,903,67,19405,8108,0.0738011731733765,383665,215082,
1625,0.05458651792739125,71,1084,541,2780,35836,42909,634583,0.025737096813503276,168583,1842,0.051400194328452505,19386,1256,81,34,1371,64137,0.01838378618992083,23523,18,1175,85,0.1942454157328344,134,13305,31,5197,903,67,19405,8108,0.0738011731733765,383665,215082,
1625,0.05458651792739125,71,1084,541,2780,35836,42909,634583,0.025737096813503276,168583,1842,0.051400194328452505,19386,1256,81,34,1371,64137,0.01838378618992083,23523,18,1175,85,0.1942454157328344,134,13305,31,5197,903,67,19405,8108,0.0738011731733765,383665,215082,
1625,0.05458651792739125,71,1084,541,2780,35836,42909,634583,0.025737096813503276,168583,1842,0.051400194328452505,19386,1256,81,34,1371,64137,0.01838378618992083,23523,18,1175,85,0.1942454157328344,134,13305,31,5197,903,67,19405,8108,0.0738011731733765,383665,215082,
1625,0.0,71,1084,541,2780,35836,42909,634583,0.025737096813503276,168583,1842,0.051400194328452505,19386,103,0,0,103,64137,0.01838378618992083,23523,0,103,0,0.05438225976768744,0,13305,0,5197,903,0,19405,8108,0.0738011731733765,383665,215082,
1625,0.18369987063389392,71,1084,541,2780,35836,42909,634583,0.025737096813503276,168583,1842,0.051400194328452505,19386,202,25,12,239,64137,0.01838378618992083,23523,9,177,127,0.07154583557664251,142,13305,6,5197,903,118,19405,8108,0.0738011731733765,383665,215082,
1625,0.18369987063389392,71,1084,541,2780,35836,42909,634583,0.025737096813503276,168583,1842,0.051400194328452505,19386,202,25,12,239,64137,0.01838378618992083,23523,9,177,127,0.07154583557664251,142,13305,6,5197,903,118,19405,8108,0.0738011731733765,383665,215082,
1625,0.0,71,1084,541,2780,35836,42909,634583,0.025737096813503276,168583,1842,0.051400194328452505,19386,62,1,0,63,64137,0.01838378618992083,23523,0,61,0,0.12176986835689907,0,13305,0,5197,903,0,19405,8108,0.0738011731733765,383665,215082,
1625,0.0,71,1084,541,2780,35836,42909,634583,0.025737096813503276,168583,1842,0.051400194328452505,19386,226,30,1,257,64137,0.01838378618992083,23523,0,196,0,0.13677181785619025,0,13305,0,5197,903,0,19405,8108,0.0738011731733765,383665,215082,
1625,0.0,71,1084,541,2780,35836,42909,634583,0.025737096813503276,168583,1842,0.051400194328452505,19386,0,0,0,0,64137,0.01838378618992083,23523,0,0,0,0.0,0,13305,0,5197,903,0,19405,8108,0.0738011731733765,383665,215082,
1625,0.0015512895094046927,71,1084,541,2780,35836,42909,634583,0.025737096813503276,168583,1842,0.051400194328452505,19386,364,303,30,697,64137,0.01838378618992083,23523,8,61,8,0.0659421739389816,16,13305,0,5197,903,0,19405,8108,0.0738011731733765,383665,215082,
1625,0.0015512895094046927,71,1084,541,2780,35836,42909,634583,0.025737096813503276,168583,1842,0.051400194328452505,19386,364,303,30,697,64137,0.01838378618992083,23523,8,61,8,0.0659421739389816,16,13305,0,5197,903,0,19405,8108,0.0738011731733765,383665,215082,
1625,0.0015512895094046927,71,1084,541,2780,35836,42909,634583,0.025737096813503276,168583,1842,0.051400194328452505,19386,364,303,30,697,64137,0.01838378618992083,23523,8,61,8,0.0659421739389816,16,13305,0,5197,903,0,19405,8108,0.0738011731733765,383665,215082,
120,0.0,3,360,-240,483,35836,42909,634583,0.0049520011837220195,168583,1842,0.051400194328452505,19386,665,297,39,1001,64137,0.01838378618992083,23523,0,368,0,0.12190167985323835,0,4807,0,2470,339,0,7616,2337,0.04953383561652067,383665,215082,
120,0.0,3,360,-240,483,35836,42909,634583,0.0049520011837220195,168583,1842,0.051400194328452505,19386,665,297,39,1001,64137,0.01838378618992083,23523,0,368,0,0.12190167985323835,0,4807,0,2470,339,0,7616,2337,0.04953383561652067,383665,215082,
1625,2.568788313647503E-4,71,1084,541,2780,35836,42909,634583,0.025737096813503276,168583,1842,0.051400194328452505,19386,155,243,4,402,64137,0.01838378618992083,23523,3,-88,3,0.042434486883616916,6,13305,0,5197,903,0,19405,8108,0.0738011731733765,383665,215082,
1625,2.568788313647503E-4,71,1084,541,2780,35836,42909,634583,0.025737096813503276,168583,1842,0.051400194328452505,19386,155,243,4,402,64137,0.01838378618992083,23523,3,-88,3,0.042434486883616916,6,13305,0,5197,903,0,19405,8108,0.0738011731733765,383665,215082,
1625,2.568788313647503E-4,71,1084,541,2780,35836,42909,634583,0.025737096813503276,168583,1842,0.051400194328452505,19386,155,243,4,402,64137,0.01838378618992083,23523,3,-88,3,0.042434486883616916,6,13305,0,5197,903,0,19405,8108,0.0738011731733765,383665,215082,
1625,2.568788313647503E-4,71,1084,541,2780,35836,42909,634583,0.025737096813503276,168583,1842,0.051400194328452505,19386,155,243,4,402,64137,0.01838378618992083,23523,3,-88,3,0.042434486883616916,6,13305,0,5197,903,0,19405,8108,0.0738011731733765,383665,215082,
1625,2.568788313647503E-4,71,1084,541,2780,35836,42909,634583,0.025737096813503276,168583,1842,0.051400194328452505,19386,155,243,4,402,64137,0.01838378618992083,23523,3,-88,3,0.042434486883616916,6,13305,0,5197,903,0,19405,8108,0.0738011731733765,383665,215082,
1625,2.568788313647503E-4,71,1084,541,2780,35836,42909,634583,0.025737096813503276,168583,1842,0.051400194328452505,19386,155,243,4,402,64137,0.01838378618992083,23523,3,-88,3,0.042434486883616916,6,13305,0,5197,903,0,19405,8108,0.0738011731733765,383665,215082,
1625,2.568788313647503E-4,71,1084,541,2780,35836,42909,634583,0.025737096813503276,168583,1842,0.051400194328452505,19386,155,243,4,402,64137,0.01838378618992083,23523,3,-88,3,0.042434486883616916,6,13305,0,5197,903,0,19405,8108,0.0738011731733765,383665,215082,
1625,2.568788313647503E-4,71,1084,541,2780,35836,42909,634583,0.025737096813503276,168583,1842,0.051400194328452505,19386,155,243,4,402,64137,0.01838378618992083,23523,3,-88,3,0.042434486883616916,6,13305,0,5197,903,0,19405,8108,0.0738011731733765,383665,215082,
1625,0.0,71,1084,541,2780,35836,42909,634583,0.025737096813503276,168583,1842,0.051400194328452505,19386,281,22,34,337,64137,0.01838378618992083,23523,0,259,0,0.06051209304973831,0,13305,0,5197,903,0,19405,8108,0.0738011731733765,383665,215082,
1625,0.0,71,1084,541,2780,35836,42909,634583,0.025737096813503276,168583,1842,0.051400194328452505,19386,281,22,34,337,64137,0.01838378618992083,23523,0,259,0,0.06051209304973831,0,13305,0,5197,903,0,19405,8108,0.0738011731733765,383665,215082,
1625,0.0,71,1084,541,2780,35836,42909,634583,0.025737096813503276,168583,1842,0.051400194328452505,19386,281,22,34,337,64137,0.01838378618992083,23523,0,259,0,0.06051209304973831,0,13305,0,5197,903,0,19405,8108,0.0738011731733765,383665,215082,
1625,0.0,71,1084,541,2780,35836,42909,634583,0.025737096813503276,168583,1842,0.051400194328452505,19386,281,22,34,337,64137,0.01838378618992083,23523,0,259,0,0.06051209304973831,0,13305,0,5197,903,0,19405,8108,0.0738011731733765,383665,215082,
1625,0.13333333333333333,71,1084,541,2780,35836,42909,634583,0.025737096813503276,168583,1842,0.051400194328452505,19386,1,1,0,2,64137,0.01838378618992083,23523,1,0,1,0.13333333333333333,2,13305,0,5197,903,0,19405,8108,0.0738011731733765,383665,215082,
1625,0.2727272727272727,71,1084,541,2780,35836,42909,634583,0.025737096813503276,168583,1842,0.051400194328452505,19386,7,4,1,12,64137,0.01838378618992083,23523,4,3,7,0.2727272727272727,12,13305,1,5197,903,3,19405,8108,0.0738011731733765,383665,215082,
1625,0.2727272727272727,71,1084,541,2780,35836,42909,634583,0.025737096813503276,168583,1842,0.051400194328452505,19386,7,4,1,12,64137,0.01838378618992083,23523,4,3,7,0.2727272727272727,12,13305,1,5197,903,3,19405,8108,0.0738011731733765,383665,215082,
1625,0.2727272727272727,71,1084,541,2780,35836,42909,634583,0.025737096813503276,168583,1842,0.051400194328452505,19386,7,4,1,12,64137,0.01838378618992083,23523,4,3,7,0.2727272727272727,12,13305,1,5197,903,3,19405,8108,0.0738011731733765,383665,215082,
1625,0.0,71,1084,541,2780,35836,42909,634583,0.025737096813503276,168583,1842,0.051400194328452505,19386,415,32,0,447,64137,0.01838378618992083,23523,0,383,0,0.587059620596206,0,13305,0,5197,903,0,19405,8108,0.0738011731733765,383665,215082,
1625,0.0,71,1084,541,2780,35836,42909,634583,0.025737096813503276,168583,1842,0.051400194328452505,19386,195,43,1,239,64137,0.01838378618992083,23523,0,152,0,0.1725687290627742,0,13305,0,5197,903,0,19405,8108,0.0738011731733765,383665,215082,
1625,0.0,71,1084,541,2780,35836,42909,634583,0.025737096813503276,168583,1842,0.051400194328452505,19386,195,43,1,239,64137,0.01838378618992083,23523,0,152,0,0.1725687290627742,0,13305,0,5197,903,0,19405,8108,0.0738011731733765,383665,215082,
1625,0.0,71,1084,541,2780,35836,42909,634583,0.025737096813503276,168583,1842,0.051400194328452505,19386,195,43,1,239,64137,0.01838378618992083,23523,0,152,0,0.1725687290627742,0,13305,0,5197,903,0,19405,8108,0.0738011731733765,383665,215082,
1625,0.0,71,1084,541,2780,35836,42909,634583,0.025737096813503276,168583,1842,0.051400194328452505,19386,195,43,1,239,64137,0.01838378618992083,23523,0,152,0,0.1725687290627742,0,13305,0,5197,903,0,19405,8108,0.0738011731733765,383665,215082,
1625,0.0,71,1084,541,2780,35836,42909,634583,0.025737096813503276,168583,1842,0.051400194328452505,19386,195,43,1,239,64137,0.01838378618992083,23523,0,152,0,0.1725687290627742,0,13305,0,5197,903,0,19405,8108,0.0738011731733765,383665,215082,
1625,0.0,71,1084,541,2780,35836,42909,634583,0.025737096813503276,168583,1842,0.051400194328452505,19386,195,43,1,239,64137,0.01838378618992083,23523,0,152,0,0.1725687290627742,0,13305,0,5197,903,0,19405,8108,0.0738011731733765,383665,215082,
1625,0.0,71,1084,541,2780,35836,42909,634583,0.025737096813503276,168583,1842,0.051400194328452505,19386,195,43,1,239,64137,0.01838378618992083,23523,0,152,0,0.1725687290627742,0,13305,0,5197,903,0,19405,8108,0.0738011731733765,383665,215082,
1625,0.48119777158774374,71,1084,541,2780,35836,42909,634583,0.025737096813503276,168583,1842,0.051400194328452505,19386,37,691,2,730,64137,0.01838378618992083,23523,691,-654,0,0.11218212493637836,691,13305,0,5197,903,-691,19405,8108,0.0738011731733765,383665,215082,
1625,0.48119777158774374,71,1084,541,2780,35836,42909,634583,0.025737096813503276,168583,1842,0.051400194328452505,19386,37,691,2,730,64137,0.01838378618992083,23523,691,-654,0,0.11218212493637836,691,13305,0,5197,903,-691,19405,8108,0.0738011731733765,383665,215082,
1625,0.48119777158774374,71,1084,541,2780,35836,42909,634583,0.025737096813503276,168583,1842,0.051400194328452505,19386,37,691,2,730,64137,0.01838378618992083,23523,691,-654,0,0.11218212493637836,691,13305,0,5197,903,-691,19405,8108,0.0738011731733765,383665,215082,
1625,0.48119777158774374,71,1084,541,2780,35836,42909,634583,0.025737096813503276,168583,1842,0.051400194328452505,19386,37,691,2,730,64137,0.01838378618992083,23523,691,-654,0,0.11218212493637836,691,13305,0,5197,903,-691,19405,8108,0.0738011731733765,383665,215082,
1625,0.0021693038967507735,71,1084,541,2780,35836,42909,634583,0.025737096813503276,168583,1842,0.051400194328452505,19386,60,75,5,140,64137,0.01838378618992083,23523,21,-15,17,0.016247506930743113,38,13305,0,5197,903,-4,19405,8108,0.0738011731733765,383665,215082,
1625,0.0015381657373582003,71,1084,541,2780,35836,42909,634583,0.025737096813503276,168583,1842,0.051400194328452505,19386,19,32,0,51,64137,0.01838378618992083,23523,4,-13,4,0.05224947735584616,8,13305,0,5197,903,0,19405,8108,0.0738011731733765,383665,215082,
1625,6.080875646093037E-4,71,1084,541,2780,35836,42909,634583,0.025737096813503276,168583,1842,0.051400194328452505,19386,113,1,0,114,64137,0.01838378618992083,23523,1,112,1,0.10212222560048648,2,13305,0,5197,903,0,19405,8108,0.0738011731733765,383665,215082,
1625,0.0,71,1084,541,2780,35836,42909,634583,0.025737096813503276,168583,1842,0.051400194328452505,19386,0,0,0,0,64137,0.01838378618992083,23523,0,0,0,0.0,0,13305,0,5197,903,0,19405,8108,0.0738011731733765,383665,215082,
1625,0.0,71,1084,541,2780,35836,42909,634583,0.025737096813503276,168583,1842,0.051400194328452505,19386,0,0,0,0,64137,0.01838378618992083,23523,0,0,0,0.0,0,13305,0,5197,903,0,19405,8108,0.0738011731733765,383665,215082,
1625,0.0,71,1084,541,2780,35836,42909,634583,0.025737096813503276,168583,1842,0.051400194328452505,19386,0,0,0,0,64137,0.01838378618992083,23523,0,0,0,0.0,0,13305,0,5197,903,0,19405,8108,0.0738011731733765,383665,215082,
1625,0.0,71,1084,541,2780,35836,42909,634583,0.025737096813503276,168583,1842,0.051400194328452505,19386,190,82,20,292,64137,0.01838378618992083,23523,0,108,0,0.08082645313961978,0,13305,0,5197,903,0,19405,8108,0.0738011731733765,383665,215082,
1625,0.0,71,1084,541,2780,35836,42909,634583,0.025737096813503276,168583,1842,0.051400194328452505,19386,34,1,0,35,64137,0.01838378618992083,23523,0,33,0,0.02764364720247073,0,13305,0,5197,903,0,19405,8108,0.0738011731733765,383665,215082,
1225,0.054296420858550076,15,704,521,1944,35836,42909,634583,0.053003835897014955,168583,1842,0.051400194328452505,19386,781,159,7,947,64137,0.01838378618992083,23523,45,622,312,0.11219382454525058,360,2231,3,911,38,267,3180,1320,0.0668226416412824,383665,215082,
1225,0.054296420858550076,15,704,521,1944,35836,42909,634583,0.053003835897014955,168583,1842,0.051400194328452505,19386,781,159,7,947,64137,0.01838378618992083,23523,45,622,312,0.11219382454525058,360,2231,3,911,38,267,3180,1320,0.0668226416412824,383665,215082,
1225,0.054296420858550076,15,704,521,1944,35836,42909,634583,0.053003835897014955,168583,1842,0.051400194328452505,19386,781,159,7,947,64137,0.01838378618992083,23523,45,622,312,0.11219382454525058,360,2231,3,911,38,267,3180,1320,0.0668226416412824,383665,215082,
1225,0.054296420858550076,15,704,521,1944,35836,42909,634583,0.053003835897014955,168583,1842,0.051400194328452505,19386,781,159,7,947,64137,0.01838378618992083,23523,45,622,312,0.11219382454525058,360,2231,3,911,38,267,3180,1320,0.0668226416412824,383665,215082,
1225,0.1191833944181362,15,704,521,1944,35836,42909,634583,0.053003835897014955,168583,1842,0.051400194328452505,19386,858,12,0,870,64137,0.01838378618992083,23523,8,846,537,0.09766379423073332,545,2231,0,911,38,529,3180,1320,0.0668226416412824,383665,215082,
1225,0.1191833944181362,15,704,521,1944,35836,42909,634583,0.053003835897014955,168583,1842,0.051400194328452505,19386,858,12,0,870,64137,0.01838378618992083,23523,8,846,537,0.09766379423073332,545,2231,0,911,38,529,3180,1320,0.0668226416412824,383665,215082,
1225,0.03969912244045132,15,704,521,1944,35836,42909,634583,0.053003835897014955,168583,1842,0.051400194328452505,19386,12,106,0,118,64137,0.01838378618992083,23523,95,-94,0,0.03209235269104168,95,2231,0,911,38,-95,3180,1320,0.0668226416412824,383665,215082,
1225,0.06430496726992684,15,704,521,1944,35836,42909,634583,0.053003835897014955,168583,1842,0.051400194328452505,19386,23,173,0,196,64137,0.01838378618992083,23523,167,-150,0,0.05383945106562985,167,2231,0,911,38,-167,3180,1320,0.0668226416412824,383665,215082,
1225,9.560229445506692E-4,15,704,521,1944,35836,42909,634583,0.053003835897014955,168583,1842,0.051400194328452505,19386,62,29,19,110,64137,0.01838378618992083,23523,1,33,2,0.12349864551130456,3,2231,0,911,38,1,3180,1320,0.0668226416412824,383665,215082,
1225,0.0933456561922366,15,704,521,1944,35836,42909,634583,0.053003835897014955,168583,1842,0.051400194328452505,19386,51,318,0,369,64137,0.01838378618992083,23523,303,-267,0,0.11430659311892472,303,2231,0,911,38,-303,3180,1320,0.0668226416412824,383665,215082,
213,0.0,20,17,196,250,35836,42909,634583,0.019104433017113717,168583,1842,0.051400194328452505,19386,16,0,0,16,64137,0.01838378618992083,23523,0,16,0,0.2318840579710145,0,1789,0,128,23,0,1940,1661,0.08905636883972806,383665,215082,
213,0.0,20,17,196,250,35836,42909,634583,0.019104433017113717,168583,1842,0.051400194328452505,19386,377,13,0,390,64137,0.01838378618992083,23523,0,364,0,0.03314404321695189,0,1789,0,128,23,0,1940,1661,0.08905636883972806,383665,215082,
213,0.2617601246105919,20,17,196,250,35836,42909,634583,0.019104433017113717,168583,1842,0.051400194328452505,19386,291,14,12,317,64137,0.01838378618992083,23523,5,277,154,0.08927329764699436,169,1789,10,128,23,149,1940,1661,0.08905636883972806,383665,215082,
213,0.2617601246105919,20,17,196,250,35836,42909,634583,0.019104433017113717,168583,1842,0.051400194328452505,19386,291,14,12,317,64137,0.01838378618992083,23523,5,277,154,0.08927329764699436,169,1789,10,128,23,149,1940,1661,0.08905636883972806,383665,215082,
213,0.0,20,17,196,250,35836,42909,634583,0.019104433017113717,168583,1842,0.051400194328452505,19386,65,0,0,65,64137,0.01838378618992083,23523,0,65,0,0.10139032529773646,0,1789,0,128,23,0,1940,1661,0.08905636883972806,383665,215082,
213,0.0,20,17,196,250,35836,42909,634583,0.019104433017113717,168583,1842,0.051400194328452505,19386,65,0,0,65,64137,0.01838378618992083,23523,0,65,0,0.10139032529773646,0,1789,0,128,23,0,1940,1661,0.08905636883972806,383665,215082,
213,0.05415860735009671,20,17,196,250,35836,42909,634583,0.019104433017113717,168583,1842,0.051400194328452505,19386,43,2,7,52,64137,0.01838378618992083,23523,2,41,19,0.10551067622406796,28,1789,7,128,23,17,1940,1661,0.08905636883972806,383665,215082,
82,0.023121387283236993,13,105,-23,200,35836,42909,634583,0.01729673636857079,168583,1842,0.051400194328452505,19386,39,6,0,45,64137,0.01838378618992083,23523,2,33,2,0.0443481192585852,4,2526,0,186,17,0,2729,2340,0.06514269471696578,383665,215082,
82,0.0,13,105,-23,200,35836,42909,634583,0.01729673636857079,168583,1842,0.051400194328452505,19386,31,10,4,45,64137,0.01838378618992083,23523,0,21,0,0.03267388154012057,0,2526,0,186,17,0,2729,2340,0.06514269471696578,383665,215082,
82,0.0,13,105,-23,200,35836,42909,634583,0.01729673636857079,168583,1842,0.051400194328452505,19386,31,10,4,45,64137,0.01838378618992083,23523,0,21,0,0.03267388154012057,0,2526,0,186,17,0,2729,2340,0.06514269471696578,383665,215082,
82,0.04556962025316456,13,105,-23,200,35836,42909,634583,0.01729673636857079,168583,1842,0.051400194328452505,19386,90,1,0,91,64137,0.01838378618992083,23523,1,89,17,0.32950749920221256,18,2526,0,186,17,16,2729,2340,0.06514269471696578,383665,215082,
82,0.04556962025316456,13,105,-23,200,35836,42909,634583,0.01729673636857079,168583,1842,0.051400194328452505,19386,90,1,0,91,64137,0.01838378618992083,23523,1,89,17,0.32950749920221256,18,2526,0,186,17,16,2729,2340,0.06514269471696578,383665,215082,
82,0.04556962025316456,13,105,-23,200,35836,42909,634583,0.01729673636857079,168583,1842,0.051400194328452505,19386,90,1,0,91,64137,0.01838378618992083,23523,1,89,17,0.32950749920221256,18,2526,0,186,17,16,2729,2340,0.06514269471696578,383665,215082,
82,0.04556962025316456,13,105,-23,200,35836,42909,634583,0.01729673636857079,168583,1842,0.051400194328452505,19386,90,1,0,91,64137,0.01838378618992083,23523,1,89,17,0.32950749920221256,18,2526,0,186,17,16,2729,2340,0.06514269471696578,383665,215082,
82,0.04556962025316456,13,105,-23,200,35836,42909,634583,0.01729673636857079,168583,1842,0.051400194328452505,19386,90,1,0,91,64137,0.01838378618992083,23523,1,89,17,0.32950749920221256,18,2526,0,186,17,16,2729,2340,0.06514269471696578,383665,215082,
0,0.0,0,0,0,0,35836,42909,634583,0.0,168583,1842,0.051400194328452505,19386,120,1,1,122,64137,0.01838378618992083,23523,0,119,0,0.05762375568299645,0,306,0,1,1,0,308,305,0.05264640377053217,383665,215082,
0,0.0,0,0,0,0,35836,42909,634583,0.0,168583,1842,0.051400194328452505,19386,120,1,1,122,64137,0.01838378618992083,23523,0,119,0,0.05762375568299645,0,306,0,1,1,0,308,305,0.05264640377053217,383665,215082,
0,0.0,0,0,0,0,35836,42909,634583,0.0,168583,1842,0.051400194328452505,19386,186,0,0,186,64137,0.01838378618992083,23523,0,186,0,0.047669051858067885,0,306,0,1,1,0,308,305,0.05264640377053217,383665,215082,
0,0.0,0,0,0,0,35836,42909,634583,0.0,168583,1842,0.051400194328452505,19386,186,0,0,186,64137,0.01838378618992083,23523,0,186,0,0.047669051858067885,0,306,0,1,1,0,308,305,0.05264640377053217,383665,215082,
