F41,F40,F43,F42,F45,F44,F140,F47,F141,F46,F142,F49,F143,F48,F126,F127,F128,F129,F50,F52,F51,F36,F130,F35,F131,F38,F132,F37,F133,F134,F39,F135,F136,F137,F138,F139,
0,0.0,0,0,0,0,128664,8190,492706,0.0,153880,552,0.09502848749426634,8798,0,0,0,0,17540,0.01938949306265632,-608,0,0,0,0.0,0,0,0,0,0,0,0,0,0.0,258961,105081,
4,0.0,3,0,4,7,128664,8190,492706,0.009510869565217392,153880,552,0.09502848749426634,8798,255,17,3,275,17540,0.01938949306265632,-608,0,238,0,0.08569036486321428,0,3528,0,1129,825,0,5482,2399,0.06903710783529243,258961,105081,
4,0.0,3,0,4,7,128664,8190,492706,0.009510869565217392,153880,552,0.09502848749426634,8798,100,53,137,290,17540,0.01938949306265632,-608,0,47,0,0.01728740581823983,0,3528,0,1129,825,0,5482,2399,0.06903710783529243,258961,105081,
4,0.0,3,0,4,7,128664,8190,492706,0.009510869565217392,153880,552,0.09502848749426634,8798,100,53,137,290,17540,0.01938949306265632,-608,0,47,0,0.01728740581823983,0,3528,0,1129,825,0,5482,2399,0.06903710783529243,258961,105081,
0,0.0,0,0,0,0,128664,8190,492706,0.0,153880,552,0.09502848749426634,8798,78,15,312,405,17540,0.01938949306265632,-608,0,63,0,0.09479868891526508,0,1327,0,514,2428,0,4269,813,0.021736404656336375,258961,105081,
0,0.0,0,0,0,0,128664,8190,492706,0.0,153880,552,0.09502848749426634,8798,79,62,231,372,17540,0.01938949306265632,-608,0,17,0,0.022609967470655457,0,1327,0,514,2428,0,4269,813,0.021736404656336375,258961,105081,
6,0.2962962962962963,0,6,0,12,128664,8190,492706,0.017806267806267803,153880,552,0.09502848749426634,8798,34,4,0,38,17540,0.01938949306265632,-608,4,30,4,0.15407934625016476,8,840,0,116,23,0,979,724,0.18001252124232536,258961,105081,
0,0.0,0,0,0,0,128664,8190,492706,0.0,153880,552,0.09502848749426634,8798,251,22,3,276,17540,0.01938949306265632,-608,0,229,0,0.11706651383159183,0,1226,0,212,740,0,2178,1014,0.08054472593063824,258961,105081,
0,0.0,0,0,0,0,128664,8190,492706,0.0,153880,552,0.09502848749426634,8798,251,22,3,276,17540,0.01938949306265632,-608,0,229,0,0.11706651383159183,0,1226,0,212,740,0,2178,1014,0.08054472593063824,258961,105081,
0,0.0,0,0,0,0,128664,8190,492706,0.0,153880,552,0.09502848749426634,8798,251,22,3,276,17540,0.01938949306265632,-608,0,229,0,0.11706651383159183,0,1226,0,212,740,0,2178,1014,0.08054472593063824,258961,105081,
0,0.0,0,0,0,0,128664,8190,492706,0.0,153880,552,0.09502848749426634,8798,251,22,3,276,17540,0.01938949306265632,-608,0,229,0,0.11706651383159183,0,1226,0,212,740,0,2178,1014,0.08054472593063824,258961,105081,
0,0.0,0,0,0,0,128664,8190,492706,0.0,153880,552,0.09502848749426634,8798,8,7,321,336,17540,0.01938949306265632,-608,0,1,0,0.0474241268590055,0,1226,0,212,740,0,2178,1014,0.08054472593063824,258961,105081,
0,0.0,0,0,0,0,128664,8190,492706,0.0,153880,552,0.09502848749426634,8798,8,7,321,336,17540,0.01938949306265632,-608,0,1,0,0.0474241268590055,0,1226,0,212,740,0,2178,1014,0.08054472593063824,258961,105081,
0,0.0,0,0,0,0,128664,8190,492706,0.0,153880,552,0.09502848749426634,8798,5,5,73,83,17540,0.01938949306265632,-608,0,0,0,0.01713981568336345,0,1226,0,212,740,0,2178,1014,0.08054472593063824,258961,105081,
0,0.0,0,0,0,0,128664,8190,492706,0.0,153880,552,0.09502848749426634,8798,161,0,0,161,17540,0.01938949306265632,-608,0,161,0,0.3788235294117647,0,1843,0,319,764,0,2926,1524,0.07543626361478753,258961,105081,
0,0.0,0,0,0,0,128664,8190,492706,0.0,153880,552,0.09502848749426634,8798,178,9,182,369,17540,0.01938949306265632,-608,0,169,0,0.039914645963655196,0,1843,0,319,764,0,2926,1524,0.07543626361478753,258961,105081,
0,0.0,0,0,0,0,128664,8190,492706,0.0,153880,552,0.09502848749426634,8798,190,7,7,204,17540,0.01938949306265632,-608,0,183,0,0.012851134454999273,0,1843,0,319,764,0,2926,1524,0.07543626361478753,258961,105081,
0,0.0,0,0,0,0,128664,8190,492706,0.0,153880,552,0.09502848749426634,8798,641,34,1,676,17540,0.01938949306265632,-608,0,607,0,0.06717458985701424,0,1843,0,319,764,0,2926,1524,0.07543626361478753,258961,105081,
0,0.0,0,0,0,0,128664,8190,492706,0.0,153880,552,0.09502848749426634,8798,641,34,1,676,17540,0.01938949306265632,-608,0,607,0,0.06717458985701424,0,1843,0,319,764,0,2926,1524,0.07543626361478753,258961,105081,
0,0.0,0,0,0,0,128664,8190,492706,0.0,153880,552,0.09502848749426634,8798,641,34,1,676,17540,0.01938949306265632,-608,0,607,0,0.06717458985701424,0,1843,0,319,764,0,2926,1524,0.07543626361478753,258961,105081,
0,0.0,0,0,0,0,128664,8190,492706,0.0,153880,552,0.09502848749426634,8798,641,34,1,676,17540,0.01938949306265632,-608,0,607,0,0.06717458985701424,0,1843,0,319,764,0,2926,1524,0.07543626361478753,258961,105081,
103,0.2767411356520268,3,128,-25,234,128664,8190,492706,0.09296450200796466,153880,552,0.09502848749426634,8798,919,155,62,1136,17540,0.01938949306265632,-608,17,764,56,0.17661476076239233,73,3007,0,1147,1674,39,5828,1860,0.1424757625808926,258961,105081,
103,0.1433445819272591,3,128,-25,234,128664,8190,492706,0.09296450200796466,153880,552,0.09502848749426634,8798,418,216,379,1013,17540,0.01938949306265632,-608,8,202,6,0.15335723890068242,14,3007,0,1147,1674,-2,5828,1860,0.1424757625808926,258961,105081,
103,0.051566331139501875,3,128,-25,234,128664,8190,492706,0.09296450200796466,153880,552,0.09502848749426634,8798,226,100,456,782,17540,0.01938949306265632,-608,6,126,13,0.1539446079629724,20,3007,1,1147,1674,7,5828,1860,0.1424757625808926,258961,105081,
103,0.1875,3,128,-25,234,128664,8190,492706,0.09296450200796466,153880,552,0.09502848749426634,8798,205,287,590,1082,17540,0.01938949306265632,-608,2,-82,1,0.19034650574717213,3,3007,0,1147,1674,-1,5828,1860,0.1424757625808926,258961,105081,
103,0.1875,3,128,-25,234,128664,8190,492706,0.09296450200796466,153880,552,0.09502848749426634,8798,205,287,590,1082,17540,0.01938949306265632,-608,2,-82,1,0.19034650574717213,3,3007,0,1147,1674,-1,5828,1860,0.1424757625808926,258961,105081,
103,0.1875,3,128,-25,234,128664,8190,492706,0.09296450200796466,153880,552,0.09502848749426634,8798,205,287,590,1082,17540,0.01938949306265632,-608,2,-82,1,0.19034650574717213,3,3007,0,1147,1674,-1,5828,1860,0.1424757625808926,258961,105081,
103,0.007407407407407408,3,128,-25,234,128664,8190,492706,0.09296450200796466,153880,552,0.09502848749426634,8798,201,47,2,250,17540,0.01938949306265632,-608,0,154,1,0.08362197981214466,1,3007,0,1147,1674,1,5828,1860,0.1424757625808926,258961,105081,
103,0.007407407407407408,3,128,-25,234,128664,8190,492706,0.09296450200796466,153880,552,0.09502848749426634,8798,201,47,2,250,17540,0.01938949306265632,-608,0,154,1,0.08362197981214466,1,3007,0,1147,1674,1,5828,1860,0.1424757625808926,258961,105081,
103,0.007407407407407408,3,128,-25,234,128664,8190,492706,0.09296450200796466,153880,552,0.09502848749426634,8798,201,47,2,250,17540,0.01938949306265632,-608,0,154,1,0.08362197981214466,1,3007,0,1147,1674,1,5828,1860,0.1424757625808926,258961,105081,
103,0.007407407407407408,3,128,-25,234,128664,8190,492706,0.09296450200796466,153880,552,0.09502848749426634,8798,201,47,2,250,17540,0.01938949306265632,-608,0,154,1,0.08362197981214466,1,3007,0,1147,1674,1,5828,1860,0.1424757625808926,258961,105081,
103,0.007407407407407408,3,128,-25,234,128664,8190,492706,0.09296450200796466,153880,552,0.09502848749426634,8798,201,47,2,250,17540,0.01938949306265632,-608,0,154,1,0.08362197981214466,1,3007,0,1147,1674,1,5828,1860,0.1424757625808926,258961,105081,
103,0.0,3,128,-25,234,128664,8190,492706,0.09296450200796466,153880,552,0.09502848749426634,8798,102,0,0,102,17540,0.01938949306265632,-608,0,102,0,0.26842105263157895,0,3007,0,1147,1674,0,5828,1860,0.1424757625808926,258961,105081,
103,0.0,3,128,-25,234,128664,8190,492706,0.09296450200796466,153880,552,0.09502848749426634,8798,102,0,0,102,17540,0.01938949306265632,-608,0,102,0,0.26842105263157895,0,3007,0,1147,1674,0,5828,1860,0.1424757625808926,258961,105081,
103,0.013283828382838283,3,128,-25,234,128664,8190,492706,0.09296450200796466,153880,552,0.09502848749426634,8798,296,37,4,337,17540,0.01938949306265632,-608,3,259,2,0.180556691576619,5,3007,0,1147,1674,-1,5828,1860,0.1424757625808926,258961,105081,
22,0.13333333333333333,10,15,7,47,128664,8190,492706,0.05121178721031931,153880,552,0.09502848749426634,8798,1131,297,990,2418,17540,0.01938949306265632,-608,1,834,1,0.20616289742441235,2,9328,0,2235,6022,0,17585,7093,0.10879670833165062,258961,105081,
22,0.18930817610062894,10,15,7,47,128664,8190,492706,0.05121178721031931,153880,552,0.09502848749426634,8798,1299,567,221,2087,17540,0.01938949306265632,-608,1,732,4,0.23261937256927073,15,9328,10,2235,6022,3,17585,7093,0.10879670833165062,258961,105081,
22,0.18930817610062894,10,15,7,47,128664,8190,492706,0.05121178721031931,153880,552,0.09502848749426634,8798,1299,567,221,2087,17540,0.01938949306265632,-608,1,732,4,0.23261937256927073,15,9328,10,2235,6022,3,17585,7093,0.10879670833165062,258961,105081,
22,0.18930817610062894,10,15,7,47,128664,8190,492706,0.05121178721031931,153880,552,0.09502848749426634,8798,1299,567,221,2087,17540,0.01938949306265632,-608,1,732,4,0.23261937256927073,15,9328,10,2235,6022,3,17585,7093,0.10879670833165062,258961,105081,
22,0.0,10,15,7,47,128664,8190,492706,0.05121178721031931,153880,552,0.09502848749426634,8798,12,1,147,160,17540,0.01938949306265632,-608,0,11,0,0.039159870531581,0,9328,0,2235,6022,0,17585,7093,0.10879670833165062,258961,105081,
22,0.17647058823529413,10,15,7,47,128664,8190,492706,0.05121178721031931,153880,552,0.09502848749426634,8798,2901,562,2095,5558,17540,0.01938949306265632,-608,1,2339,5,0.15699124005297252,6,9328,0,2235,6022,4,17585,7093,0.10879670833165062,258961,105081,
22,0.17647058823529413,10,15,7,47,128664,8190,492706,0.05121178721031931,153880,552,0.09502848749426634,8798,2901,562,2095,5558,17540,0.01938949306265632,-608,1,2339,5,0.15699124005297252,6,9328,0,2235,6022,4,17585,7093,0.10879670833165062,258961,105081,
22,0.17647058823529413,10,15,7,47,128664,8190,492706,0.05121178721031931,153880,552,0.09502848749426634,8798,2901,562,2095,5558,17540,0.01938949306265632,-608,1,2339,5,0.15699124005297252,6,9328,0,2235,6022,4,17585,7093,0.10879670833165062,258961,105081,
22,0.17647058823529413,10,15,7,47,128664,8190,492706,0.05121178721031931,153880,552,0.09502848749426634,8798,2901,562,2095,5558,17540,0.01938949306265632,-608,1,2339,5,0.15699124005297252,6,9328,0,2235,6022,4,17585,7093,0.10879670833165062,258961,105081,
22,0.17647058823529413,10,15,7,47,128664,8190,492706,0.05121178721031931,153880,552,0.09502848749426634,8798,2901,562,2095,5558,17540,0.01938949306265632,-608,1,2339,5,0.15699124005297252,6,9328,0,2235,6022,4,17585,7093,0.10879670833165062,258961,105081,
22,0.17647058823529413,10,15,7,47,128664,8190,492706,0.05121178721031931,153880,552,0.09502848749426634,8798,2901,562,2095,5558,17540,0.01938949306265632,-608,1,2339,5,0.15699124005297252,6,9328,0,2235,6022,4,17585,7093,0.10879670833165062,258961,105081,
22,0.17647058823529413,10,15,7,47,128664,8190,492706,0.05121178721031931,153880,552,0.09502848749426634,8798,2901,562,2095,5558,17540,0.01938949306265632,-608,1,2339,5,0.15699124005297252,6,9328,0,2235,6022,4,17585,7093,0.10879670833165062,258961,105081,
22,0.17647058823529413,10,15,7,47,128664,8190,492706,0.05121178721031931,153880,552,0.09502848749426634,8798,2901,562,2095,5558,17540,0.01938949306265632,-608,1,2339,5,0.15699124005297252,6,9328,0,2235,6022,4,17585,7093,0.10879670833165062,258961,105081,
22,0.1774193548387097,10,15,7,47,128664,8190,492706,0.05121178721031931,153880,552,0.09502848749426634,8798,1542,260,1211,3013,17540,0.01938949306265632,-608,11,1282,11,0.14206697822785577,22,9328,0,2235,6022,0,17585,7093,0.10879670833165062,258961,105081,
22,0.1774193548387097,10,15,7,47,128664,8190,492706,0.05121178721031931,153880,552,0.09502848749426634,8798,1542,260,1211,3013,17540,0.01938949306265632,-608,11,1282,11,0.14206697822785577,22,9328,0,2235,6022,0,17585,7093,0.10879670833165062,258961,105081,
99,0.0,11,70,29,180,128664,8190,492706,0.04246621218708231,153880,552,0.09502848749426634,8798,712,93,29,834,17540,0.01938949306265632,-608,0,619,0,0.08083324245772158,0,17519,0,5711,10510,0,33740,11808,0.12424781513879357,258961,105081,
99,0.0,11,70,29,180,128664,8190,492706,0.04246621218708231,153880,552,0.09502848749426634,8798,712,93,29,834,17540,0.01938949306265632,-608,0,619,0,0.08083324245772158,0,17519,0,5711,10510,0,33740,11808,0.12424781513879357,258961,105081,
99,0.0,11,70,29,180,128664,8190,492706,0.04246621218708231,153880,552,0.09502848749426634,8798,712,93,29,834,17540,0.01938949306265632,-608,0,619,0,0.08083324245772158,0,17519,0,5711,10510,0,33740,11808,0.12424781513879357,258961,105081,
99,0.0,11,70,29,180,128664,8190,492706,0.04246621218708231,153880,552,0.09502848749426634,8798,712,93,29,834,17540,0.01938949306265632,-608,0,619,0,0.08083324245772158,0,17519,0,5711,10510,0,33740,11808,0.12424781513879357,258961,105081,
99,0.07142857142857142,11,70,29,180,128664,8190,492706,0.04246621218708231,153880,552,0.09502848749426634,8798,215,101,22,338,17540,0.01938949306265632,-608,1,114,0,0.12394632987269157,1,17519,0,5711,10510,-1,33740,11808,0.12424781513879357,258961,105081,
99,0.07142857142857142,11,70,29,180,128664,8190,492706,0.04246621218708231,153880,552,0.09502848749426634,8798,215,101,22,338,17540,0.01938949306265632,-608,1,114,0,0.12394632987269157,1,17519,0,5711,10510,-1,33740,11808,0.12424781513879357,258961,105081,
99,0.07142857142857142,11,70,29,180,128664,8190,492706,0.04246621218708231,153880,552,0.09502848749426634,8798,215,101,22,338,17540,0.01938949306265632,-608,1,114,0,0.12394632987269157,1,17519,0,5711,10510,-1,33740,11808,0.12424781513879357,258961,105081,
99,0.12962962962962962,11,70,29,180,128664,8190,492706,0.04246621218708231,153880,552,0.09502848749426634,8798,59,82,311,452,17540,0.01938949306265632,-608,14,-23,14,0.12801121948280916,28,17519,0,5711,10510,0,33740,11808,0.12424781513879357,258961,105081,
99,0.12962962962962962,11,70,29,180,128664,8190,492706,0.04246621218708231,153880,552,0.09502848749426634,8798,59,82,311,452,17540,0.01938949306265632,-608,14,-23,14,0.12801121948280916,28,17519,0,5711,10510,0,33740,11808,0.12424781513879357,258961,105081,
99,0.12962962962962962,11,70,29,180,128664,8190,492706,0.04246621218708231,153880,552,0.09502848749426634,8798,59,82,311,452,17540,0.01938949306265632,-608,14,-23,14,0.12801121948280916,28,17519,0,5711,10510,0,33740,11808,0.12424781513879357,258961,105081,
99,0.12962962962962962,11,70,29,180,128664,8190,492706,0.04246621218708231,153880,552,0.09502848749426634,8798,59,82,311,452,17540,0.01938949306265632,-608,14,-23,14,0.12801121948280916,28,17519,0,5711,10510,0,33740,11808,0.12424781513879357,258961,105081,
99,0.12962962962962962,11,70,29,180,128664,8190,492706,0.04246621218708231,153880,552,0.09502848749426634,8798,59,82,311,452,17540,0.01938949306265632,-608,14,-23,14,0.12801121948280916,28,17519,0,5711,10510,0,33740,11808,0.12424781513879357,258961,105081,
99,0.12962962962962962,11,70,29,180,128664,8190,492706,0.04246621218708231,153880,552,0.09502848749426634,8798,59,82,311,452,17540,0.01938949306265632,-608,14,-23,14,0.12801121948280916,28,17519,0,5711,10510,0,33740,11808,0.12424781513879357,258961,105081,
99,0.07692307692307693,11,70,29,180,128664,8190,492706,0.04246621218708231,153880,552,0.09502848749426634,8798,79,46,713,838,17540,0.01938949306265632,-608,11,33,11,0.07966377821152434,22,17519,0,5711,10510,0,33740,11808,0.12424781513879357,258961,105081,
99,0.0,11,70,29,180,128664,8190,492706,0.04246621218708231,153880,552,0.09502848749426634,8798,0,0,0,0,17540,0.01938949306265632,-608,0,0,0,0.0,0,17519,0,5711,10510,0,33740,11808,0.12424781513879357,258961,105081,
99,0.18087557603686638,11,70,29,180,128664,8190,492706,0.04246621218708231,153880,552,0.09502848749426634,8798,263,119,128,510,17540,0.01938949306265632,-608,5,144,4,0.18723396207617235,11,17519,2,5711,10510,-1,33740,11808,0.12424781513879357,258961,105081,
99,0.18087557603686638,11,70,29,180,128664,8190,492706,0.04246621218708231,153880,552,0.09502848749426634,8798,263,119,128,510,17540,0.01938949306265632,-608,5,144,4,0.18723396207617235,11,17519,2,5711,10510,-1,33740,11808,0.12424781513879357,258961,105081,
99,0.18087557603686638,11,70,29,180,128664,8190,492706,0.04246621218708231,153880,552,0.09502848749426634,8798,263,119,128,510,17540,0.01938949306265632,-608,5,144,4,0.18723396207617235,11,17519,2,5711,10510,-1,33740,11808,0.12424781513879357,258961,105081,
99,0.18087557603686638,11,70,29,180,128664,8190,492706,0.04246621218708231,153880,552,0.09502848749426634,8798,263,119,128,510,17540,0.01938949306265632,-608,5,144,4,0.18723396207617235,11,17519,2,5711,10510,-1,33740,11808,0.12424781513879357,258961,105081,
99,0.18087557603686638,11,70,29,180,128664,8190,492706,0.04246621218708231,153880,552,0.09502848749426634,8798,263,119,128,510,17540,0.01938949306265632,-608,5,144,4,0.18723396207617235,11,17519,2,5711,10510,-1,33740,11808,0.12424781513879357,258961,105081,
99,0.18087557603686638,11,70,29,180,128664,8190,492706,0.04246621218708231,153880,552,0.09502848749426634,8798,263,119,128,510,17540,0.01938949306265632,-608,5,144,4,0.18723396207617235,11,17519,2,5711,10510,-1,33740,11808,0.12424781513879357,258961,105081,
99,0.18087557603686638,11,70,29,180,128664,8190,492706,0.04246621218708231,153880,552,0.09502848749426634,8798,263,119,128,510,17540,0.01938949306265632,-608,5,144,4,0.18723396207617235,11,17519,2,5711,10510,-1,33740,11808,0.12424781513879357,258961,105081,
99,0.18087557603686638,11,70,29,180,128664,8190,492706,0.04246621218708231,153880,552,0.09502848749426634,8798,263,119,128,510,17540,0.01938949306265632,-608,5,144,4,0.18723396207617235,11,17519,2,5711,10510,-1,33740,11808,0.12424781513879357,258961,105081,
99,0.18087557603686638,11,70,29,180,128664,8190,492706,0.04246621218708231,153880,552,0.09502848749426634,8798,263,119,128,510,17540,0.01938949306265632,-608,5,144,4,0.18723396207617235,11,17519,2,5711,10510,-1,33740,11808,0.12424781513879357,258961,105081,
99,0.18087557603686638,11,70,29,180,128664,8190,492706,0.04246621218708231,153880,552,0.09502848749426634,8798,263,119,128,510,17540,0.01938949306265632,-608,5,144,4,0.18723396207617235,11,17519,2,5711,10510,-1,33740,11808,0.12424781513879357,258961,105081,
99,0.18087557603686638,11,70,29,180,128664,8190,492706,0.04246621218708231,153880,552,0.09502848749426634,8798,263,119,128,510,17540,0.01938949306265632,-608,5,144,4,0.18723396207617235,11,17519,2,5711,10510,-1,33740,11808,0.12424781513879357,258961,105081,
99,0.4,11,70,29,180,128664,8190,492706,0.04246621218708231,153880,552,0.09502848749426634,8798,686,337,77,1100,17540,0.01938949306265632,-608,3,349,7,0.23790143505099678,10,17519,0,5711,10510,4,33740,11808,0.12424781513879357,258961,105081,
99,0.4,11,70,29,180,128664,8190,492706,0.04246621218708231,153880,552,0.09502848749426634,8798,686,337,77,1100,17540,0.01938949306265632,-608,3,349,7,0.23790143505099678,10,17519,0,5711,10510,4,33740,11808,0.12424781513879357,258961,105081,
99,0.4,11,70,29,180,128664,8190,492706,0.04246621218708231,153880,552,0.09502848749426634,8798,686,337,77,1100,17540,0.01938949306265632,-608,3,349,7,0.23790143505099678,10,17519,0,5711,10510,4,33740,11808,0.12424781513879357,258961,105081,
99,0.0,11,70,29,180,128664,8190,492706,0.04246621218708231,153880,552,0.09502848749426634,8798,312,367,103,782,17540,0.01938949306265632,-608,0,-55,0,0.17743708550886503,0,17519,0,5711,10510,0,33740,11808,0.12424781513879357,258961,105081,
99,0.0,11,70,29,180,128664,8190,492706,0.04246621218708231,153880,552,0.09502848749426634,8798,847,289,195,1331,17540,0.01938949306265632,-608,0,558,0,0.28282844996929,0,17519,0,5711,10510,0,33740,11808,0.12424781513879357,258961,105081,
99,0.0,11,70,29,180,128664,8190,492706,0.04246621218708231,153880,552,0.09502848749426634,8798,847,289,195,1331,17540,0.01938949306265632,-608,0,558,0,0.28282844996929,0,17519,0,5711,10510,0,33740,11808,0.12424781513879357,258961,105081,
99,0.0,11,70,29,180,128664,8190,492706,0.04246621218708231,153880,552,0.09502848749426634,8798,847,289,195,1331,17540,0.01938949306265632,-608,0,558,0,0.28282844996929,0,17519,0,5711,10510,0,33740,11808,0.12424781513879357,258961,105081,
99,0.0,11,70,29,180,128664,8190,492706,0.04246621218708231,153880,552,0.09502848749426634,8798,847,289,195,1331,17540,0.01938949306265632,-608,0,558,0,0.28282844996929,0,17519,0,5711,10510,0,33740,11808,0.12424781513879357,258961,105081,
99,0.0,11,70,29,180,128664,8190,492706,0.04246621218708231,153880,552,0.09502848749426634,8798,97,41,31,169,17540,0.01938949306265632,-608,0,56,0,0.12667024132415508,0,17519,0,5711,10510,0,33740,11808,0.12424781513879357,258961,105081,
99,0.0,11,70,29,180,128664,8190,492706,0.04246621218708231,153880,552,0.09502848749426634,8798,97,41,31,169,17540,0.01938949306265632,-608,0,56,0,0.12667024132415508,0,17519,0,5711,10510,0,33740,11808,0.12424781513879357,258961,105081,
99,0.0,11,70,29,180,128664,8190,492706,0.04246621218708231,153880,552,0.09502848749426634,8798,97,41,31,169,17540,0.01938949306265632,-608,0,56,0,0.12667024132415508,0,17519,0,5711,10510,0,33740,11808,0.12424781513879357,258961,105081,
99,0.22143744603487478,11,70,29,180,128664,8190,492706,0.04246621218708231,153880,552,0.09502848749426634,8798,5806,1347,4555,11708,17540,0.01938949306265632,-608,28,4459,50,0.2007261451295572,79,17519,1,5711,10510,22,33740,11808,0.12424781513879357,258961,105081,
99,0.22143744603487478,11,70,29,180,128664,8190,492706,0.04246621218708231,153880,552,0.09502848749426634,8798,5806,1347,4555,11708,17540,0.01938949306265632,-608,28,4459,50,0.2007261451295572,79,17519,1,5711,10510,22,33740,11808,0.12424781513879357,258961,105081,
99,0.22143744603487478,11,70,29,180,128664,8190,492706,0.04246621218708231,153880,552,0.09502848749426634,8798,5806,1347,4555,11708,17540,0.01938949306265632,-608,28,4459,50,0.2007261451295572,79,17519,1,5711,10510,22,33740,11808,0.12424781513879357,258961,105081,
99,0.22143744603487478,11,70,29,180,128664,8190,492706,0.04246621218708231,153880,552,0.09502848749426634,8798,5806,1347,4555,11708,17540,0.01938949306265632,-608,28,4459,50,0.2007261451295572,79,17519,1,5711,10510,22,33740,11808,0.12424781513879357,258961,105081,
99,0.22143744603487478,11,70,29,180,128664,8190,492706,0.04246621218708231,153880,552,0.09502848749426634,8798,5806,1347,4555,11708,17540,0.01938949306265632,-608,28,4459,50,0.2007261451295572,79,17519,1,5711,10510,22,33740,11808,0.12424781513879357,258961,105081,
99,0.22143744603487478,11,70,29,180,128664,8190,492706,0.04246621218708231,153880,552,0.09502848749426634,8798,5806,1347,4555,11708,17540,0.01938949306265632,-608,28,4459,50,0.2007261451295572,79,17519,1,5711,10510,22,33740,11808,0.12424781513879357,258961,105081,
99,0.22143744603487478,11,70,29,180,128664,8190,492706,0.04246621218708231,153880,552,0.09502848749426634,8798,5806,1347,4555,11708,17540,0.01938949306265632,-608,28,4459,50,0.2007261451295572,79,17519,1,5711,10510,22,33740,11808,0.12424781513879357,258961,105081,
99,0.22143744603487478,11,70,29,180,128664,8190,492706,0.04246621218708231,153880,552,0.09502848749426634,8798,5806,1347,4555,11708,17540,0.01938949306265632,-608,28,4459,50,0.2007261451295572,79,17519,1,5711,10510,22,33740,11808,0.12424781513879357,258961,105081,
99,0.22143744603487478,11,70,29,180,128664,8190,492706,0.04246621218708231,153880,552,0.09502848749426634,8798,5806,1347,4555,11708,17540,0.01938949306265632,-608,28,4459,50,0.2007261451295572,79,17519,1,5711,10510,22,33740,11808,0.12424781513879357,258961,105081,
99,0.22143744603487478,11,70,29,180,128664,8190,492706,0.04246621218708231,153880,552,0.09502848749426634,8798,5806,1347,4555,11708,17540,0.01938949306265632,-608,28,4459,50,0.2007261451295572,79,17519,1,5711,10510,22,33740,11808,0.12424781513879357,258961,105081,
99,0.22143744603487478,11,70,29,180,128664,8190,492706,0.04246621218708231,153880,552,0.09502848749426634,8798,5806,1347,4555,11708,17540,0.01938949306265632,-608,28,4459,50,0.2007261451295572,79,17519,1,5711,10510,22,33740,11808,0.12424781513879357,258961,105081,
99,0.22143744603487478,11,70,29,180,128664,8190,492706,0.04246621218708231,153880,552,0.09502848749426634,8798,5806,1347,4555,11708,17540,0.01938949306265632,-608,28,4459,50,0.2007261451295572,79,17519,1,5711,10510,22,33740,11808,0.12424781513879357,258961,105081,
99,0.22143744603487478,11,70,29,180,128664,8190,492706,0.04246621218708231,153880,552,0.09502848749426634,8798,5806,1347,4555,11708,17540,0.01938949306265632,-608,28,4459,50,0.2007261451295572,79,17519,1,5711,10510,22,33740,11808,0.12424781513879357,258961,105081,
99,0.22143744603487478,11,70,29,180,128664,8190,492706,0.04246621218708231,153880,552,0.09502848749426634,8798,5806,1347,4555,11708,17540,0.01938949306265632,-608,28,4459,50,0.2007261451295572,79,17519,1,5711,10510,22,33740,11808,0.12424781513879357,258961,105081,
99,0.22143744603487478,11,70,29,180,128664,8190,492706,0.04246621218708231,153880,552,0.09502848749426634,8798,5806,1347,4555,11708,17540,0.01938949306265632,-608,28,4459,50,0.2007261451295572,79,17519,1,5711,10510,22,33740,11808,0.12424781513879357,258961,105081,
99,0.10714285714285714,11,70,29,180,128664,8190,492706,0.04246621218708231,153880,552,0.09502848749426634,8798,733,150,640,1523,17540,0.01938949306265632,-608,0,583,3,0.13073324435307696,3,17519,0,5711,10510,3,33740,11808,0.12424781513879357,258961,105081,
99,0.07162944582299421,11,70,29,180,128664,8190,492706,0.04246621218708231,153880,552,0.09502848749426634,8798,410,156,350,916,17540,0.01938949306265632,-608,3,254,3,0.11246344445653166,6,17519,0,5711,10510,0,33740,11808,0.12424781513879357,258961,105081,
99,0.0,11,70,29,180,128664,8190,492706,0.04246621218708231,153880,552,0.09502848749426634,8798,740,77,620,1437,17540,0.01938949306265632,-608,0,663,0,0.11050798182602767,0,17519,0,5711,10510,0,33740,11808,0.12424781513879357,258961,105081,
99,0.0,11,70,29,180,128664,8190,492706,0.04246621218708231,153880,552,0.09502848749426634,8798,164,180,26,370,17540,0.01938949306265632,-608,0,-16,0,0.13359830926268557,0,17519,0,5711,10510,0,33740,11808,0.12424781513879357,258961,105081,
99,0.009411764705882352,11,70,29,180,128664,8190,492706,0.04246621218708231,153880,552,0.09502848749426634,8798,1685,460,71,2216,17540,0.01938949306265632,-608,2,1225,2,0.1372908006519956,4,17519,0,5711,10510,0,33740,11808,0.12424781513879357,258961,105081,
99,0.009411764705882352,11,70,29,180,128664,8190,492706,0.04246621218708231,153880,552,0.09502848749426634,8798,1685,460,71,2216,17540,0.01938949306265632,-608,2,1225,2,0.1372908006519956,4,17519,0,5711,10510,0,33740,11808,0.12424781513879357,258961,105081,
99,0.009411764705882352,11,70,29,180,128664,8190,492706,0.04246621218708231,153880,552,0.09502848749426634,8798,1685,460,71,2216,17540,0.01938949306265632,-608,2,1225,2,0.1372908006519956,4,17519,0,5711,10510,0,33740,11808,0.12424781513879357,258961,105081,
99,0.009411764705882352,11,70,29,180,128664,8190,492706,0.04246621218708231,153880,552,0.09502848749426634,8798,1685,460,71,2216,17540,0.01938949306265632,-608,2,1225,2,0.1372908006519956,4,17519,0,5711,10510,0,33740,11808,0.12424781513879357,258961,105081,
99,0.009411764705882352,11,70,29,180,128664,8190,492706,0.04246621218708231,153880,552,0.09502848749426634,8798,1685,460,71,2216,17540,0.01938949306265632,-608,2,1225,2,0.1372908006519956,4,17519,0,5711,10510,0,33740,11808,0.12424781513879357,258961,105081,
99,0.009411764705882352,11,70,29,180,128664,8190,492706,0.04246621218708231,153880,552,0.09502848749426634,8798,1685,460,71,2216,17540,0.01938949306265632,-608,2,1225,2,0.1372908006519956,4,17519,0,5711,10510,0,33740,11808,0.12424781513879357,258961,105081,
99,0.009411764705882352,11,70,29,180,128664,8190,492706,0.04246621218708231,153880,552,0.09502848749426634,8798,1685,460,71,2216,17540,0.01938949306265632,-608,2,1225,2,0.1372908006519956,4,17519,0,5711,10510,0,33740,11808,0.12424781513879357,258961,105081,
99,0.009411764705882352,11,70,29,180,128664,8190,492706,0.04246621218708231,153880,552,0.09502848749426634,8798,1685,460,71,2216,17540,0.01938949306265632,-608,2,1225,2,0.1372908006519956,4,17519,0,5711,10510,0,33740,11808,0.12424781513879357,258961,105081,
99,0.009411764705882352,11,70,29,180,128664,8190,492706,0.04246621218708231,153880,552,0.09502848749426634,8798,1685,460,71,2216,17540,0.01938949306265632,-608,2,1225,2,0.1372908006519956,4,17519,0,5711,10510,0,33740,11808,0.12424781513879357,258961,105081,
99,0.009411764705882352,11,70,29,180,128664,8190,492706,0.04246621218708231,153880,552,0.09502848749426634,8798,1685,460,71,2216,17540,0.01938949306265632,-608,2,1225,2,0.1372908006519956,4,17519,0,5711,10510,0,33740,11808,0.12424781513879357,258961,105081,
99,0.009411764705882352,11,70,29,180,128664,8190,492706,0.04246621218708231,153880,552,0.09502848749426634,8798,1685,460,71,2216,17540,0.01938949306265632,-608,2,1225,2,0.1372908006519956,4,17519,0,5711,10510,0,33740,11808,0.12424781513879357,258961,105081,
99,0.009411764705882352,11,70,29,180,128664,8190,492706,0.04246621218708231,153880,552,0.09502848749426634,8798,1685,460,71,2216,17540,0.01938949306265632,-608,2,1225,2,0.1372908006519956,4,17519,0,5711,10510,0,33740,11808,0.12424781513879357,258961,105081,
99,0.009411764705882352,11,70,29,180,128664,8190,492706,0.04246621218708231,153880,552,0.09502848749426634,8798,1685,460,71,2216,17540,0.01938949306265632,-608,2,1225,2,0.1372908006519956,4,17519,0,5711,10510,0,33740,11808,0.12424781513879357,258961,105081,
99,0.009411764705882352,11,70,29,180,128664,8190,492706,0.04246621218708231,153880,552,0.09502848749426634,8798,1685,460,71,2216,17540,0.01938949306265632,-608,2,1225,2,0.1372908006519956,4,17519,0,5711,10510,0,33740,11808,0.12424781513879357,258961,105081,
0,0.0,0,0,0,0,128664,8190,492706,0.0,153880,552,0.09502848749426634,8798,9,3,0,12,17540,0.01938949306265632,-608,0,6,0,0.055635095447870785,0,25,0,19,0,0,44,6,0.26311166537099423,258961,105081,
62,0.36718151035011504,0,13,49,75,128664,8190,492706,0.02261311115649764,153880,552,0.09502848749426634,8798,1061,21,1,1083,17540,0.01938949306265632,-608,12,1040,61,0.3919648228926291,73,4001,0,344,50,49,4395,3657,0.12092477308981484,258961,105081,
62,0.36718151035011504,0,13,49,75,128664,8190,492706,0.02261311115649764,153880,552,0.09502848749426634,8798,1061,21,1,1083,17540,0.01938949306265632,-608,12,1040,61,0.3919648228926291,73,4001,0,344,50,49,4395,3657,0.12092477308981484,258961,105081,
62,0.36718151035011504,0,13,49,75,128664,8190,492706,0.02261311115649764,153880,552,0.09502848749426634,8798,1061,21,1,1083,17540,0.01938949306265632,-608,12,1040,61,0.3919648228926291,73,4001,0,344,50,49,4395,3657,0.12092477308981484,258961,105081,
62,0.36718151035011504,0,13,49,75,128664,8190,492706,0.02261311115649764,153880,552,0.09502848749426634,8798,1061,21,1,1083,17540,0.01938949306265632,-608,12,1040,61,0.3919648228926291,73,4001,0,344,50,49,4395,3657,0.12092477308981484,258961,105081,
62,0.36718151035011504,0,13,49,75,128664,8190,492706,0.02261311115649764,153880,552,0.09502848749426634,8798,1061,21,1,1083,17540,0.01938949306265632,-608,12,1040,61,0.3919648228926291,73,4001,0,344,50,49,4395,3657,0.12092477308981484,258961,105081,
62,0.36718151035011504,0,13,49,75,128664,8190,492706,0.02261311115649764,153880,552,0.09502848749426634,8798,1061,21,1,1083,17540,0.01938949306265632,-608,12,1040,61,0.3919648228926291,73,4001,0,344,50,49,4395,3657,0.12092477308981484,258961,105081,
62,0.0,0,13,49,75,128664,8190,492706,0.02261311115649764,153880,552,0.09502848749426634,8798,102,24,11,137,17540,0.01938949306265632,-608,0,78,0,0.2337374282566735,0,4001,0,344,50,0,4395,3657,0.12092477308981484,258961,105081,
62,0.0,0,13,49,75,128664,8190,492706,0.02261311115649764,153880,552,0.09502848749426634,8798,1499,64,0,1563,17540,0.01938949306265632,-608,0,1435,0,0.22221690496746632,0,4001,0,344,50,0,4395,3657,0.12092477308981484,258961,105081,
62,0.0,0,13,49,75,128664,8190,492706,0.02261311115649764,153880,552,0.09502848749426634,8798,1499,64,0,1563,17540,0.01938949306265632,-608,0,1435,0,0.22221690496746632,0,4001,0,344,50,0,4395,3657,0.12092477308981484,258961,105081,
62,0.0,0,13,49,75,128664,8190,492706,0.02261311115649764,153880,552,0.09502848749426634,8798,65,12,0,77,17540,0.01938949306265632,-608,0,53,0,0.061943267959105805,0,4001,0,344,50,0,4395,3657,0.12092477308981484,258961,105081,
62,0.017241379310344827,0,13,49,75,128664,8190,492706,0.02261311115649764,153880,552,0.09502848749426634,8798,1003,99,12,1114,17540,0.01938949306265632,-608,1,904,1,0.2562886793107182,2,4001,0,344,50,0,4395,3657,0.12092477308981484,258961,105081,
62,0.0,0,13,49,75,128664,8190,492706,0.02261311115649764,153880,552,0.09502848749426634,8798,11,7,0,18,17540,0.01938949306265632,-608,0,4,0,0.04965471937454696,0,4001,0,344,50,0,4395,3657,0.12092477308981484,258961,105081,
0,0.0,0,0,0,0,128664,8190,492706,0.0,153880,552,0.09502848749426634,8798,79,53,7,139,17540,0.01938949306265632,-608,0,26,0,0.1094727952352672,0,317,0,224,17,0,558,93,0.09491908512919717,258961,105081,
0,0.0,0,0,0,0,128664,8190,492706,0.0,153880,552,0.09502848749426634,8798,1,1,2,4,17540,0.01938949306265632,-608,0,0,0,0.002179711948120499,0,216,0,51,14,0,281,165,0.06701850789348986,258961,105081,
0,0.0,0,0,0,0,128664,8190,492706,0.0,153880,552,0.09502848749426634,8798,5,4,3,12,17540,0.01938949306265632,-608,0,1,0,0.020771904455261794,0,216,0,51,14,0,281,165,0.06701850789348986,258961,105081,
0,0.0,0,0,0,0,128664,8190,492706,0.0,153880,552,0.09502848749426634,8798,163,3,0,166,17540,0.01938949306265632,-608,0,160,0,0.11033169529611035,0,216,0,51,14,0,281,165,0.06701850789348986,258961,105081,
0,0.0,0,0,0,0,128664,8190,492706,0.0,153880,552,0.09502848749426634,8798,163,3,0,166,17540,0.01938949306265632,-608,0,160,0,0.11033169529611035,0,216,0,51,14,0,281,165,0.06701850789348986,258961,105081,
0,0.0,0,0,0,0,128664,8190,492706,0.0,153880,552,0.09502848749426634,8798,163,3,0,166,17540,0.01938949306265632,-608,0,160,0,0.11033169529611035,0,216,0,51,14,0,281,165,0.06701850789348986,258961,105081,
10,0.3333333333333333,0,3,7,13,128664,8190,492706,0.3333333333333333,153880,552,0.09502848749426634,8798,103,37,96,236,17540,0.01938949306265632,-608,3,66,10,0.11689949918466412,13,103,0,37,96,7,236,66,0.11689949918466412,258961,105081,
10,0.3333333333333333,0,3,7,13,128664,8190,492706,0.3333333333333333,153880,552,0.09502848749426634,8798,103,37,96,236,17540,0.01938949306265632,-608,3,66,10,0.11689949918466412,13,103,0,37,96,7,236,66,0.11689949918466412,258961,105081,
10,0.3333333333333333,0,3,7,13,128664,8190,492706,0.3333333333333333,153880,552,0.09502848749426634,8798,103,37,96,236,17540,0.01938949306265632,-608,3,66,10,0.11689949918466412,13,103,0,37,96,7,236,66,0.11689949918466412,258961,105081,
10,0.3333333333333333,0,3,7,13,128664,8190,492706,0.3333333333333333,153880,552,0.09502848749426634,8798,103,37,96,236,17540,0.01938949306265632,-608,3,66,10,0.11689949918466412,13,103,0,37,96,7,236,66,0.11689949918466412,258961,105081,
24,0.0,0,9,15,33,128664,8190,492706,0.03144784286648254,153880,552,0.09502848749426634,8798,711,98,667,1476,17540,0.01938949306265632,-608,0,613,0,0.14131892329313947,0,1140,0,179,1329,0,2648,961,0.12482708866834745,258961,105081,
24,0.0,0,9,15,33,128664,8190,492706,0.03144784286648254,153880,552,0.09502848749426634,8798,711,98,667,1476,17540,0.01938949306265632,-608,0,613,0,0.14131892329313947,0,1140,0,179,1329,0,2648,961,0.12482708866834745,258961,105081,
24,0.0,0,9,15,33,128664,8190,492706,0.03144784286648254,153880,552,0.09502848749426634,8798,711,98,667,1476,17540,0.01938949306265632,-608,0,613,0,0.14131892329313947,0,1140,0,179,1329,0,2648,961,0.12482708866834745,258961,105081,
24,0.0,0,9,15,33,128664,8190,492706,0.03144784286648254,153880,552,0.09502848749426634,8798,711,98,667,1476,17540,0.01938949306265632,-608,0,613,0,0.14131892329313947,0,1140,0,179,1329,0,2648,961,0.12482708866834745,258961,105081,
24,0.0,0,9,15,33,128664,8190,492706,0.03144784286648254,153880,552,0.09502848749426634,8798,8,7,85,100,17540,0.01938949306265632,-608,0,1,0,0.010434348970068896,0,1140,0,179,1329,0,2648,961,0.12482708866834745,258961,105081,
24,0.0,0,9,15,33,128664,8190,492706,0.03144784286648254,153880,552,0.09502848749426634,8798,8,7,85,100,17540,0.01938949306265632,-608,0,1,0,0.010434348970068896,0,1140,0,179,1329,0,2648,961,0.12482708866834745,258961,105081,
24,0.0,0,9,15,33,128664,8190,492706,0.03144784286648254,153880,552,0.09502848749426634,8798,8,7,85,100,17540,0.01938949306265632,-608,0,1,0,0.010434348970068896,0,1140,0,179,1329,0,2648,961,0.12482708866834745,258961,105081,
24,0.015503875968992248,0,9,15,33,128664,8190,492706,0.03144784286648254,153880,552,0.09502848749426634,8798,355,26,279,660,17540,0.01938949306265632,-608,1,329,1,0.07789217037207406,2,1140,0,179,1329,0,2648,961,0.12482708866834745,258961,105081,
24,0.015503875968992248,0,9,15,33,128664,8190,492706,0.03144784286648254,153880,552,0.09502848749426634,8798,355,26,279,660,17540,0.01938949306265632,-608,1,329,1,0.07789217037207406,2,1140,0,179,1329,0,2648,961,0.12482708866834745,258961,105081,
0,0.46153846153846156,0,18,-18,18,128664,8190,492706,0.038461538461538464,153880,552,0.09502848749426634,8798,291,295,1414,2000,17540,0.01938949306265632,-608,18,-4,0,0.15916231433489436,18,1516,0,941,3596,-18,6053,575,0.09372421655954648,258961,105081,
0,0.46153846153846156,0,18,-18,18,128664,8190,492706,0.038461538461538464,153880,552,0.09502848749426634,8798,291,295,1414,2000,17540,0.01938949306265632,-608,18,-4,0,0.15916231433489436,18,1516,0,941,3596,-18,6053,575,0.09372421655954648,258961,105081,
0,0.46153846153846156,0,18,-18,18,128664,8190,492706,0.038461538461538464,153880,552,0.09502848749426634,8798,291,295,1414,2000,17540,0.01938949306265632,-608,18,-4,0,0.15916231433489436,18,1516,0,941,3596,-18,6053,575,0.09372421655954648,258961,105081,
0,0.46153846153846156,0,18,-18,18,128664,8190,492706,0.038461538461538464,153880,552,0.09502848749426634,8798,291,295,1414,2000,17540,0.01938949306265632,-608,18,-4,0,0.15916231433489436,18,1516,0,941,3596,-18,6053,575,0.09372421655954648,258961,105081,
0,0.46153846153846156,0,18,-18,18,128664,8190,492706,0.038461538461538464,153880,552,0.09502848749426634,8798,291,295,1414,2000,17540,0.01938949306265632,-608,18,-4,0,0.15916231433489436,18,1516,0,941,3596,-18,6053,575,0.09372421655954648,258961,105081,
0,0.46153846153846156,0,18,-18,18,128664,8190,492706,0.038461538461538464,153880,552,0.09502848749426634,8798,291,295,1414,2000,17540,0.01938949306265632,-608,18,-4,0,0.15916231433489436,18,1516,0,941,3596,-18,6053,575,0.09372421655954648,258961,105081,
0,0.46153846153846156,0,18,-18,18,128664,8190,492706,0.038461538461538464,153880,552,0.09502848749426634,8798,291,295,1414,2000,17540,0.01938949306265632,-608,18,-4,0,0.15916231433489436,18,1516,0,941,3596,-18,6053,575,0.09372421655954648,258961,105081,
0,0.46153846153846156,0,18,-18,18,128664,8190,492706,0.038461538461538464,153880,552,0.09502848749426634,8798,291,295,1414,2000,17540,0.01938949306265632,-608,18,-4,0,0.15916231433489436,18,1516,0,941,3596,-18,6053,575,0.09372421655954648,258961,105081,
0,0.46153846153846156,0,18,-18,18,128664,8190,492706,0.038461538461538464,153880,552,0.09502848749426634,8798,291,295,1414,2000,17540,0.01938949306265632,-608,18,-4,0,0.15916231433489436,18,1516,0,941,3596,-18,6053,575,0.09372421655954648,258961,105081,
0,0.46153846153846156,0,18,-18,18,128664,8190,492706,0.038461538461538464,153880,552,0.09502848749426634,8798,291,295,1414,2000,17540,0.01938949306265632,-608,18,-4,0,0.15916231433489436,18,1516,0,941,3596,-18,6053,575,0.09372421655954648,258961,105081,
0,0.0,0,18,-18,18,128664,8190,492706,0.038461538461538464,153880,552,0.09502848749426634,8798,228,114,649,991,17540,0.01938949306265632,-608,0,114,0,0.146585368318022,0,1516,0,941,3596,0,6053,575,0.09372421655954648,258961,105081,
0,0.0,0,18,-18,18,128664,8190,492706,0.038461538461538464,153880,552,0.09502848749426634,8798,228,114,649,991,17540,0.01938949306265632,-608,0,114,0,0.146585368318022,0,1516,0,941,3596,0,6053,575,0.09372421655954648,258961,105081,
0,0.0,0,18,-18,18,128664,8190,492706,0.038461538461538464,153880,552,0.09502848749426634,8798,71,136,472,679,17540,0.01938949306265632,-608,0,-65,0,0.10268316085912561,0,1516,0,941,3596,0,6053,575,0.09372421655954648,258961,105081,
0,0.0,0,18,-18,18,128664,8190,492706,0.038461538461538464,153880,552,0.09502848749426634,8798,146,9,130,285,17540,0.01938949306265632,-608,0,137,0,0.02082980203385815,0,1516,0,941,3596,0,6053,575,0.09372421655954648,258961,105081,
0,0.0,0,18,-18,18,128664,8190,492706,0.038461538461538464,153880,552,0.09502848749426634,8798,146,9,130,285,17540,0.01938949306265632,-608,0,137,0,0.02082980203385815,0,1516,0,941,3596,0,6053,575,0.09372421655954648,258961,105081,
0,0.0,0,0,0,0,128664,8190,492706,0.0,153880,552,0.09502848749426634,8798,67,76,598,741,17540,0.01938949306265632,-608,0,-9,0,0.08681814504846119,0,359,0,268,1448,0,2075,91,0.05714300537846077,258961,105081,
0,0.0,0,0,0,0,128664,8190,492706,0.0,153880,552,0.09502848749426634,8798,206,174,832,1212,17540,0.01938949306265632,-608,0,32,0,0.12307348351839563,0,359,0,268,1448,0,2075,91,0.05714300537846077,258961,105081,
2,0.0,0,2,0,4,128664,8190,492706,0.007303077725612937,153880,552,0.09502848749426634,8798,1,2,0,3,17540,0.01938949306265632,-608,0,-1,0,0.013953488372093023,0,2457,0,3623,3476,0,9556,-1166,0.11593526305343804,258961,105081,
2,0.0,0,2,0,4,128664,8190,492706,0.007303077725612937,153880,552,0.09502848749426634,8798,1229,3290,2485,7004,17540,0.01938949306265632,-608,0,-2061,0,0.24383887882520408,0,2457,0,3623,3476,0,9556,-1166,0.11593526305343804,258961,105081,
2,0.037037037037037035,0,2,0,4,128664,8190,492706,0.007303077725612937,153880,552,0.09502848749426634,8798,31,7,0,38,17540,0.01938949306265632,-608,1,24,1,0.19892768262333477,2,2457,0,3623,3476,0,9556,-1166,0.11593526305343804,258961,105081,
2,0.037037037037037035,0,2,0,4,128664,8190,492706,0.007303077725612937,153880,552,0.09502848749426634,8798,31,7,0,38,17540,0.01938949306265632,-608,1,24,1,0.19892768262333477,2,2457,0,3623,3476,0,9556,-1166,0.11593526305343804,258961,105081,
2,0.037037037037037035,0,2,0,4,128664,8190,492706,0.007303077725612937,153880,552,0.09502848749426634,8798,31,7,0,38,17540,0.01938949306265632,-608,1,24,1,0.19892768262333477,2,2457,0,3623,3476,0,9556,-1166,0.11593526305343804,258961,105081,
2,0.037037037037037035,0,2,0,4,128664,8190,492706,0.007303077725612937,153880,552,0.09502848749426634,8798,31,7,0,38,17540,0.01938949306265632,-608,1,24,1,0.19892768262333477,2,2457,0,3623,3476,0,9556,-1166,0.11593526305343804,258961,105081,
2,0.037037037037037035,0,2,0,4,128664,8190,492706,0.007303077725612937,153880,552,0.09502848749426634,8798,31,7,0,38,17540,0.01938949306265632,-608,1,24,1,0.19892768262333477,2,2457,0,3623,3476,0,9556,-1166,0.11593526305343804,258961,105081,
2,0.037037037037037035,0,2,0,4,128664,8190,492706,0.007303077725612937,153880,552,0.09502848749426634,8798,31,7,0,38,17540,0.01938949306265632,-608,1,24,1,0.19892768262333477,2,2457,0,3623,3476,0,9556,-1166,0.11593526305343804,258961,105081,
2,0.0,0,2,0,4,128664,8190,492706,0.007303077725612937,153880,552,0.09502848749426634,8798,1105,311,973,2389,17540,0.01938949306265632,-608,0,794,0,0.091338937161288,0,2457,0,3623,3476,0,9556,-1166,0.11593526305343804,258961,105081,
2,0.0,0,2,0,4,128664,8190,492706,0.007303077725612937,153880,552,0.09502848749426634,8798,1105,311,973,2389,17540,0.01938949306265632,-608,0,794,0,0.091338937161288,0,2457,0,3623,3476,0,9556,-1166,0.11593526305343804,258961,105081,
2,0.0,0,2,0,4,128664,8190,492706,0.007303077725612937,153880,552,0.09502848749426634,8798,1105,311,973,2389,17540,0.01938949306265632,-608,0,794,0,0.091338937161288,0,2457,0,3623,3476,0,9556,-1166,0.11593526305343804,258961,105081,
0,0.0,0,0,0,0,128664,8190,492706,0.0,153880,552,0.09502848749426634,8798,518,462,33,1013,17540,0.01938949306265632,-608,0,56,0,0.18489904538160207,0,1633,0,924,85,0,2642,709,0.14771543999809872,258961,105081,
0,0.0,0,0,0,0,128664,8190,492706,0.0,153880,552,0.09502848749426634,8798,518,462,33,1013,17540,0.01938949306265632,-608,0,56,0,0.18489904538160207,0,1633,0,924,85,0,2642,709,0.14771543999809872,258961,105081,
0,0.0,0,0,0,0,128664,8190,492706,0.0,153880,552,0.09502848749426634,8798,518,462,33,1013,17540,0.01938949306265632,-608,0,56,0,0.18489904538160207,0,1633,0,924,85,0,2642,709,0.14771543999809872,258961,105081,
0,0.0,0,0,0,0,128664,8190,492706,0.0,153880,552,0.09502848749426634,8798,518,462,33,1013,17540,0.01938949306265632,-608,0,56,0,0.18489904538160207,0,1633,0,924,85,0,2642,709,0.14771543999809872,258961,105081,
0,0.0,0,0,0,0,128664,8190,492706,0.0,153880,552,0.09502848749426634,8798,518,462,33,1013,17540,0.01938949306265632,-608,0,56,0,0.18489904538160207,0,1633,0,924,85,0,2642,709,0.14771543999809872,258961,105081,
0,0.0,0,0,0,0,128664,8190,492706,0.0,153880,552,0.09502848749426634,8798,518,462,33,1013,17540,0.01938949306265632,-608,0,56,0,0.18489904538160207,0,1633,0,924,85,0,2642,709,0.14771543999809872,258961,105081,
0,0.0,0,0,0,0,128664,8190,492706,0.0,153880,552,0.09502848749426634,8798,518,462,33,1013,17540,0.01938949306265632,-608,0,56,0,0.18489904538160207,0,1633,0,924,85,0,2642,709,0.14771543999809872,258961,105081,
0,0.0,0,0,0,0,128664,8190,492706,0.0,153880,552,0.09502848749426634,8798,518,462,33,1013,17540,0.01938949306265632,-608,0,56,0,0.18489904538160207,0,1633,0,924,85,0,2642,709,0.14771543999809872,258961,105081,
0,0.0,0,0,0,0,128664,8190,492706,0.0,153880,552,0.09502848749426634,8798,518,462,33,1013,17540,0.01938949306265632,-608,0,56,0,0.18489904538160207,0,1633,0,924,85,0,2642,709,0.14771543999809872,258961,105081,
0,0.0,0,0,0,0,128664,8190,492706,0.0,153880,552,0.09502848749426634,8798,518,462,33,1013,17540,0.01938949306265632,-608,0,56,0,0.18489904538160207,0,1633,0,924,85,0,2642,709,0.14771543999809872,258961,105081,
0,0.0,0,0,0,0,128664,8190,492706,0.0,153880,552,0.09502848749426634,8798,518,462,33,1013,17540,0.01938949306265632,-608,0,56,0,0.18489904538160207,0,1633,0,924,85,0,2642,709,0.14771543999809872,258961,105081,
0,0.0,0,0,0,0,128664,8190,492706,0.0,153880,552,0.09502848749426634,8798,341,89,39,469,17540,0.01938949306265632,-608,0,252,0,0.2383292711178609,0,1633,0,924,85,0,2642,709,0.14771543999809872,258961,105081,
0,0.0,0,0,0,0,128664,8190,492706,0.0,153880,552,0.09502848749426634,8798,327,314,9,650,17540,0.01938949306265632,-608,0,13,0,0.16486330216720535,0,1633,0,924,85,0,2642,709,0.14771543999809872,258961,105081,
0,0.0,0,0,0,0,128664,8190,492706,0.0,153880,552,0.09502848749426634,8798,327,314,9,650,17540,0.01938949306265632,-608,0,13,0,0.16486330216720535,0,1633,0,924,85,0,2642,709,0.14771543999809872,258961,105081,
0,0.0,0,0,0,0,128664,8190,492706,0.0,153880,552,0.09502848749426634,8798,327,314,9,650,17540,0.01938949306265632,-608,0,13,0,0.16486330216720535,0,1633,0,924,85,0,2642,709,0.14771543999809872,258961,105081,
0,0.0,0,0,0,0,128664,8190,492706,0.0,153880,552,0.09502848749426634,8798,327,314,9,650,17540,0.01938949306265632,-608,0,13,0,0.16486330216720535,0,1633,0,924,85,0,2642,709,0.14771543999809872,258961,105081,
0,0.0,0,0,0,0,128664,8190,492706,0.0,153880,552,0.09502848749426634,8798,327,314,9,650,17540,0.01938949306265632,-608,0,13,0,0.16486330216720535,0,1633,0,924,85,0,2642,709,0.14771543999809872,258961,105081,
0,0.0,0,0,0,0,128664,8190,492706,0.0,153880,552,0.09502848749426634,8798,327,314,9,650,17540,0.01938949306265632,-608,0,13,0,0.16486330216720535,0,1633,0,924,85,0,2642,709,0.14771543999809872,258961,105081,
0,0.0,0,0,0,0,128664,8190,492706,0.0,153880,552,0.09502848749426634,8798,327,314,9,650,17540,0.01938949306265632,-608,0,13,0,0.16486330216720535,0,1633,0,924,85,0,2642,709,0.14771543999809872,258961,105081,
0,0.0,0,0,0,0,128664,8190,492706,0.0,153880,552,0.09502848749426634,8798,327,314,9,650,17540,0.01938949306265632,-608,0,13,0,0.16486330216720535,0,1633,0,924,85,0,2642,709,0.14771543999809872,258961,105081,
0,0.0,0,0,0,0,128664,8190,492706,0.0,153880,552,0.09502848749426634,8798,327,314,9,650,17540,0.01938949306265632,-608,0,13,0,0.16486330216720535,0,1633,0,924,85,0,2642,709,0.14771543999809872,258961,105081,
0,0.0,0,0,0,0,128664,8190,492706,0.0,153880,552,0.09502848749426634,8798,286,9,0,295,17540,0.01938949306265632,-608,0,277,0,0.030776638619775674,0,1633,0,924,85,0,2642,709,0.14771543999809872,258961,105081,
0,0.0,0,0,0,0,128664,8190,492706,0.0,153880,552,0.09502848749426634,8798,286,9,0,295,17540,0.01938949306265632,-608,0,277,0,0.030776638619775674,0,1633,0,924,85,0,2642,709,0.14771543999809872,258961,105081,
0,0.0,0,0,0,0,128664,8190,492706,0.0,153880,552,0.09502848749426634,8798,68,30,0,98,17540,0.01938949306265632,-608,0,38,0,0.10279793477807249,0,1633,0,924,85,0,2642,709,0.14771543999809872,258961,105081,
0,0.0,0,0,0,0,128664,8190,492706,0.0,153880,552,0.09502848749426634,8798,68,30,0,98,17540,0.01938949306265632,-608,0,38,0,0.10279793477807249,0,1633,0,924,85,0,2642,709,0.14771543999809872,258961,105081,
0,0.0,0,0,0,0,128664,8190,492706,0.0,153880,552,0.09502848749426634,8798,68,30,0,98,17540,0.01938949306265632,-608,0,38,0,0.10279793477807249,0,1633,0,924,85,0,2642,709,0.14771543999809872,258961,105081,
0,0.0,0,0,0,0,128664,8190,492706,0.0,153880,552,0.09502848749426634,8798,68,30,0,98,17540,0.01938949306265632,-608,0,38,0,0.10279793477807249,0,1633,0,924,85,0,2642,709,0.14771543999809872,258961,105081,
0,0.0,0,0,0,0,128664,8190,492706,0.0,153880,552,0.09502848749426634,8798,68,30,0,98,17540,0.01938949306265632,-608,0,38,0,0.10279793477807249,0,1633,0,924,85,0,2642,709,0.14771543999809872,258961,105081,
0,0.0,0,0,0,0,128664,8190,492706,0.0,153880,552,0.09502848749426634,8798,68,30,0,98,17540,0.01938949306265632,-608,0,38,0,0.10279793477807249,0,1633,0,924,85,0,2642,709,0.14771543999809872,258961,105081,
0,0.0,0,0,0,0,128664,8190,492706,0.0,153880,552,0.09502848749426634,8798,68,30,0,98,17540,0.01938949306265632,-608,0,38,0,0.10279793477807249,0,1633,0,924,85,0,2642,709,0.14771543999809872,258961,105081,
0,0.0,0,0,0,0,128664,8190,492706,0.0,153880,552,0.09502848749426634,8798,68,30,0,98,17540,0.01938949306265632,-608,0,38,0,0.10279793477807249,0,1633,0,924,85,0,2642,709,0.14771543999809872,258961,105081,
0,0.0,0,0,0,0,128664,8190,492706,0.0,153880,552,0.09502848749426634,8798,68,30,0,98,17540,0.01938949306265632,-608,0,38,0,0.10279793477807249,0,1633,0,924,85,0,2642,709,0.14771543999809872,258961,105081,
0,0.0,0,0,0,0,128664,8190,492706,0.0,153880,552,0.09502848749426634,8798,589,71,13,673,17540,0.01938949306265632,-608,0,518,0,0.06361772895198788,0,982,0,164,21,0,1167,818,0.09921690422612252,258961,105081,
0,0.0,0,0,0,0,128664,8190,492706,0.0,153880,552,0.09502848749426634,8798,589,71,13,673,17540,0.01938949306265632,-608,0,518,0,0.06361772895198788,0,982,0,164,21,0,1167,818,0.09921690422612252,258961,105081,
0,0.0,0,0,0,0,128664,8190,492706,0.0,153880,552,0.09502848749426634,8798,589,71,13,673,17540,0.01938949306265632,-608,0,518,0,0.06361772895198788,0,982,0,164,21,0,1167,818,0.09921690422612252,258961,105081,
0,0.0,0,0,0,0,128664,8190,492706,0.0,153880,552,0.09502848749426634,8798,589,71,13,673,17540,0.01938949306265632,-608,0,518,0,0.06361772895198788,0,982,0,164,21,0,1167,818,0.09921690422612252,258961,105081,
0,0.0,0,0,0,0,128664,8190,492706,0.0,153880,552,0.09502848749426634,8798,589,71,13,673,17540,0.01938949306265632,-608,0,518,0,0.06361772895198788,0,982,0,164,21,0,1167,818,0.09921690422612252,258961,105081,
0,0.0,0,0,0,0,128664,8190,492706,0.0,153880,552,0.09502848749426634,8798,589,71,13,673,17540,0.01938949306265632,-608,0,518,0,0.06361772895198788,0,982,0,164,21,0,1167,818,0.09921690422612252,258961,105081,
0,0.0,0,0,0,0,128664,8190,492706,0.0,153880,552,0.09502848749426634,8798,589,71,13,673,17540,0.01938949306265632,-608,0,518,0,0.06361772895198788,0,982,0,164,21,0,1167,818,0.09921690422612252,258961,105081,
0,0.0,0,0,0,0,128664,8190,492706,0.0,153880,552,0.09502848749426634,8798,35,1,0,36,17540,0.01938949306265632,-608,0,34,0,0.019764808364255947,0,191,0,29,22,0,242,162,0.05200650004964122,258961,105081,
0,0.0,0,0,0,0,128664,8190,492706,0.0,153880,552,0.09502848749426634,8798,35,1,0,36,17540,0.01938949306265632,-608,0,34,0,0.019764808364255947,0,191,0,29,22,0,242,162,0.05200650004964122,258961,105081,
0,0.0,0,0,0,0,128664,8190,492706,0.0,153880,552,0.09502848749426634,8798,151,23,19,193,17540,0.01938949306265632,-608,0,128,0,0.12806439198188416,0,191,0,29,22,0,242,162,0.05200650004964122,258961,105081,
0,0.0,0,0,0,0,128664,8190,492706,0.0,153880,552,0.09502848749426634,8798,151,23,19,193,17540,0.01938949306265632,-608,0,128,0,0.12806439198188416,0,191,0,29,22,0,242,162,0.05200650004964122,258961,105081,
0,0.0,0,0,0,0,128664,8190,492706,0.0,153880,552,0.09502848749426634,8798,151,23,19,193,17540,0.01938949306265632,-608,0,128,0,0.12806439198188416,0,191,0,29,22,0,242,162,0.05200650004964122,258961,105081,
0,0.0,0,0,0,0,128664,8190,492706,0.0,153880,552,0.09502848749426634,8798,1840,459,144,2443,17540,0.01938949306265632,-608,0,1381,0,0.3203469897878932,0,2361,0,479,157,0,2997,1882,0.1334557781959498,258961,105081,
0,0.0,0,0,0,0,128664,8190,492706,0.0,153880,552,0.09502848749426634,8798,1840,459,144,2443,17540,0.01938949306265632,-608,0,1381,0,0.3203469897878932,0,2361,0,479,157,0,2997,1882,0.1334557781959498,258961,105081,
0,0.0,0,0,0,0,128664,8190,492706,0.0,153880,552,0.09502848749426634,8798,1840,459,144,2443,17540,0.01938949306265632,-608,0,1381,0,0.3203469897878932,0,2361,0,479,157,0,2997,1882,0.1334557781959498,258961,105081,
0,0.0,0,0,0,0,128664,8190,492706,0.0,153880,552,0.09502848749426634,8798,1840,459,144,2443,17540,0.01938949306265632,-608,0,1381,0,0.3203469897878932,0,2361,0,479,157,0,2997,1882,0.1334557781959498,258961,105081,
0,0.0,0,0,0,0,128664,8190,492706,0.0,153880,552,0.09502848749426634,8798,1840,459,144,2443,17540,0.01938949306265632,-608,0,1381,0,0.3203469897878932,0,2361,0,479,157,0,2997,1882,0.1334557781959498,258961,105081,
0,0.0,0,0,0,0,128664,8190,492706,0.0,153880,552,0.09502848749426634,8798,1840,459,144,2443,17540,0.01938949306265632,-608,0,1381,0,0.3203469897878932,0,2361,0,479,157,0,2997,1882,0.1334557781959498,258961,105081,
127,0.0,7,75,52,209,128664,8190,492706,0.052017268445839884,153880,552,0.09502848749426634,8798,272,3,12,287,17540,0.01938949306265632,-608,0,269,0,0.11880203795738399,0,1940,0,1457,2349,0,5746,483,0.08526763338234122,258961,105081,
127,0.0,7,75,52,209,128664,8190,492706,0.052017268445839884,153880,552,0.09502848749426634,8798,272,3,12,287,17540,0.01938949306265632,-608,0,269,0,0.11880203795738399,0,1940,0,1457,2349,0,5746,483,0.08526763338234122,258961,105081,
127,0.0,7,75,52,209,128664,8190,492706,0.052017268445839884,153880,552,0.09502848749426634,8798,2,3,2,7,17540,0.01938949306265632,-608,0,-1,0,0.0014709969887409754,0,1940,0,1457,2349,0,5746,483,0.08526763338234122,258961,105081,
127,0.0,7,75,52,209,128664,8190,492706,0.052017268445839884,153880,552,0.09502848749426634,8798,2,3,2,7,17540,0.01938949306265632,-608,0,-1,0,0.0014709969887409754,0,1940,0,1457,2349,0,5746,483,0.08526763338234122,258961,105081,
127,0.0,7,75,52,209,128664,8190,492706,0.052017268445839884,153880,552,0.09502848749426634,8798,2,3,2,7,17540,0.01938949306265632,-608,0,-1,0,0.0014709969887409754,0,1940,0,1457,2349,0,5746,483,0.08526763338234122,258961,105081,
127,0.0,7,75,52,209,128664,8190,492706,0.052017268445839884,153880,552,0.09502848749426634,8798,2,3,2,7,17540,0.01938949306265632,-608,0,-1,0,0.0014709969887409754,0,1940,0,1457,2349,0,5746,483,0.08526763338234122,258961,105081,
127,0.521978021978022,7,75,52,209,128664,8190,492706,0.052017268445839884,153880,552,0.09502848749426634,8798,267,97,34,398,17540,0.01938949306265632,-608,57,170,126,0.1936380834132577,190,1940,7,1457,2349,69,5746,483,0.08526763338234122,258961,105081,
127,0.521978021978022,7,75,52,209,128664,8190,492706,0.052017268445839884,153880,552,0.09502848749426634,8798,267,97,34,398,17540,0.01938949306265632,-608,57,170,126,0.1936380834132577,190,1940,7,1457,2349,69,5746,483,0.08526763338234122,258961,105081,
127,0.521978021978022,7,75,52,209,128664,8190,492706,0.052017268445839884,153880,552,0.09502848749426634,8798,267,97,34,398,17540,0.01938949306265632,-608,57,170,126,0.1936380834132577,190,1940,7,1457,2349,69,5746,483,0.08526763338234122,258961,105081,
127,0.521978021978022,7,75,52,209,128664,8190,492706,0.052017268445839884,153880,552,0.09502848749426634,8798,267,97,34,398,17540,0.01938949306265632,-608,57,170,126,0.1936380834132577,190,1940,7,1457,2349,69,5746,483,0.08526763338234122,258961,105081,
127,0.061224489795918366,7,75,52,209,128664,8190,492706,0.052017268445839884,153880,552,0.09502848749426634,8798,80,249,2,331,17540,0.01938949306265632,-608,2,-169,1,0.1269236723180887,3,1940,0,1457,2349,-1,5746,483,0.08526763338234122,258961,105081,
127,0.0,7,75,52,209,128664,8190,492706,0.052017268445839884,153880,552,0.09502848749426634,8798,327,36,2,365,17540,0.01938949306265632,-608,0,291,0,0.024184314565148884,0,1940,0,1457,2349,0,5746,483,0.08526763338234122,258961,105081,
127,0.0,7,75,52,209,128664,8190,492706,0.052017268445839884,153880,552,0.09502848749426634,8798,7,7,2,16,17540,0.01938949306265632,-608,0,0,0,8.379456812842223E-4,0,1940,0,1457,2349,0,5746,483,0.08526763338234122,258961,105081,
305,0.0,8,19,286,332,128664,8190,492706,0.05463545236547588,153880,552,0.09502848749426634,8798,528,45,520,1093,17540,0.01938949306265632,-608,0,483,0,0.07986478864346747,0,5040,0,910,4515,0,10465,4130,0.12401961767926369,258961,105081,
305,0.0,8,19,286,332,128664,8190,492706,0.05463545236547588,153880,552,0.09502848749426634,8798,528,45,520,1093,17540,0.01938949306265632,-608,0,483,0,0.07986478864346747,0,5040,0,910,4515,0,10465,4130,0.12401961767926369,258961,105081,
305,0.0,8,19,286,332,128664,8190,492706,0.05463545236547588,153880,552,0.09502848749426634,8798,528,45,520,1093,17540,0.01938949306265632,-608,0,483,0,0.07986478864346747,0,5040,0,910,4515,0,10465,4130,0.12401961767926369,258961,105081,
305,0.0,8,19,286,332,128664,8190,492706,0.05463545236547588,153880,552,0.09502848749426634,8798,528,45,520,1093,17540,0.01938949306265632,-608,0,483,0,0.07986478864346747,0,5040,0,910,4515,0,10465,4130,0.12401961767926369,258961,105081,
305,0.18181818181818182,8,19,286,332,128664,8190,492706,0.05463545236547588,153880,552,0.09502848749426634,8798,43,57,144,244,17540,0.01938949306265632,-608,2,-14,2,0.10891601188909551,4,5040,0,910,4515,0,10465,4130,0.12401961767926369,258961,105081,
305,0.0,8,19,286,332,128664,8190,492706,0.05463545236547588,153880,552,0.09502848749426634,8798,159,67,483,709,17540,0.01938949306265632,-608,0,92,0,0.08878646298803139,0,5040,0,910,4515,0,10465,4130,0.12401961767926369,258961,105081,
305,0.0,8,19,286,332,128664,8190,492706,0.05463545236547588,153880,552,0.09502848749426634,8798,159,67,483,709,17540,0.01938949306265632,-608,0,92,0,0.08878646298803139,0,5040,0,910,4515,0,10465,4130,0.12401961767926369,258961,105081,
305,0.0,8,19,286,332,128664,8190,492706,0.05463545236547588,153880,552,0.09502848749426634,8798,159,67,483,709,17540,0.01938949306265632,-608,0,92,0,0.08878646298803139,0,5040,0,910,4515,0,10465,4130,0.12401961767926369,258961,105081,
305,0.2222222222222222,8,19,286,332,128664,8190,492706,0.05463545236547588,153880,552,0.09502848749426634,8798,48,79,615,742,17540,0.01938949306265632,-608,4,-31,4,0.1024404393190011,8,5040,0,910,4515,0,10465,4130,0.12401961767926369,258961,105081,
305,0.2222222222222222,8,19,286,332,128664,8190,492706,0.05463545236547588,153880,552,0.09502848749426634,8798,48,79,615,742,17540,0.01938949306265632,-608,4,-31,4,0.1024404393190011,8,5040,0,910,4515,0,10465,4130,0.12401961767926369,258961,105081,
305,0.2222222222222222,8,19,286,332,128664,8190,492706,0.05463545236547588,153880,552,0.09502848749426634,8798,48,79,615,742,17540,0.01938949306265632,-608,4,-31,4,0.1024404393190011,8,5040,0,910,4515,0,10465,4130,0.12401961767926369,258961,105081,
305,0.2222222222222222,8,19,286,332,128664,8190,492706,0.05463545236547588,153880,552,0.09502848749426634,8798,48,79,615,742,17540,0.01938949306265632,-608,4,-31,4,0.1024404393190011,8,5040,0,910,4515,0,10465,4130,0.12401961767926369,258961,105081,
305,0.2222222222222222,8,19,286,332,128664,8190,492706,0.05463545236547588,153880,552,0.09502848749426634,8798,48,79,615,742,17540,0.01938949306265632,-608,4,-31,4,0.1024404393190011,8,5040,0,910,4515,0,10465,4130,0.12401961767926369,258961,105081,
305,0.2210368996351807,8,19,286,332,128664,8190,492706,0.05463545236547588,153880,552,0.09502848749426634,8798,726,260,1432,2418,17540,0.01938949306265632,-608,7,466,242,0.21842593045499906,249,5040,0,910,4515,235,10465,4130,0.12401961767926369,258961,105081,
305,0.2210368996351807,8,19,286,332,128664,8190,492706,0.05463545236547588,153880,552,0.09502848749426634,8798,726,260,1432,2418,17540,0.01938949306265632,-608,7,466,242,0.21842593045499906,249,5040,0,910,4515,235,10465,4130,0.12401961767926369,258961,105081,
305,0.2210368996351807,8,19,286,332,128664,8190,492706,0.05463545236547588,153880,552,0.09502848749426634,8798,726,260,1432,2418,17540,0.01938949306265632,-608,7,466,242,0.21842593045499906,249,5040,0,910,4515,235,10465,4130,0.12401961767926369,258961,105081,
305,0.2210368996351807,8,19,286,332,128664,8190,492706,0.05463545236547588,153880,552,0.09502848749426634,8798,726,260,1432,2418,17540,0.01938949306265632,-608,7,466,242,0.21842593045499906,249,5040,0,910,4515,235,10465,4130,0.12401961767926369,258961,105081,
305,0.2210368996351807,8,19,286,332,128664,8190,492706,0.05463545236547588,153880,552,0.09502848749426634,8798,726,260,1432,2418,17540,0.01938949306265632,-608,7,466,242,0.21842593045499906,249,5040,0,910,4515,235,10465,4130,0.12401961767926369,258961,105081,
305,0.2210368996351807,8,19,286,332,128664,8190,492706,0.05463545236547588,153880,552,0.09502848749426634,8798,726,260,1432,2418,17540,0.01938949306265632,-608,7,466,242,0.21842593045499906,249,5040,0,910,4515,235,10465,4130,0.12401961767926369,258961,105081,
305,0.2210368996351807,8,19,286,332,128664,8190,492706,0.05463545236547588,153880,552,0.09502848749426634,8798,726,260,1432,2418,17540,0.01938949306265632,-608,7,466,242,0.21842593045499906,249,5040,0,910,4515,235,10465,4130,0.12401961767926369,258961,105081,
305,0.2210368996351807,8,19,286,332,128664,8190,492706,0.05463545236547588,153880,552,0.09502848749426634,8798,726,260,1432,2418,17540,0.01938949306265632,-608,7,466,242,0.21842593045499906,249,5040,0,910,4515,235,10465,4130,0.12401961767926369,258961,105081,
305,0.2210368996351807,8,19,286,332,128664,8190,492706,0.05463545236547588,153880,552,0.09502848749426634,8798,726,260,1432,2418,17540,0.01938949306265632,-608,7,466,242,0.21842593045499906,249,5040,0,910,4515,235,10465,4130,0.12401961767926369,258961,105081,
305,0.2210368996351807,8,19,286,332,128664,8190,492706,0.05463545236547588,153880,552,0.09502848749426634,8798,726,260,1432,2418,17540,0.01938949306265632,-608,7,466,242,0.21842593045499906,249,5040,0,910,4515,235,10465,4130,0.12401961767926369,258961,105081,
305,0.2210368996351807,8,19,286,332,128664,8190,492706,0.05463545236547588,153880,552,0.09502848749426634,8798,726,260,1432,2418,17540,0.01938949306265632,-608,7,466,242,0.21842593045499906,249,5040,0,910,4515,235,10465,4130,0.12401961767926369,258961,105081,
305,0.0,8,19,286,332,128664,8190,492706,0.05463545236547588,153880,552,0.09502848749426634,8798,353,9,0,362,17540,0.01938949306265632,-608,0,344,0,0.14628875362383856,0,5040,0,910,4515,0,10465,4130,0.12401961767926369,258961,105081,
305,0.04456824512534819,8,19,286,332,128664,8190,492706,0.05463545236547588,153880,552,0.09502848749426634,8798,1479,220,1138,2837,17540,0.01938949306265632,-608,0,1259,16,0.11557633641252357,16,5040,0,910,4515,16,10465,4130,0.12401961767926369,258961,105081,
305,0.04456824512534819,8,19,286,332,128664,8190,492706,0.05463545236547588,153880,552,0.09502848749426634,8798,1479,220,1138,2837,17540,0.01938949306265632,-608,0,1259,16,0.11557633641252357,16,5040,0,910,4515,16,10465,4130,0.12401961767926369,258961,105081,
305,0.04456824512534819,8,19,286,332,128664,8190,492706,0.05463545236547588,153880,552,0.09502848749426634,8798,1479,220,1138,2837,17540,0.01938949306265632,-608,0,1259,16,0.11557633641252357,16,5040,0,910,4515,16,10465,4130,0.12401961767926369,258961,105081,
305,0.04456824512534819,8,19,286,332,128664,8190,492706,0.05463545236547588,153880,552,0.09502848749426634,8798,1479,220,1138,2837,17540,0.01938949306265632,-608,0,1259,16,0.11557633641252357,16,5040,0,910,4515,16,10465,4130,0.12401961767926369,258961,105081,
305,0.04456824512534819,8,19,286,332,128664,8190,492706,0.05463545236547588,153880,552,0.09502848749426634,8798,1479,220,1138,2837,17540,0.01938949306265632,-608,0,1259,16,0.11557633641252357,16,5040,0,910,4515,16,10465,4130,0.12401961767926369,258961,105081,
305,0.04456824512534819,8,19,286,332,128664,8190,492706,0.05463545236547588,153880,552,0.09502848749426634,8798,1479,220,1138,2837,17540,0.01938949306265632,-608,0,1259,16,0.11557633641252357,16,5040,0,910,4515,16,10465,4130,0.12401961767926369,258961,105081,
305,0.04456824512534819,8,19,286,332,128664,8190,492706,0.05463545236547588,153880,552,0.09502848749426634,8798,1479,220,1138,2837,17540,0.01938949306265632,-608,0,1259,16,0.11557633641252357,16,5040,0,910,4515,16,10465,4130,0.12401961767926369,258961,105081,
305,0.04456824512534819,8,19,286,332,128664,8190,492706,0.05463545236547588,153880,552,0.09502848749426634,8798,1479,220,1138,2837,17540,0.01938949306265632,-608,0,1259,16,0.11557633641252357,16,5040,0,910,4515,16,10465,4130,0.12401961767926369,258961,105081,
4,0.0,0,5,-1,9,128664,8190,492706,0.0497444831591173,153880,552,0.09502848749426634,8798,121,13,2,136,17540,0.01938949306265632,-608,0,108,0,0.09794015503133231,0,773,0,157,19,0,949,616,0.13156638159392914,258961,105081,
4,0.0,0,5,-1,9,128664,8190,492706,0.0497444831591173,153880,552,0.09502848749426634,8798,371,55,11,437,17540,0.01938949306265632,-608,0,316,0,0.13183065748041567,0,773,0,157,19,0,949,616,0.13156638159392914,258961,105081,
4,0.0,0,5,-1,9,128664,8190,492706,0.0497444831591173,153880,552,0.09502848749426634,8798,371,55,11,437,17540,0.01938949306265632,-608,0,316,0,0.13183065748041567,0,773,0,157,19,0,949,616,0.13156638159392914,258961,105081,
8,0.23076923076923078,0,5,3,13,128664,8190,492706,0.10178185649525429,153880,552,0.09502848749426634,8798,173,267,105,545,17540,0.01938949306265632,-608,2,-94,4,0.2265942101555468,6,2861,0,1423,2648,2,6932,1438,0.14183913718286198,258961,105081,
8,0.23076923076923078,0,5,3,13,128664,8190,492706,0.10178185649525429,153880,552,0.09502848749426634,8798,173,267,105,545,17540,0.01938949306265632,-608,2,-94,4,0.2265942101555468,6,2861,0,1423,2648,2,6932,1438,0.14183913718286198,258961,105081,
8,0.23076923076923078,0,5,3,13,128664,8190,492706,0.10178185649525429,153880,552,0.09502848749426634,8798,173,267,105,545,17540,0.01938949306265632,-608,2,-94,4,0.2265942101555468,6,2861,0,1423,2648,2,6932,1438,0.14183913718286198,258961,105081,
8,0.23076923076923078,0,5,3,13,128664,8190,492706,0.10178185649525429,153880,552,0.09502848749426634,8798,173,267,105,545,17540,0.01938949306265632,-608,2,-94,4,0.2265942101555468,6,2861,0,1423,2648,2,6932,1438,0.14183913718286198,258961,105081,
8,0.23076923076923078,0,5,3,13,128664,8190,492706,0.10178185649525429,153880,552,0.09502848749426634,8798,173,267,105,545,17540,0.01938949306265632,-608,2,-94,4,0.2265942101555468,6,2861,0,1423,2648,2,6932,1438,0.14183913718286198,258961,105081,
8,0.23076923076923078,0,5,3,13,128664,8190,492706,0.10178185649525429,153880,552,0.09502848749426634,8798,173,267,105,545,17540,0.01938949306265632,-608,2,-94,4,0.2265942101555468,6,2861,0,1423,2648,2,6932,1438,0.14183913718286198,258961,105081,
8,0.04302486187845304,0,5,3,13,128664,8190,492706,0.10178185649525429,153880,552,0.09502848749426634,8798,2228,594,95,2917,17540,0.01938949306265632,-608,2,1634,3,0.17397659030165563,5,2861,0,1423,2648,1,6932,1438,0.14183913718286198,258961,105081,
8,0.04302486187845304,0,5,3,13,128664,8190,492706,0.10178185649525429,153880,552,0.09502848749426634,8798,2228,594,95,2917,17540,0.01938949306265632,-608,2,1634,3,0.17397659030165563,5,2861,0,1423,2648,1,6932,1438,0.14183913718286198,258961,105081,
8,0.04302486187845304,0,5,3,13,128664,8190,492706,0.10178185649525429,153880,552,0.09502848749426634,8798,2228,594,95,2917,17540,0.01938949306265632,-608,2,1634,3,0.17397659030165563,5,2861,0,1423,2648,1,6932,1438,0.14183913718286198,258961,105081,
8,0.04302486187845304,0,5,3,13,128664,8190,492706,0.10178185649525429,153880,552,0.09502848749426634,8798,2228,594,95,2917,17540,0.01938949306265632,-608,2,1634,3,0.17397659030165563,5,2861,0,1423,2648,1,6932,1438,0.14183913718286198,258961,105081,
8,0.04302486187845304,0,5,3,13,128664,8190,492706,0.10178185649525429,153880,552,0.09502848749426634,8798,2228,594,95,2917,17540,0.01938949306265632,-608,2,1634,3,0.17397659030165563,5,2861,0,1423,2648,1,6932,1438,0.14183913718286198,258961,105081,
8,0.04302486187845304,0,5,3,13,128664,8190,492706,0.10178185649525429,153880,552,0.09502848749426634,8798,2228,594,95,2917,17540,0.01938949306265632,-608,2,1634,3,0.17397659030165563,5,2861,0,1423,2648,1,6932,1438,0.14183913718286198,258961,105081,
8,0.04302486187845304,0,5,3,13,128664,8190,492706,0.10178185649525429,153880,552,0.09502848749426634,8798,2228,594,95,2917,17540,0.01938949306265632,-608,2,1634,3,0.17397659030165563,5,2861,0,1423,2648,1,6932,1438,0.14183913718286198,258961,105081,
8,0.04302486187845304,0,5,3,13,128664,8190,492706,0.10178185649525429,153880,552,0.09502848749426634,8798,2228,594,95,2917,17540,0.01938949306265632,-608,2,1634,3,0.17397659030165563,5,2861,0,1423,2648,1,6932,1438,0.14183913718286198,258961,105081,
8,0.13333333333333333,0,5,3,13,128664,8190,492706,0.10178185649525429,153880,552,0.09502848749426634,8798,460,562,2431,3453,17540,0.01938949306265632,-608,1,-102,1,0.16644956257499144,2,2861,0,1423,2648,0,6932,1438,0.14183913718286198,258961,105081,
8,0.13333333333333333,0,5,3,13,128664,8190,492706,0.10178185649525429,153880,552,0.09502848749426634,8798,460,562,2431,3453,17540,0.01938949306265632,-608,1,-102,1,0.16644956257499144,2,2861,0,1423,2648,0,6932,1438,0.14183913718286198,258961,105081,
8,0.13333333333333333,0,5,3,13,128664,8190,492706,0.10178185649525429,153880,552,0.09502848749426634,8798,460,562,2431,3453,17540,0.01938949306265632,-608,1,-102,1,0.16644956257499144,2,2861,0,1423,2648,0,6932,1438,0.14183913718286198,258961,105081,
8,0.13333333333333333,0,5,3,13,128664,8190,492706,0.10178185649525429,153880,552,0.09502848749426634,8798,460,562,2431,3453,17540,0.01938949306265632,-608,1,-102,1,0.16644956257499144,2,2861,0,1423,2648,0,6932,1438,0.14183913718286198,258961,105081,
8,0.13333333333333333,0,5,3,13,128664,8190,492706,0.10178185649525429,153880,552,0.09502848749426634,8798,460,562,2431,3453,17540,0.01938949306265632,-608,1,-102,1,0.16644956257499144,2,2861,0,1423,2648,0,6932,1438,0.14183913718286198,258961,105081,
8,0.13333333333333333,0,5,3,13,128664,8190,492706,0.10178185649525429,153880,552,0.09502848749426634,8798,460,562,2431,3453,17540,0.01938949306265632,-608,1,-102,1,0.16644956257499144,2,2861,0,1423,2648,0,6932,1438,0.14183913718286198,258961,105081,
8,0.13333333333333333,0,5,3,13,128664,8190,492706,0.10178185649525429,153880,552,0.09502848749426634,8798,460,562,2431,3453,17540,0.01938949306265632,-608,1,-102,1,0.16644956257499144,2,2861,0,1423,2648,0,6932,1438,0.14183913718286198,258961,105081,
8,0.13333333333333333,0,5,3,13,128664,8190,492706,0.10178185649525429,153880,552,0.09502848749426634,8798,460,562,2431,3453,17540,0.01938949306265632,-608,1,-102,1,0.16644956257499144,2,2861,0,1423,2648,0,6932,1438,0.14183913718286198,258961,105081,
8,0.13333333333333333,0,5,3,13,128664,8190,492706,0.10178185649525429,153880,552,0.09502848749426634,8798,460,562,2431,3453,17540,0.01938949306265632,-608,1,-102,1,0.16644956257499144,2,2861,0,1423,2648,0,6932,1438,0.14183913718286198,258961,105081,
8,0.13333333333333333,0,5,3,13,128664,8190,492706,0.10178185649525429,153880,552,0.09502848749426634,8798,460,562,2431,3453,17540,0.01938949306265632,-608,1,-102,1,0.16644956257499144,2,2861,0,1423,2648,0,6932,1438,0.14183913718286198,258961,105081,
8,0.13333333333333333,0,5,3,13,128664,8190,492706,0.10178185649525429,153880,552,0.09502848749426634,8798,460,562,2431,3453,17540,0.01938949306265632,-608,1,-102,1,0.16644956257499144,2,2861,0,1423,2648,0,6932,1438,0.14183913718286198,258961,105081,
8,0.13333333333333333,0,5,3,13,128664,8190,492706,0.10178185649525429,153880,552,0.09502848749426634,8798,460,562,2431,3453,17540,0.01938949306265632,-608,1,-102,1,0.16644956257499144,2,2861,0,1423,2648,0,6932,1438,0.14183913718286198,258961,105081,
0,0.0,0,0,0,0,128664,8190,492706,0.0,153880,552,0.09502848749426634,8798,40,64,345,449,17540,0.01938949306265632,-608,0,-24,0,0.10775014118192365,0,4575,0,1468,2250,0,8293,3107,0.10639909167419927,258961,105081,
0,0.0,0,0,0,0,128664,8190,492706,0.0,153880,552,0.09502848749426634,8798,40,64,345,449,17540,0.01938949306265632,-608,0,-24,0,0.10775014118192365,0,4575,0,1468,2250,0,8293,3107,0.10639909167419927,258961,105081,
0,0.0,0,0,0,0,128664,8190,492706,0.0,153880,552,0.09502848749426634,8798,40,64,345,449,17540,0.01938949306265632,-608,0,-24,0,0.10775014118192365,0,4575,0,1468,2250,0,8293,3107,0.10639909167419927,258961,105081,
0,0.0,0,0,0,0,128664,8190,492706,0.0,153880,552,0.09502848749426634,8798,949,112,78,1139,17540,0.01938949306265632,-608,0,837,0,0.11281108857011604,0,4575,0,1468,2250,0,8293,3107,0.10639909167419927,258961,105081,
0,0.0,0,0,0,0,128664,8190,492706,0.0,153880,552,0.09502848749426634,8798,949,112,78,1139,17540,0.01938949306265632,-608,0,837,0,0.11281108857011604,0,4575,0,1468,2250,0,8293,3107,0.10639909167419927,258961,105081,
0,0.0,0,0,0,0,128664,8190,492706,0.0,153880,552,0.09502848749426634,8798,949,112,78,1139,17540,0.01938949306265632,-608,0,837,0,0.11281108857011604,0,4575,0,1468,2250,0,8293,3107,0.10639909167419927,258961,105081,
0,0.0,0,0,0,0,128664,8190,492706,0.0,153880,552,0.09502848749426634,8798,949,112,78,1139,17540,0.01938949306265632,-608,0,837,0,0.11281108857011604,0,4575,0,1468,2250,0,8293,3107,0.10639909167419927,258961,105081,
0,0.0,0,0,0,0,128664,8190,492706,0.0,153880,552,0.09502848749426634,8798,949,112,78,1139,17540,0.01938949306265632,-608,0,837,0,0.11281108857011604,0,4575,0,1468,2250,0,8293,3107,0.10639909167419927,258961,105081,
0,0.0,0,0,0,0,128664,8190,492706,0.0,153880,552,0.09502848749426634,8798,949,112,78,1139,17540,0.01938949306265632,-608,0,837,0,0.11281108857011604,0,4575,0,1468,2250,0,8293,3107,0.10639909167419927,258961,105081,
0,0.0,0,0,0,0,128664,8190,492706,0.0,153880,552,0.09502848749426634,8798,949,112,78,1139,17540,0.01938949306265632,-608,0,837,0,0.11281108857011604,0,4575,0,1468,2250,0,8293,3107,0.10639909167419927,258961,105081,
0,0.0,0,0,0,0,128664,8190,492706,0.0,153880,552,0.09502848749426634,8798,949,112,78,1139,17540,0.01938949306265632,-608,0,837,0,0.11281108857011604,0,4575,0,1468,2250,0,8293,3107,0.10639909167419927,258961,105081,
0,0.0,0,0,0,0,128664,8190,492706,0.0,153880,552,0.09502848749426634,8798,949,112,78,1139,17540,0.01938949306265632,-608,0,837,0,0.11281108857011604,0,4575,0,1468,2250,0,8293,3107,0.10639909167419927,258961,105081,
0,0.0,0,0,0,0,128664,8190,492706,0.0,153880,552,0.09502848749426634,8798,949,112,78,1139,17540,0.01938949306265632,-608,0,837,0,0.11281108857011604,0,4575,0,1468,2250,0,8293,3107,0.10639909167419927,258961,105081,
0,0.0,0,0,0,0,128664,8190,492706,0.0,153880,552,0.09502848749426634,8798,949,112,78,1139,17540,0.01938949306265632,-608,0,837,0,0.11281108857011604,0,4575,0,1468,2250,0,8293,3107,0.10639909167419927,258961,105081,
0,0.0,0,0,0,0,128664,8190,492706,0.0,153880,552,0.09502848749426634,8798,949,112,78,1139,17540,0.01938949306265632,-608,0,837,0,0.11281108857011604,0,4575,0,1468,2250,0,8293,3107,0.10639909167419927,258961,105081,
0,0.0,0,0,0,0,128664,8190,492706,0.0,153880,552,0.09502848749426634,8798,949,112,78,1139,17540,0.01938949306265632,-608,0,837,0,0.11281108857011604,0,4575,0,1468,2250,0,8293,3107,0.10639909167419927,258961,105081,
0,0.0,0,0,0,0,128664,8190,492706,0.0,153880,552,0.09502848749426634,8798,1459,551,97,2107,17540,0.01938949306265632,-608,0,908,0,0.17687658871708903,0,4575,0,1468,2250,0,8293,3107,0.10639909167419927,258961,105081,
0,0.0,0,0,0,0,128664,8190,492706,0.0,153880,552,0.09502848749426634,8798,69,260,602,931,17540,0.01938949306265632,-608,0,-191,0,0.08717951288993823,0,4575,0,1468,2250,0,8293,3107,0.10639909167419927,258961,105081,
0,0.0,0,0,0,0,128664,8190,492706,0.0,153880,552,0.09502848749426634,8798,69,260,602,931,17540,0.01938949306265632,-608,0,-191,0,0.08717951288993823,0,4575,0,1468,2250,0,8293,3107,0.10639909167419927,258961,105081,
0,0.0,0,0,0,0,128664,8190,492706,0.0,153880,552,0.09502848749426634,8798,69,260,602,931,17540,0.01938949306265632,-608,0,-191,0,0.08717951288993823,0,4575,0,1468,2250,0,8293,3107,0.10639909167419927,258961,105081,
0,0.0,0,0,0,0,128664,8190,492706,0.0,153880,552,0.09502848749426634,8798,69,260,602,931,17540,0.01938949306265632,-608,0,-191,0,0.08717951288993823,0,4575,0,1468,2250,0,8293,3107,0.10639909167419927,258961,105081,
0,0.0,0,0,0,0,128664,8190,492706,0.0,153880,552,0.09502848749426634,8798,1535,195,51,1781,17540,0.01938949306265632,-608,0,1340,0,0.1390396841518034,0,4575,0,1468,2250,0,8293,3107,0.10639909167419927,258961,105081,
0,0.0,0,0,0,0,128664,8190,492706,0.0,153880,552,0.09502848749426634,8798,1535,195,51,1781,17540,0.01938949306265632,-608,0,1340,0,0.1390396841518034,0,4575,0,1468,2250,0,8293,3107,0.10639909167419927,258961,105081,
0,0.0,0,0,0,0,128664,8190,492706,0.0,153880,552,0.09502848749426634,8798,1535,195,51,1781,17540,0.01938949306265632,-608,0,1340,0,0.1390396841518034,0,4575,0,1468,2250,0,8293,3107,0.10639909167419927,258961,105081,
0,0.0,0,0,0,0,128664,8190,492706,0.0,153880,552,0.09502848749426634,8798,1535,195,51,1781,17540,0.01938949306265632,-608,0,1340,0,0.1390396841518034,0,4575,0,1468,2250,0,8293,3107,0.10639909167419927,258961,105081,
0,0.0,0,0,0,0,128664,8190,492706,0.0,153880,552,0.09502848749426634,8798,1535,195,51,1781,17540,0.01938949306265632,-608,0,1340,0,0.1390396841518034,0,4575,0,1468,2250,0,8293,3107,0.10639909167419927,258961,105081,
0,0.0,0,0,0,0,128664,8190,492706,0.0,153880,552,0.09502848749426634,8798,1535,195,51,1781,17540,0.01938949306265632,-608,0,1340,0,0.1390396841518034,0,4575,0,1468,2250,0,8293,3107,0.10639909167419927,258961,105081,
0,0.0,0,0,0,0,128664,8190,492706,0.0,153880,552,0.09502848749426634,8798,368,12,1,381,17540,0.01938949306265632,-608,0,356,0,0.10079190610053942,0,1402,0,255,1904,0,3561,1147,0.031015504258590752,258961,105081,
0,0.0,0,0,0,0,128664,8190,492706,0.0,153880,552,0.09502848749426634,8798,16,10,64,90,17540,0.01938949306265632,-608,0,6,0,0.01028256421835738,0,1402,0,255,1904,0,3561,1147,0.031015504258590752,258961,105081,
0,0.0,0,0,0,0,128664,8190,492706,0.0,153880,552,0.09502848749426634,8798,16,10,64,90,17540,0.01938949306265632,-608,0,6,0,0.01028256421835738,0,1402,0,255,1904,0,3561,1147,0.031015504258590752,258961,105081,
0,0.0,0,0,0,0,128664,8190,492706,0.0,153880,552,0.09502848749426634,8798,22,11,151,184,17540,0.01938949306265632,-608,0,11,0,0.008938093700470833,0,1402,0,255,1904,0,3561,1147,0.031015504258590752,258961,105081,
0,0.0,0,0,0,0,128664,8190,492706,0.0,153880,552,0.09502848749426634,8798,22,11,151,184,17540,0.01938949306265632,-608,0,11,0,0.008938093700470833,0,1402,0,255,1904,0,3561,1147,0.031015504258590752,258961,105081,
0,0.0,0,0,0,0,128664,8190,492706,0.0,153880,552,0.09502848749426634,8798,22,11,151,184,17540,0.01938949306265632,-608,0,11,0,0.008938093700470833,0,1402,0,255,1904,0,3561,1147,0.031015504258590752,258961,105081,
0,0.0,0,0,0,0,128664,8190,492706,0.0,153880,552,0.09502848749426634,8798,317,24,1,342,17540,0.01938949306265632,-608,0,293,0,0.06342851478507575,0,1402,0,255,1904,0,3561,1147,0.031015504258590752,258961,105081,
0,0.0,0,0,0,0,128664,8190,492706,0.0,153880,552,0.09502848749426634,8798,317,24,1,342,17540,0.01938949306265632,-608,0,293,0,0.06342851478507575,0,1402,0,255,1904,0,3561,1147,0.031015504258590752,258961,105081,
0,0.0,0,0,0,0,128664,8190,492706,0.0,153880,552,0.09502848749426634,8798,8,5,199,212,17540,0.01938949306265632,-608,0,3,0,0.005939455783066355,0,1402,0,255,1904,0,3561,1147,0.031015504258590752,258961,105081,
0,0.0,0,0,0,0,128664,8190,492706,0.0,153880,552,0.09502848749426634,8798,15,19,512,546,17540,0.01938949306265632,-608,0,-4,0,0.04532106516451544,0,1402,0,255,1904,0,3561,1147,0.031015504258590752,258961,105081,
0,0.0,0,0,0,0,128664,8190,492706,0.0,153880,552,0.09502848749426634,8798,15,19,512,546,17540,0.01938949306265632,-608,0,-4,0,0.04532106516451544,0,1402,0,255,1904,0,3561,1147,0.031015504258590752,258961,105081,
186,0.24675324675324675,32,75,111,293,128664,8190,492706,0.05627295966171268,153880,552,0.09502848749426634,8798,567,123,19,709,17540,0.01938949306265632,-608,1,444,15,0.19661376815856385,19,8461,3,2611,6468,14,17540,5850,0.10657665209355899,258961,105081,
186,0.24675324675324675,32,75,111,293,128664,8190,492706,0.05627295966171268,153880,552,0.09502848749426634,8798,567,123,19,709,17540,0.01938949306265632,-608,1,444,15,0.19661376815856385,19,8461,3,2611,6468,14,17540,5850,0.10657665209355899,258961,105081,
186,0.24675324675324675,32,75,111,293,128664,8190,492706,0.05627295966171268,153880,552,0.09502848749426634,8798,567,123,19,709,17540,0.01938949306265632,-608,1,444,15,0.19661376815856385,19,8461,3,2611,6468,14,17540,5850,0.10657665209355899,258961,105081,
186,0.0,32,75,111,293,128664,8190,492706,0.05627295966171268,153880,552,0.09502848749426634,8798,722,139,49,910,17540,0.01938949306265632,-608,0,583,0,0.1584361576018712,0,8461,0,2611,6468,0,17540,5850,0.10657665209355899,258961,105081,
186,0.0,32,75,111,293,128664,8190,492706,0.05627295966171268,153880,552,0.09502848749426634,8798,722,139,49,910,17540,0.01938949306265632,-608,0,583,0,0.1584361576018712,0,8461,0,2611,6468,0,17540,5850,0.10657665209355899,258961,105081,
186,0.0,32,75,111,293,128664,8190,492706,0.05627295966171268,153880,552,0.09502848749426634,8798,722,139,49,910,17540,0.01938949306265632,-608,0,583,0,0.1584361576018712,0,8461,0,2611,6468,0,17540,5850,0.10657665209355899,258961,105081,
186,0.0,32,75,111,293,128664,8190,492706,0.05627295966171268,153880,552,0.09502848749426634,8798,722,139,49,910,17540,0.01938949306265632,-608,0,583,0,0.1584361576018712,0,8461,0,2611,6468,0,17540,5850,0.10657665209355899,258961,105081,
186,0.0,32,75,111,293,128664,8190,492706,0.05627295966171268,153880,552,0.09502848749426634,8798,722,139,49,910,17540,0.01938949306265632,-608,0,583,0,0.1584361576018712,0,8461,0,2611,6468,0,17540,5850,0.10657665209355899,258961,105081,
186,0.0,32,75,111,293,128664,8190,492706,0.05627295966171268,153880,552,0.09502848749426634,8798,722,139,49,910,17540,0.01938949306265632,-608,0,583,0,0.1584361576018712,0,8461,0,2611,6468,0,17540,5850,0.10657665209355899,258961,105081,
186,0.0,32,75,111,293,128664,8190,492706,0.05627295966171268,153880,552,0.09502848749426634,8798,169,71,129,369,17540,0.01938949306265632,-608,0,98,0,0.1887297859029616,0,8461,0,2611,6468,0,17540,5850,0.10657665209355899,258961,105081,
186,0.0,32,75,111,293,128664,8190,492706,0.05627295966171268,153880,552,0.09502848749426634,8798,169,71,129,369,17540,0.01938949306265632,-608,0,98,0,0.1887297859029616,0,8461,0,2611,6468,0,17540,5850,0.10657665209355899,258961,105081,
186,0.18472222222222223,32,75,111,293,128664,8190,492706,0.05627295966171268,153880,552,0.09502848749426634,8798,1227,1125,3658,6010,17540,0.01938949306265632,-608,7,102,5,0.20705736569415242,12,8461,0,2611,6468,-2,17540,5850,0.10657665209355899,258961,105081,
186,0.18472222222222223,32,75,111,293,128664,8190,492706,0.05627295966171268,153880,552,0.09502848749426634,8798,1227,1125,3658,6010,17540,0.01938949306265632,-608,7,102,5,0.20705736569415242,12,8461,0,2611,6468,-2,17540,5850,0.10657665209355899,258961,105081,
186,0.18472222222222223,32,75,111,293,128664,8190,492706,0.05627295966171268,153880,552,0.09502848749426634,8798,1227,1125,3658,6010,17540,0.01938949306265632,-608,7,102,5,0.20705736569415242,12,8461,0,2611,6468,-2,17540,5850,0.10657665209355899,258961,105081,
186,0.18472222222222223,32,75,111,293,128664,8190,492706,0.05627295966171268,153880,552,0.09502848749426634,8798,1227,1125,3658,6010,17540,0.01938949306265632,-608,7,102,5,0.20705736569415242,12,8461,0,2611,6468,-2,17540,5850,0.10657665209355899,258961,105081,
186,0.18472222222222223,32,75,111,293,128664,8190,492706,0.05627295966171268,153880,552,0.09502848749426634,8798,1227,1125,3658,6010,17540,0.01938949306265632,-608,7,102,5,0.20705736569415242,12,8461,0,2611,6468,-2,17540,5850,0.10657665209355899,258961,105081,
186,0.18472222222222223,32,75,111,293,128664,8190,492706,0.05627295966171268,153880,552,0.09502848749426634,8798,1227,1125,3658,6010,17540,0.01938949306265632,-608,7,102,5,0.20705736569415242,12,8461,0,2611,6468,-2,17540,5850,0.10657665209355899,258961,105081,
186,0.18472222222222223,32,75,111,293,128664,8190,492706,0.05627295966171268,153880,552,0.09502848749426634,8798,1227,1125,3658,6010,17540,0.01938949306265632,-608,7,102,5,0.20705736569415242,12,8461,0,2611,6468,-2,17540,5850,0.10657665209355899,258961,105081,
186,0.18472222222222223,32,75,111,293,128664,8190,492706,0.05627295966171268,153880,552,0.09502848749426634,8798,1227,1125,3658,6010,17540,0.01938949306265632,-608,7,102,5,0.20705736569415242,12,8461,0,2611,6468,-2,17540,5850,0.10657665209355899,258961,105081,
186,0.18472222222222223,32,75,111,293,128664,8190,492706,0.05627295966171268,153880,552,0.09502848749426634,8798,1227,1125,3658,6010,17540,0.01938949306265632,-608,7,102,5,0.20705736569415242,12,8461,0,2611,6468,-2,17540,5850,0.10657665209355899,258961,105081,
186,0.0,32,75,111,293,128664,8190,492706,0.05627295966171268,153880,552,0.09502848749426634,8798,80,0,0,80,17540,0.01938949306265632,-608,0,80,0,0.6153846153846154,0,8461,0,2611,6468,0,17540,5850,0.10657665209355899,258961,105081,
186,0.2886281912980942,32,75,111,293,128664,8190,492706,0.05627295966171268,153880,552,0.09502848749426634,8798,471,85,15,571,17540,0.01938949306265632,-608,16,386,40,0.17960114546263692,67,8461,11,2611,6468,24,17540,5850,0.10657665209355899,258961,105081,
186,0.2886281912980942,32,75,111,293,128664,8190,492706,0.05627295966171268,153880,552,0.09502848749426634,8798,471,85,15,571,17540,0.01938949306265632,-608,16,386,40,0.17960114546263692,67,8461,11,2611,6468,24,17540,5850,0.10657665209355899,258961,105081,
186,0.2886281912980942,32,75,111,293,128664,8190,492706,0.05627295966171268,153880,552,0.09502848749426634,8798,471,85,15,571,17540,0.01938949306265632,-608,16,386,40,0.17960114546263692,67,8461,11,2611,6468,24,17540,5850,0.10657665209355899,258961,105081,
186,0.2886281912980942,32,75,111,293,128664,8190,492706,0.05627295966171268,153880,552,0.09502848749426634,8798,471,85,15,571,17540,0.01938949306265632,-608,16,386,40,0.17960114546263692,67,8461,11,2611,6468,24,17540,5850,0.10657665209355899,258961,105081,
186,0.0,32,75,111,293,128664,8190,492706,0.05627295966171268,153880,552,0.09502848749426634,8798,525,34,1,560,17540,0.01938949306265632,-608,0,491,0,0.056596646903466025,0,8461,0,2611,6468,0,17540,5850,0.10657665209355899,258961,105081,
186,0.0,32,75,111,293,128664,8190,492706,0.05627295966171268,153880,552,0.09502848749426634,8798,525,34,1,560,17540,0.01938949306265632,-608,0,491,0,0.056596646903466025,0,8461,0,2611,6468,0,17540,5850,0.10657665209355899,258961,105081,
186,0.0,32,75,111,293,128664,8190,492706,0.05627295966171268,153880,552,0.09502848749426634,8798,525,34,1,560,17540,0.01938949306265632,-608,0,491,0,0.056596646903466025,0,8461,0,2611,6468,0,17540,5850,0.10657665209355899,258961,105081,
186,0.0,32,75,111,293,128664,8190,492706,0.05627295966171268,153880,552,0.09502848749426634,8798,525,34,1,560,17540,0.01938949306265632,-608,0,491,0,0.056596646903466025,0,8461,0,2611,6468,0,17540,5850,0.10657665209355899,258961,105081,
186,0.0,32,75,111,293,128664,8190,492706,0.05627295966171268,153880,552,0.09502848749426634,8798,525,34,1,560,17540,0.01938949306265632,-608,0,491,0,0.056596646903466025,0,8461,0,2611,6468,0,17540,5850,0.10657665209355899,258961,105081,
186,0.0,32,75,111,293,128664,8190,492706,0.05627295966171268,153880,552,0.09502848749426634,8798,525,34,1,560,17540,0.01938949306265632,-608,0,491,0,0.056596646903466025,0,8461,0,2611,6468,0,17540,5850,0.10657665209355899,258961,105081,
186,0.0,32,75,111,293,128664,8190,492706,0.05627295966171268,153880,552,0.09502848749426634,8798,525,34,1,560,17540,0.01938949306265632,-608,0,491,0,0.056596646903466025,0,8461,0,2611,6468,0,17540,5850,0.10657665209355899,258961,105081,
186,0.0,32,75,111,293,128664,8190,492706,0.05627295966171268,153880,552,0.09502848749426634,8798,525,34,1,560,17540,0.01938949306265632,-608,0,491,0,0.056596646903466025,0,8461,0,2611,6468,0,17540,5850,0.10657665209355899,258961,105081,
186,0.0,32,75,111,293,128664,8190,492706,0.05627295966171268,153880,552,0.09502848749426634,8798,525,34,1,560,17540,0.01938949306265632,-608,0,491,0,0.056596646903466025,0,8461,0,2611,6468,0,17540,5850,0.10657665209355899,258961,105081,
186,0.0,32,75,111,293,128664,8190,492706,0.05627295966171268,153880,552,0.09502848749426634,8798,525,34,1,560,17540,0.01938949306265632,-608,0,491,0,0.056596646903466025,0,8461,0,2611,6468,0,17540,5850,0.10657665209355899,258961,105081,
186,0.0,32,75,111,293,128664,8190,492706,0.05627295966171268,153880,552,0.09502848749426634,8798,525,34,1,560,17540,0.01938949306265632,-608,0,491,0,0.056596646903466025,0,8461,0,2611,6468,0,17540,5850,0.10657665209355899,258961,105081,
186,0.0,32,75,111,293,128664,8190,492706,0.05627295966171268,153880,552,0.09502848749426634,8798,525,34,1,560,17540,0.01938949306265632,-608,0,491,0,0.056596646903466025,0,8461,0,2611,6468,0,17540,5850,0.10657665209355899,258961,105081,
186,0.0,32,75,111,293,128664,8190,492706,0.05627295966171268,153880,552,0.09502848749426634,8798,525,34,1,560,17540,0.01938949306265632,-608,0,491,0,0.056596646903466025,0,8461,0,2611,6468,0,17540,5850,0.10657665209355899,258961,105081,
186,0.0,32,75,111,293,128664,8190,492706,0.05627295966171268,153880,552,0.09502848749426634,8798,525,34,1,560,17540,0.01938949306265632,-608,0,491,0,0.056596646903466025,0,8461,0,2611,6468,0,17540,5850,0.10657665209355899,258961,105081,
186,0.0,32,75,111,293,128664,8190,492706,0.05627295966171268,153880,552,0.09502848749426634,8798,525,34,1,560,17540,0.01938949306265632,-608,0,491,0,0.056596646903466025,0,8461,0,2611,6468,0,17540,5850,0.10657665209355899,258961,105081,
186,0.0,32,75,111,293,128664,8190,492706,0.05627295966171268,153880,552,0.09502848749426634,8798,525,34,1,560,17540,0.01938949306265632,-608,0,491,0,0.056596646903466025,0,8461,0,2611,6468,0,17540,5850,0.10657665209355899,258961,105081,
186,0.0,32,75,111,293,128664,8190,492706,0.05627295966171268,153880,552,0.09502848749426634,8798,525,34,1,560,17540,0.01938949306265632,-608,0,491,0,0.056596646903466025,0,8461,0,2611,6468,0,17540,5850,0.10657665209355899,258961,105081,
186,0.0,32,75,111,293,128664,8190,492706,0.05627295966171268,153880,552,0.09502848749426634,8798,525,34,1,560,17540,0.01938949306265632,-608,0,491,0,0.056596646903466025,0,8461,0,2611,6468,0,17540,5850,0.10657665209355899,258961,105081,
186,0.0,32,75,111,293,128664,8190,492706,0.05627295966171268,153880,552,0.09502848749426634,8798,525,34,1,560,17540,0.01938949306265632,-608,0,491,0,0.056596646903466025,0,8461,0,2611,6468,0,17540,5850,0.10657665209355899,258961,105081,
186,0.0,32,75,111,293,128664,8190,492706,0.05627295966171268,153880,552,0.09502848749426634,8798,8,4,86,98,17540,0.01938949306265632,-608,0,4,0,0.01577708049005271,0,8461,0,2611,6468,0,17540,5850,0.10657665209355899,258961,105081,
186,0.25081377536590743,32,75,111,293,128664,8190,492706,0.05627295966171268,153880,552,0.09502848749426634,8798,1820,560,1351,3731,17540,0.01938949306265632,-608,26,1260,60,0.20422676464295575,104,8461,18,2611,6468,34,17540,5850,0.10657665209355899,258961,105081,
186,0.25081377536590743,32,75,111,293,128664,8190,492706,0.05627295966171268,153880,552,0.09502848749426634,8798,1820,560,1351,3731,17540,0.01938949306265632,-608,26,1260,60,0.20422676464295575,104,8461,18,2611,6468,34,17540,5850,0.10657665209355899,258961,105081,
186,0.25081377536590743,32,75,111,293,128664,8190,492706,0.05627295966171268,153880,552,0.09502848749426634,8798,1820,560,1351,3731,17540,0.01938949306265632,-608,26,1260,60,0.20422676464295575,104,8461,18,2611,6468,34,17540,5850,0.10657665209355899,258961,105081,
186,0.25081377536590743,32,75,111,293,128664,8190,492706,0.05627295966171268,153880,552,0.09502848749426634,8798,1820,560,1351,3731,17540,0.01938949306265632,-608,26,1260,60,0.20422676464295575,104,8461,18,2611,6468,34,17540,5850,0.10657665209355899,258961,105081,
186,0.25081377536590743,32,75,111,293,128664,8190,492706,0.05627295966171268,153880,552,0.09502848749426634,8798,1820,560,1351,3731,17540,0.01938949306265632,-608,26,1260,60,0.20422676464295575,104,8461,18,2611,6468,34,17540,5850,0.10657665209355899,258961,105081,
186,0.25081377536590743,32,75,111,293,128664,8190,492706,0.05627295966171268,153880,552,0.09502848749426634,8798,1820,560,1351,3731,17540,0.01938949306265632,-608,26,1260,60,0.20422676464295575,104,8461,18,2611,6468,34,17540,5850,0.10657665209355899,258961,105081,
186,0.25081377536590743,32,75,111,293,128664,8190,492706,0.05627295966171268,153880,552,0.09502848749426634,8798,1820,560,1351,3731,17540,0.01938949306265632,-608,26,1260,60,0.20422676464295575,104,8461,18,2611,6468,34,17540,5850,0.10657665209355899,258961,105081,
186,0.0,32,75,111,293,128664,8190,492706,0.05627295966171268,153880,552,0.09502848749426634,8798,9,5,126,140,17540,0.01938949306265632,-608,0,4,0,0.016840467317915678,0,8461,0,2611,6468,0,17540,5850,0.10657665209355899,258961,105081,
186,0.0,32,75,111,293,128664,8190,492706,0.05627295966171268,153880,552,0.09502848749426634,8798,9,5,126,140,17540,0.01938949306265632,-608,0,4,0,0.016840467317915678,0,8461,0,2611,6468,0,17540,5850,0.10657665209355899,258961,105081,
186,0.3600608828006089,32,75,111,293,128664,8190,492706,0.05627295966171268,153880,552,0.09502848749426634,8798,941,123,21,1085,17540,0.01938949306265632,-608,14,818,36,0.21552822886526096,50,8461,0,2611,6468,22,17540,5850,0.10657665209355899,258961,105081,
186,0.3600608828006089,32,75,111,293,128664,8190,492706,0.05627295966171268,153880,552,0.09502848749426634,8798,941,123,21,1085,17540,0.01938949306265632,-608,14,818,36,0.21552822886526096,50,8461,0,2611,6468,22,17540,5850,0.10657665209355899,258961,105081,
186,0.3600608828006089,32,75,111,293,128664,8190,492706,0.05627295966171268,153880,552,0.09502848749426634,8798,941,123,21,1085,17540,0.01938949306265632,-608,14,818,36,0.21552822886526096,50,8461,0,2611,6468,22,17540,5850,0.10657665209355899,258961,105081,
186,0.3600608828006089,32,75,111,293,128664,8190,492706,0.05627295966171268,153880,552,0.09502848749426634,8798,941,123,21,1085,17540,0.01938949306265632,-608,14,818,36,0.21552822886526096,50,8461,0,2611,6468,22,17540,5850,0.10657665209355899,258961,105081,
186,0.3600608828006089,32,75,111,293,128664,8190,492706,0.05627295966171268,153880,552,0.09502848749426634,8798,941,123,21,1085,17540,0.01938949306265632,-608,14,818,36,0.21552822886526096,50,8461,0,2611,6468,22,17540,5850,0.10657665209355899,258961,105081,
186,0.0,32,75,111,293,128664,8190,492706,0.05627295966171268,153880,552,0.09502848749426634,8798,281,34,3,318,17540,0.01938949306265632,-608,0,247,0,0.07681006317198628,0,8461,0,2611,6468,0,17540,5850,0.10657665209355899,258961,105081,
186,0.0,32,75,111,293,128664,8190,492706,0.05627295966171268,153880,552,0.09502848749426634,8798,335,114,287,736,17540,0.01938949306265632,-608,0,221,0,0.18655926819724294,0,8461,0,2611,6468,0,17540,5850,0.10657665209355899,258961,105081,
186,0.16346153846153846,32,75,111,293,128664,8190,492706,0.05627295966171268,153880,552,0.09502848749426634,8798,164,16,0,180,17540,0.01938949306265632,-608,7,148,10,0.13702146912247018,17,8461,0,2611,6468,3,17540,5850,0.10657665209355899,258961,105081,
7,0.0,0,7,0,14,128664,8190,492706,5.954782021294219E-4,153880,552,0.09502848749426634,8798,259,4,0,263,17540,0.01938949306265632,-608,0,255,0,0.2039149468417761,0,3316,0,181,67,0,3564,3135,0.09757072977185607,258961,105081,
7,0.0,0,7,0,14,128664,8190,492706,5.954782021294219E-4,153880,552,0.09502848749426634,8798,8,3,7,18,17540,0.01938949306265632,-608,0,5,0,0.09205112169464891,0,3316,0,181,67,0,3564,3135,0.09757072977185607,258961,105081,
7,0.0,0,7,0,14,128664,8190,492706,5.954782021294219E-4,153880,552,0.09502848749426634,8798,151,12,2,165,17540,0.01938949306265632,-608,0,139,0,0.11491043152333473,0,3316,0,181,67,0,3564,3135,0.09757072977185607,258961,105081,
7,0.0,0,7,0,14,128664,8190,492706,5.954782021294219E-4,153880,552,0.09502848749426634,8798,174,1,0,175,17540,0.01938949306265632,-608,0,173,0,0.022414263901117885,0,3316,0,181,67,0,3564,3135,0.09757072977185607,258961,105081,
7,0.0,0,7,0,14,128664,8190,492706,5.954782021294219E-4,153880,552,0.09502848749426634,8798,174,1,0,175,17540,0.01938949306265632,-608,0,173,0,0.022414263901117885,0,3316,0,181,67,0,3564,3135,0.09757072977185607,258961,105081,
7,0.0,0,7,0,14,128664,8190,492706,5.954782021294219E-4,153880,552,0.09502848749426634,8798,174,1,0,175,17540,0.01938949306265632,-608,0,173,0,0.022414263901117885,0,3316,0,181,67,0,3564,3135,0.09757072977185607,258961,105081,
7,0.0,0,7,0,14,128664,8190,492706,5.954782021294219E-4,153880,552,0.09502848749426634,8798,2,2,10,14,17540,0.01938949306265632,-608,0,0,0,0.00716966966966967,0,3316,0,181,67,0,3564,3135,0.09757072977185607,258961,105081,
1,0.0,0,1,0,2,128664,8190,492706,6.064281382656155E-4,153880,552,0.09502848749426634,8798,82,3,80,165,17540,0.01938949306265632,-608,0,79,0,0.04122632131546776,0,732,0,89,1371,0,2192,643,0.029844967335179235,258961,105081,
1,0.0,0,1,0,2,128664,8190,492706,6.064281382656155E-4,153880,552,0.09502848749426634,8798,82,3,80,165,17540,0.01938949306265632,-608,0,79,0,0.04122632131546776,0,732,0,89,1371,0,2192,643,0.029844967335179235,258961,105081,
1,0.0,0,1,0,2,128664,8190,492706,6.064281382656155E-4,153880,552,0.09502848749426634,8798,82,3,80,165,17540,0.01938949306265632,-608,0,79,0,0.04122632131546776,0,732,0,89,1371,0,2192,643,0.029844967335179235,258961,105081,
1,0.0,0,1,0,2,128664,8190,492706,6.064281382656155E-4,153880,552,0.09502848749426634,8798,151,9,138,298,17540,0.01938949306265632,-608,0,142,0,0.06656743515253924,0,732,0,89,1371,0,2192,643,0.029844967335179235,258961,105081,
1,0.0,0,1,0,2,128664,8190,492706,6.064281382656155E-4,153880,552,0.09502848749426634,8798,31,4,96,131,17540,0.01938949306265632,-608,0,27,0,0.10848332068755899,0,732,0,89,1371,0,2192,643,0.029844967335179235,258961,105081,
1,0.0,0,1,0,2,128664,8190,492706,6.064281382656155E-4,153880,552,0.09502848749426634,8798,57,1,57,115,17540,0.01938949306265632,-608,0,56,0,0.0017781731830202052,0,732,0,89,1371,0,2192,643,0.029844967335179235,258961,105081,
1,0.0,0,1,0,2,128664,8190,492706,6.064281382656155E-4,153880,552,0.09502848749426634,8798,57,1,57,115,17540,0.01938949306265632,-608,0,56,0,0.0017781731830202052,0,732,0,89,1371,0,2192,643,0.029844967335179235,258961,105081,
0,0.0,0,0,0,0,128664,8190,492706,0.0,153880,552,0.09502848749426634,8798,265,13,260,538,17540,0.01938949306265632,-608,0,252,0,0.06685973167656542,0,825,0,140,1364,0,2329,685,0.07934122202062013,258961,105081,
0,0.0,0,0,0,0,128664,8190,492706,0.0,153880,552,0.09502848749426634,8798,21,9,133,163,17540,0.01938949306265632,-608,0,12,0,0.03625073876790962,0,825,0,140,1364,0,2329,685,0.07934122202062013,258961,105081,
0,0.0,0,0,0,0,128664,8190,492706,0.0,153880,552,0.09502848749426634,8798,92,45,568,705,17540,0.01938949306265632,-608,0,47,0,0.10207506091934303,0,825,0,140,1364,0,2329,685,0.07934122202062013,258961,105081,
0,0.0,0,0,0,0,128664,8190,492706,0.0,153880,552,0.09502848749426634,8798,92,45,568,705,17540,0.01938949306265632,-608,0,47,0,0.10207506091934303,0,825,0,140,1364,0,2329,685,0.07934122202062013,258961,105081,
0,0.0,0,0,0,0,128664,8190,492706,0.0,153880,552,0.09502848749426634,8798,92,45,568,705,17540,0.01938949306265632,-608,0,47,0,0.10207506091934303,0,825,0,140,1364,0,2329,685,0.07934122202062013,258961,105081,
0,0.0,0,0,0,0,128664,8190,492706,0.0,153880,552,0.09502848749426634,8798,279,51,212,542,17540,0.01938949306265632,-608,0,228,0,0.1379348988096621,0,825,0,140,1364,0,2329,685,0.07934122202062013,258961,105081,
0,0.0,0,0,0,0,128664,8190,492706,0.0,153880,552,0.09502848749426634,8798,279,51,212,542,17540,0.01938949306265632,-608,0,228,0,0.1379348988096621,0,825,0,140,1364,0,2329,685,0.07934122202062013,258961,105081,
0,0.0,0,0,0,0,128664,8190,492706,0.0,153880,552,0.09502848749426634,8798,279,51,212,542,17540,0.01938949306265632,-608,0,228,0,0.1379348988096621,0,825,0,140,1364,0,2329,685,0.07934122202062013,258961,105081,
0,0.0,0,0,0,0,128664,8190,492706,0.0,153880,552,0.09502848749426634,8798,279,51,212,542,17540,0.01938949306265632,-608,0,228,0,0.1379348988096621,0,825,0,140,1364,0,2329,685,0.07934122202062013,258961,105081,
0,0.0,0,0,0,0,128664,8190,492706,0.0,153880,552,0.09502848749426634,8798,279,51,212,542,17540,0.01938949306265632,-608,0,228,0,0.1379348988096621,0,825,0,140,1364,0,2329,685,0.07934122202062013,258961,105081,
0,0.0,0,0,0,0,128664,8190,492706,0.0,153880,552,0.09502848749426634,8798,279,51,212,542,17540,0.01938949306265632,-608,0,228,0,0.1379348988096621,0,825,0,140,1364,0,2329,685,0.07934122202062013,258961,105081,
0,0.0,0,0,0,0,128664,8190,492706,0.0,153880,552,0.09502848749426634,8798,279,51,212,542,17540,0.01938949306265632,-608,0,228,0,0.1379348988096621,0,825,0,140,1364,0,2329,685,0.07934122202062013,258961,105081,
0,0.0,0,0,0,0,128664,8190,492706,0.0,153880,552,0.09502848749426634,8798,279,51,212,542,17540,0.01938949306265632,-608,0,228,0,0.1379348988096621,0,825,0,140,1364,0,2329,685,0.07934122202062013,258961,105081,
0,0.0,0,0,0,0,128664,8190,492706,0.0,153880,552,0.09502848749426634,8798,14,10,90,114,17540,0.01938949306265632,-608,0,4,0,0.09761934452961922,0,825,0,140,1364,0,2329,685,0.07934122202062013,258961,105081,
0,0.0,0,0,0,0,128664,8190,492706,0.0,153880,552,0.09502848749426634,8798,14,10,90,114,17540,0.01938949306265632,-608,0,4,0,0.09761934452961922,0,825,0,140,1364,0,2329,685,0.07934122202062013,258961,105081,
6,0.3333333333333333,1,2,4,9,128664,8190,492706,0.02638424377554812,153880,552,0.09502848749426634,8798,95,8,3,106,17540,0.01938949306265632,-608,1,87,5,0.1041822434587243,7,1897,1,171,2098,4,4166,1726,0.08321448797003737,258961,105081,
6,0.3333333333333333,1,2,4,9,128664,8190,492706,0.02638424377554812,153880,552,0.09502848749426634,8798,95,8,3,106,17540,0.01938949306265632,-608,1,87,5,0.1041822434587243,7,1897,1,171,2098,4,4166,1726,0.08321448797003737,258961,105081,
6,0.0,1,2,4,9,128664,8190,492706,0.02638424377554812,153880,552,0.09502848749426634,8798,7,3,196,206,17540,0.01938949306265632,-608,0,4,0,0.0026881747215836533,0,1897,0,171,2098,0,4166,1726,0.08321448797003737,258961,105081,
6,0.0,1,2,4,9,128664,8190,492706,0.02638424377554812,153880,552,0.09502848749426634,8798,176,9,161,346,17540,0.01938949306265632,-608,0,167,0,0.040857902561266986,0,1897,0,171,2098,0,4166,1726,0.08321448797003737,258961,105081,
6,0.00966183574879227,1,2,4,9,128664,8190,492706,0.02638424377554812,153880,552,0.09502848749426634,8798,756,35,705,1496,17540,0.01938949306265632,-608,1,721,1,0.11175192919981147,2,1897,0,171,2098,0,4166,1726,0.08321448797003737,258961,105081,
6,0.00966183574879227,1,2,4,9,128664,8190,492706,0.02638424377554812,153880,552,0.09502848749426634,8798,756,35,705,1496,17540,0.01938949306265632,-608,1,721,1,0.11175192919981147,2,1897,0,171,2098,0,4166,1726,0.08321448797003737,258961,105081,
6,0.00966183574879227,1,2,4,9,128664,8190,492706,0.02638424377554812,153880,552,0.09502848749426634,8798,756,35,705,1496,17540,0.01938949306265632,-608,1,721,1,0.11175192919981147,2,1897,0,171,2098,0,4166,1726,0.08321448797003737,258961,105081,
6,0.00966183574879227,1,2,4,9,128664,8190,492706,0.02638424377554812,153880,552,0.09502848749426634,8798,756,35,705,1496,17540,0.01938949306265632,-608,1,721,1,0.11175192919981147,2,1897,0,171,2098,0,4166,1726,0.08321448797003737,258961,105081,
6,0.00966183574879227,1,2,4,9,128664,8190,492706,0.02638424377554812,153880,552,0.09502848749426634,8798,756,35,705,1496,17540,0.01938949306265632,-608,1,721,1,0.11175192919981147,2,1897,0,171,2098,0,4166,1726,0.08321448797003737,258961,105081,
6,0.00966183574879227,1,2,4,9,128664,8190,492706,0.02638424377554812,153880,552,0.09502848749426634,8798,756,35,705,1496,17540,0.01938949306265632,-608,1,721,1,0.11175192919981147,2,1897,0,171,2098,0,4166,1726,0.08321448797003737,258961,105081,
6,0.00966183574879227,1,2,4,9,128664,8190,492706,0.02638424377554812,153880,552,0.09502848749426634,8798,756,35,705,1496,17540,0.01938949306265632,-608,1,721,1,0.11175192919981147,2,1897,0,171,2098,0,4166,1726,0.08321448797003737,258961,105081,
6,0.00966183574879227,1,2,4,9,128664,8190,492706,0.02638424377554812,153880,552,0.09502848749426634,8798,756,35,705,1496,17540,0.01938949306265632,-608,1,721,1,0.11175192919981147,2,1897,0,171,2098,0,4166,1726,0.08321448797003737,258961,105081,
6,0.00966183574879227,1,2,4,9,128664,8190,492706,0.02638424377554812,153880,552,0.09502848749426634,8798,756,35,705,1496,17540,0.01938949306265632,-608,1,721,1,0.11175192919981147,2,1897,0,171,2098,0,4166,1726,0.08321448797003737,258961,105081,
6,0.00966183574879227,1,2,4,9,128664,8190,492706,0.02638424377554812,153880,552,0.09502848749426634,8798,756,35,705,1496,17540,0.01938949306265632,-608,1,721,1,0.11175192919981147,2,1897,0,171,2098,0,4166,1726,0.08321448797003737,258961,105081,
6,0.00966183574879227,1,2,4,9,128664,8190,492706,0.02638424377554812,153880,552,0.09502848749426634,8798,756,35,705,1496,17540,0.01938949306265632,-608,1,721,1,0.11175192919981147,2,1897,0,171,2098,0,4166,1726,0.08321448797003737,258961,105081,
6,0.00966183574879227,1,2,4,9,128664,8190,492706,0.02638424377554812,153880,552,0.09502848749426634,8798,756,35,705,1496,17540,0.01938949306265632,-608,1,721,1,0.11175192919981147,2,1897,0,171,2098,0,4166,1726,0.08321448797003737,258961,105081,
6,0.0,1,2,4,9,128664,8190,492706,0.02638424377554812,153880,552,0.09502848749426634,8798,88,1,87,176,17540,0.01938949306265632,-608,0,87,0,0.2472117268583607,0,1897,0,171,2098,0,4166,1726,0.08321448797003737,258961,105081,
6,0.0,1,2,4,9,128664,8190,492706,0.02638424377554812,153880,552,0.09502848749426634,8798,85,5,0,90,17540,0.01938949306265632,-608,0,80,0,0.013231982773403348,0,1897,0,171,2098,0,4166,1726,0.08321448797003737,258961,105081,
6,0.0,1,2,4,9,128664,8190,492706,0.02638424377554812,153880,552,0.09502848749426634,8798,297,19,271,587,17540,0.01938949306265632,-608,0,278,0,0.10272625331370522,0,1897,0,171,2098,0,4166,1726,0.08321448797003737,258961,105081,
6,0.0,1,2,4,9,128664,8190,492706,0.02638424377554812,153880,552,0.09502848749426634,8798,20,16,145,181,17540,0.01938949306265632,-608,0,4,0,0.1618323207895796,0,1897,0,171,2098,0,4166,1726,0.08321448797003737,258961,105081,
6,0.0,1,2,4,9,128664,8190,492706,0.02638424377554812,153880,552,0.09502848749426634,8798,20,16,145,181,17540,0.01938949306265632,-608,0,4,0,0.1618323207895796,0,1897,0,171,2098,0,4166,1726,0.08321448797003737,258961,105081,
6,0.0,1,2,4,9,128664,8190,492706,0.02638424377554812,153880,552,0.09502848749426634,8798,134,13,87,234,17540,0.01938949306265632,-608,0,121,0,0.05295940883187476,0,1897,0,171,2098,0,4166,1726,0.08321448797003737,258961,105081,
6,0.0,1,2,4,9,128664,8190,492706,0.02638424377554812,153880,552,0.09502848749426634,8798,134,13,87,234,17540,0.01938949306265632,-608,0,121,0,0.05295940883187476,0,1897,0,171,2098,0,4166,1726,0.08321448797003737,258961,105081,
0,0.0,0,0,0,0,128664,8190,492706,0.0,153880,552,0.09502848749426634,8798,331,11,310,652,17540,0.01938949306265632,-608,0,320,0,0.06880345688937187,0,637,0,113,1241,0,1991,524,0.04897048010864594,258961,105081,
0,0.0,0,0,0,0,128664,8190,492706,0.0,153880,552,0.09502848749426634,8798,331,11,310,652,17540,0.01938949306265632,-608,0,320,0,0.06880345688937187,0,637,0,113,1241,0,1991,524,0.04897048010864594,258961,105081,
0,0.0,0,0,0,0,128664,8190,492706,0.0,153880,552,0.09502848749426634,8798,331,11,310,652,17540,0.01938949306265632,-608,0,320,0,0.06880345688937187,0,637,0,113,1241,0,1991,524,0.04897048010864594,258961,105081,
0,0.0,0,0,0,0,128664,8190,492706,0.0,153880,552,0.09502848749426634,8798,331,11,310,652,17540,0.01938949306265632,-608,0,320,0,0.06880345688937187,0,637,0,113,1241,0,1991,524,0.04897048010864594,258961,105081,
0,0.0,0,0,0,0,128664,8190,492706,0.0,153880,552,0.09502848749426634,8798,331,11,310,652,17540,0.01938949306265632,-608,0,320,0,0.06880345688937187,0,637,0,113,1241,0,1991,524,0.04897048010864594,258961,105081,
0,0.0,0,0,0,0,128664,8190,492706,0.0,153880,552,0.09502848749426634,8798,331,11,310,652,17540,0.01938949306265632,-608,0,320,0,0.06880345688937187,0,637,0,113,1241,0,1991,524,0.04897048010864594,258961,105081,
0,0.0,0,0,0,0,128664,8190,492706,0.0,153880,552,0.09502848749426634,8798,26,55,530,611,17540,0.01938949306265632,-608,0,-29,0,0.09069005146222077,0,637,0,113,1241,0,1991,524,0.04897048010864594,258961,105081,
0,0.0,0,0,0,0,128664,8190,492706,0.0,153880,552,0.09502848749426634,8798,6,8,128,142,17540,0.01938949306265632,-608,0,-2,0,0.03598899001177137,0,637,0,113,1241,0,1991,524,0.04897048010864594,258961,105081,
0,0.0,0,0,0,0,128664,8190,492706,0.0,153880,552,0.09502848749426634,8798,6,8,128,142,17540,0.01938949306265632,-608,0,-2,0,0.03598899001177137,0,637,0,113,1241,0,1991,524,0.04897048010864594,258961,105081,
0,0.0,0,0,0,0,128664,8190,492706,0.0,153880,552,0.09502848749426634,8798,109,15,91,215,17540,0.01938949306265632,-608,0,94,0,0.10420332538495167,0,637,0,113,1241,0,1991,524,0.04897048010864594,258961,105081,
0,0.0,0,0,0,0,128664,8190,492706,0.0,153880,552,0.09502848749426634,8798,26,55,530,611,17540,0.01938949306265632,-608,0,-29,0,0.09069005146222077,0,637,0,113,1241,0,1991,524,0.04897048010864594,258961,105081,
0,0.0,0,0,0,0,128664,8190,492706,0.0,153880,552,0.09502848749426634,8798,26,55,530,611,17540,0.01938949306265632,-608,0,-29,0,0.09069005146222077,0,637,0,113,1241,0,1991,524,0.04897048010864594,258961,105081,
0,0.0,0,0,0,0,128664,8190,492706,0.0,153880,552,0.09502848749426634,8798,26,55,530,611,17540,0.01938949306265632,-608,0,-29,0,0.09069005146222077,0,637,0,113,1241,0,1991,524,0.04897048010864594,258961,105081,
0,0.0,0,0,0,0,128664,8190,492706,0.0,153880,552,0.09502848749426634,8798,31,4,28,63,17540,0.01938949306265632,-608,0,27,0,0.004494838697966763,0,1189,0,271,1742,0,3202,918,0.05980556182969651,258961,105081,
0,0.0,0,0,0,0,128664,8190,492706,0.0,153880,552,0.09502848749426634,8798,76,124,487,687,17540,0.01938949306265632,-608,0,-48,0,0.09008242665862083,0,1189,0,271,1742,0,3202,918,0.05980556182969651,258961,105081,
0,0.0,0,0,0,0,128664,8190,492706,0.0,153880,552,0.09502848749426634,8798,76,124,487,687,17540,0.01938949306265632,-608,0,-48,0,0.09008242665862083,0,1189,0,271,1742,0,3202,918,0.05980556182969651,258961,105081,
0,0.0,0,0,0,0,128664,8190,492706,0.0,153880,552,0.09502848749426634,8798,76,124,487,687,17540,0.01938949306265632,-608,0,-48,0,0.09008242665862083,0,1189,0,271,1742,0,3202,918,0.05980556182969651,258961,105081,
0,0.0,0,0,0,0,128664,8190,492706,0.0,153880,552,0.09502848749426634,8798,76,124,487,687,17540,0.01938949306265632,-608,0,-48,0,0.09008242665862083,0,1189,0,271,1742,0,3202,918,0.05980556182969651,258961,105081,
0,0.0,0,0,0,0,128664,8190,492706,0.0,153880,552,0.09502848749426634,8798,76,124,487,687,17540,0.01938949306265632,-608,0,-48,0,0.09008242665862083,0,1189,0,271,1742,0,3202,918,0.05980556182969651,258961,105081,
0,0.0,0,0,0,0,128664,8190,492706,0.0,153880,552,0.09502848749426634,8798,76,124,487,687,17540,0.01938949306265632,-608,0,-48,0,0.09008242665862083,0,1189,0,271,1742,0,3202,918,0.05980556182969651,258961,105081,
0,0.0,0,0,0,0,128664,8190,492706,0.0,153880,552,0.09502848749426634,8798,76,124,487,687,17540,0.01938949306265632,-608,0,-48,0,0.09008242665862083,0,1189,0,271,1742,0,3202,918,0.05980556182969651,258961,105081,
0,0.0,0,0,0,0,128664,8190,492706,0.0,153880,552,0.09502848749426634,8798,76,124,487,687,17540,0.01938949306265632,-608,0,-48,0,0.09008242665862083,0,1189,0,271,1742,0,3202,918,0.05980556182969651,258961,105081,
0,0.0,0,0,0,0,128664,8190,492706,0.0,153880,552,0.09502848749426634,8798,76,124,487,687,17540,0.01938949306265632,-608,0,-48,0,0.09008242665862083,0,1189,0,271,1742,0,3202,918,0.05980556182969651,258961,105081,
0,0.0,0,0,0,0,128664,8190,492706,0.0,153880,552,0.09502848749426634,8798,76,124,487,687,17540,0.01938949306265632,-608,0,-48,0,0.09008242665862083,0,1189,0,271,1742,0,3202,918,0.05980556182969651,258961,105081,
0,0.0,0,0,0,0,128664,8190,492706,0.0,153880,552,0.09502848749426634,8798,76,124,487,687,17540,0.01938949306265632,-608,0,-48,0,0.09008242665862083,0,1189,0,271,1742,0,3202,918,0.05980556182969651,258961,105081,
0,0.0,0,0,0,0,128664,8190,492706,0.0,153880,552,0.09502848749426634,8798,76,124,487,687,17540,0.01938949306265632,-608,0,-48,0,0.09008242665862083,0,1189,0,271,1742,0,3202,918,0.05980556182969651,258961,105081,
0,0.0,0,0,0,0,128664,8190,492706,0.0,153880,552,0.09502848749426634,8798,76,124,487,687,17540,0.01938949306265632,-608,0,-48,0,0.09008242665862083,0,1189,0,271,1742,0,3202,918,0.05980556182969651,258961,105081,
0,0.0,0,0,0,0,128664,8190,492706,0.0,153880,552,0.09502848749426634,8798,76,124,487,687,17540,0.01938949306265632,-608,0,-48,0,0.09008242665862083,0,1189,0,271,1742,0,3202,918,0.05980556182969651,258961,105081,
0,0.0,0,0,0,0,128664,8190,492706,0.0,153880,552,0.09502848749426634,8798,514,45,402,961,17540,0.01938949306265632,-608,0,469,0,0.1269604749212023,0,1189,0,271,1742,0,3202,918,0.05980556182969651,258961,105081,
0,0.0,0,0,0,0,128664,8190,492706,0.0,153880,552,0.09502848749426634,8798,514,45,402,961,17540,0.01938949306265632,-608,0,469,0,0.1269604749212023,0,1189,0,271,1742,0,3202,918,0.05980556182969651,258961,105081,
0,0.0,0,0,0,0,128664,8190,492706,0.0,153880,552,0.09502848749426634,8798,514,45,402,961,17540,0.01938949306265632,-608,0,469,0,0.1269604749212023,0,1189,0,271,1742,0,3202,918,0.05980556182969651,258961,105081,
0,0.0,0,0,0,0,128664,8190,492706,0.0,153880,552,0.09502848749426634,8798,514,45,402,961,17540,0.01938949306265632,-608,0,469,0,0.1269604749212023,0,1189,0,271,1742,0,3202,918,0.05980556182969651,258961,105081,
0,0.0,0,0,0,0,128664,8190,492706,0.0,153880,552,0.09502848749426634,8798,518,43,497,1058,17540,0.01938949306265632,-608,0,475,0,0.09042756404482037,0,1189,0,271,1742,0,3202,918,0.05980556182969651,258961,105081,
0,0.0,0,0,0,0,128664,8190,492706,0.0,153880,552,0.09502848749426634,8798,518,43,497,1058,17540,0.01938949306265632,-608,0,475,0,0.09042756404482037,0,1189,0,271,1742,0,3202,918,0.05980556182969651,258961,105081,
0,0.0,0,0,0,0,128664,8190,492706,0.0,153880,552,0.09502848749426634,8798,518,43,497,1058,17540,0.01938949306265632,-608,0,475,0,0.09042756404482037,0,1189,0,271,1742,0,3202,918,0.05980556182969651,258961,105081,
0,0.0,0,0,0,0,128664,8190,492706,0.0,153880,552,0.09502848749426634,8798,518,43,497,1058,17540,0.01938949306265632,-608,0,475,0,0.09042756404482037,0,1189,0,271,1742,0,3202,918,0.05980556182969651,258961,105081,
0,0.0,0,0,0,0,128664,8190,492706,0.0,153880,552,0.09502848749426634,8798,518,43,497,1058,17540,0.01938949306265632,-608,0,475,0,0.09042756404482037,0,1189,0,271,1742,0,3202,918,0.05980556182969651,258961,105081,
0,0.0,0,0,0,0,128664,8190,492706,0.0,153880,552,0.09502848749426634,8798,518,43,497,1058,17540,0.01938949306265632,-608,0,475,0,0.09042756404482037,0,1189,0,271,1742,0,3202,918,0.05980556182969651,258961,105081,
0,0.0,0,0,0,0,128664,8190,492706,0.0,153880,552,0.09502848749426634,8798,518,43,497,1058,17540,0.01938949306265632,-608,0,475,0,0.09042756404482037,0,1189,0,271,1742,0,3202,918,0.05980556182969651,258961,105081,
0,0.0,0,0,0,0,128664,8190,492706,0.0,153880,552,0.09502848749426634,8798,518,43,497,1058,17540,0.01938949306265632,-608,0,475,0,0.09042756404482037,0,1189,0,271,1742,0,3202,918,0.05980556182969651,258961,105081,
0,0.0,0,0,0,0,128664,8190,492706,0.0,153880,552,0.09502848749426634,8798,518,43,497,1058,17540,0.01938949306265632,-608,0,475,0,0.09042756404482037,0,1189,0,271,1742,0,3202,918,0.05980556182969651,258961,105081,
0,0.0,0,0,0,0,128664,8190,492706,0.0,153880,552,0.09502848749426634,8798,518,43,497,1058,17540,0.01938949306265632,-608,0,475,0,0.09042756404482037,0,1189,0,271,1742,0,3202,918,0.05980556182969651,258961,105081,
0,0.0,0,0,0,0,128664,8190,492706,0.0,153880,552,0.09502848749426634,8798,518,43,497,1058,17540,0.01938949306265632,-608,0,475,0,0.09042756404482037,0,1189,0,271,1742,0,3202,918,0.05980556182969651,258961,105081,
0,0.0,0,0,0,0,128664,8190,492706,0.0,153880,552,0.09502848749426634,8798,44,41,273,358,17540,0.01938949306265632,-608,0,3,0,0.02933007183762918,0,1189,0,271,1742,0,3202,918,0.05980556182969651,258961,105081,
0,0.0,0,0,0,0,128664,8190,492706,0.0,153880,552,0.09502848749426634,8798,44,41,273,358,17540,0.01938949306265632,-608,0,3,0,0.02933007183762918,0,1189,0,271,1742,0,3202,918,0.05980556182969651,258961,105081,
103,0.2051178660049628,5,8,95,116,128664,8190,492706,0.16754237148697176,153880,552,0.09502848749426634,8798,352,232,1328,1912,17540,0.01938949306265632,-608,7,120,16,0.15402482900523531,28,641,5,266,1686,9,2593,375,0.08747203627541178,258961,105081,
103,0.2051178660049628,5,8,95,116,128664,8190,492706,0.16754237148697176,153880,552,0.09502848749426634,8798,352,232,1328,1912,17540,0.01938949306265632,-608,7,120,16,0.15402482900523531,28,641,5,266,1686,9,2593,375,0.08747203627541178,258961,105081,
103,0.2051178660049628,5,8,95,116,128664,8190,492706,0.16754237148697176,153880,552,0.09502848749426634,8798,352,232,1328,1912,17540,0.01938949306265632,-608,7,120,16,0.15402482900523531,28,641,5,266,1686,9,2593,375,0.08747203627541178,258961,105081,
103,0.2051178660049628,5,8,95,116,128664,8190,492706,0.16754237148697176,153880,552,0.09502848749426634,8798,352,232,1328,1912,17540,0.01938949306265632,-608,7,120,16,0.15402482900523531,28,641,5,266,1686,9,2593,375,0.08747203627541178,258961,105081,
103,0.2051178660049628,5,8,95,116,128664,8190,492706,0.16754237148697176,153880,552,0.09502848749426634,8798,352,232,1328,1912,17540,0.01938949306265632,-608,7,120,16,0.15402482900523531,28,641,5,266,1686,9,2593,375,0.08747203627541178,258961,105081,
103,0.2051178660049628,5,8,95,116,128664,8190,492706,0.16754237148697176,153880,552,0.09502848749426634,8798,352,232,1328,1912,17540,0.01938949306265632,-608,7,120,16,0.15402482900523531,28,641,5,266,1686,9,2593,375,0.08747203627541178,258961,105081,
103,0.2051178660049628,5,8,95,116,128664,8190,492706,0.16754237148697176,153880,552,0.09502848749426634,8798,352,232,1328,1912,17540,0.01938949306265632,-608,7,120,16,0.15402482900523531,28,641,5,266,1686,9,2593,375,0.08747203627541178,258961,105081,
103,0.2051178660049628,5,8,95,116,128664,8190,492706,0.16754237148697176,153880,552,0.09502848749426634,8798,352,232,1328,1912,17540,0.01938949306265632,-608,7,120,16,0.15402482900523531,28,641,5,266,1686,9,2593,375,0.08747203627541178,258961,105081,
103,0.2051178660049628,5,8,95,116,128664,8190,492706,0.16754237148697176,153880,552,0.09502848749426634,8798,352,232,1328,1912,17540,0.01938949306265632,-608,7,120,16,0.15402482900523531,28,641,5,266,1686,9,2593,375,0.08747203627541178,258961,105081,
103,0.2051178660049628,5,8,95,116,128664,8190,492706,0.16754237148697176,153880,552,0.09502848749426634,8798,352,232,1328,1912,17540,0.01938949306265632,-608,7,120,16,0.15402482900523531,28,641,5,266,1686,9,2593,375,0.08747203627541178,258961,105081,
103,0.2051178660049628,5,8,95,116,128664,8190,492706,0.16754237148697176,153880,552,0.09502848749426634,8798,352,232,1328,1912,17540,0.01938949306265632,-608,7,120,16,0.15402482900523531,28,641,5,266,1686,9,2593,375,0.08747203627541178,258961,105081,
103,0.2051178660049628,5,8,95,116,128664,8190,492706,0.16754237148697176,153880,552,0.09502848749426634,8798,352,232,1328,1912,17540,0.01938949306265632,-608,7,120,16,0.15402482900523531,28,641,5,266,1686,9,2593,375,0.08747203627541178,258961,105081,
103,0.2051178660049628,5,8,95,116,128664,8190,492706,0.16754237148697176,153880,552,0.09502848749426634,8798,352,232,1328,1912,17540,0.01938949306265632,-608,7,120,16,0.15402482900523531,28,641,5,266,1686,9,2593,375,0.08747203627541178,258961,105081,
103,0.2051178660049628,5,8,95,116,128664,8190,492706,0.16754237148697176,153880,552,0.09502848749426634,8798,352,232,1328,1912,17540,0.01938949306265632,-608,7,120,16,0.15402482900523531,28,641,5,266,1686,9,2593,375,0.08747203627541178,258961,105081,
103,0.2051178660049628,5,8,95,116,128664,8190,492706,0.16754237148697176,153880,552,0.09502848749426634,8798,352,232,1328,1912,17540,0.01938949306265632,-608,7,120,16,0.15402482900523531,28,641,5,266,1686,9,2593,375,0.08747203627541178,258961,105081,
103,0.2051178660049628,5,8,95,116,128664,8190,492706,0.16754237148697176,153880,552,0.09502848749426634,8798,352,232,1328,1912,17540,0.01938949306265632,-608,7,120,16,0.15402482900523531,28,641,5,266,1686,9,2593,375,0.08747203627541178,258961,105081,
103,0.2051178660049628,5,8,95,116,128664,8190,492706,0.16754237148697176,153880,552,0.09502848749426634,8798,352,232,1328,1912,17540,0.01938949306265632,-608,7,120,16,0.15402482900523531,28,641,5,266,1686,9,2593,375,0.08747203627541178,258961,105081,
103,0.2051178660049628,5,8,95,116,128664,8190,492706,0.16754237148697176,153880,552,0.09502848749426634,8798,352,232,1328,1912,17540,0.01938949306265632,-608,7,120,16,0.15402482900523531,28,641,5,266,1686,9,2593,375,0.08747203627541178,258961,105081,
103,0.2051178660049628,5,8,95,116,128664,8190,492706,0.16754237148697176,153880,552,0.09502848749426634,8798,352,232,1328,1912,17540,0.01938949306265632,-608,7,120,16,0.15402482900523531,28,641,5,266,1686,9,2593,375,0.08747203627541178,258961,105081,
103,0.2051178660049628,5,8,95,116,128664,8190,492706,0.16754237148697176,153880,552,0.09502848749426634,8798,352,232,1328,1912,17540,0.01938949306265632,-608,7,120,16,0.15402482900523531,28,641,5,266,1686,9,2593,375,0.08747203627541178,258961,105081,
103,0.2051178660049628,5,8,95,116,128664,8190,492706,0.16754237148697176,153880,552,0.09502848749426634,8798,352,232,1328,1912,17540,0.01938949306265632,-608,7,120,16,0.15402482900523531,28,641,5,266,1686,9,2593,375,0.08747203627541178,258961,105081,
103,0.421573359073359,5,8,95,116,128664,8190,492706,0.16754237148697176,153880,552,0.09502848749426634,8798,98,10,87,195,17540,0.01938949306265632,-608,0,88,86,0.11148544699958164,86,641,0,266,1686,86,2593,375,0.08747203627541178,258961,105081,
103,0.421573359073359,5,8,95,116,128664,8190,492706,0.16754237148697176,153880,552,0.09502848749426634,8798,98,10,87,195,17540,0.01938949306265632,-608,0,88,86,0.11148544699958164,86,641,0,266,1686,86,2593,375,0.08747203627541178,258961,105081,
103,0.421573359073359,5,8,95,116,128664,8190,492706,0.16754237148697176,153880,552,0.09502848749426634,8798,98,10,87,195,17540,0.01938949306265632,-608,0,88,86,0.11148544699958164,86,641,0,266,1686,86,2593,375,0.08747203627541178,258961,105081,
0,0.0,0,0,0,0,128664,8190,492706,0.0,153880,552,0.09502848749426634,8798,63,3,2,68,17540,0.01938949306265632,-608,0,60,0,0.16161331805528759,0,757,0,259,355,0,1371,498,0.06761734196980768,258961,105081,
0,0.0,0,0,0,0,128664,8190,492706,0.0,153880,552,0.09502848749426634,8798,29,2,30,61,17540,0.01938949306265632,-608,0,27,0,0.0013160362802338667,0,757,0,259,355,0,1371,498,0.06761734196980768,258961,105081,
0,0.0,0,0,0,0,128664,8190,492706,0.0,153880,552,0.09502848749426634,8798,29,2,30,61,17540,0.01938949306265632,-608,0,27,0,0.0013160362802338667,0,757,0,259,355,0,1371,498,0.06761734196980768,258961,105081,
0,0.0,0,0,0,0,128664,8190,492706,0.0,153880,552,0.09502848749426634,8798,29,2,30,61,17540,0.01938949306265632,-608,0,27,0,0.0013160362802338667,0,757,0,259,355,0,1371,498,0.06761734196980768,258961,105081,
0,0.0,0,0,0,0,128664,8190,492706,0.0,153880,552,0.09502848749426634,8798,29,2,30,61,17540,0.01938949306265632,-608,0,27,0,0.0013160362802338667,0,757,0,259,355,0,1371,498,0.06761734196980768,258961,105081,
0,0.0,0,0,0,0,128664,8190,492706,0.0,153880,552,0.09502848749426634,8798,182,34,160,376,17540,0.01938949306265632,-608,0,148,0,0.08781972978910195,0,757,0,259,355,0,1371,498,0.06761734196980768,258961,105081,
0,0.0,0,0,0,0,128664,8190,492706,0.0,153880,552,0.09502848749426634,8798,182,34,160,376,17540,0.01938949306265632,-608,0,148,0,0.08781972978910195,0,757,0,259,355,0,1371,498,0.06761734196980768,258961,105081,
0,0.0,0,0,0,0,128664,8190,492706,0.0,153880,552,0.09502848749426634,8798,182,34,160,376,17540,0.01938949306265632,-608,0,148,0,0.08781972978910195,0,757,0,259,355,0,1371,498,0.06761734196980768,258961,105081,
0,0.0,0,0,0,0,128664,8190,492706,0.0,153880,552,0.09502848749426634,8798,14,21,5,40,17540,0.01938949306265632,-608,0,-7,0,0.05798045756228048,0,757,0,259,355,0,1371,498,0.06761734196980768,258961,105081,
0,0.0,0,0,0,0,128664,8190,492706,0.0,153880,552,0.09502848749426634,8798,14,21,5,40,17540,0.01938949306265632,-608,0,-7,0,0.05798045756228048,0,757,0,259,355,0,1371,498,0.06761734196980768,258961,105081,
0,0.0,0,0,0,0,128664,8190,492706,0.0,153880,552,0.09502848749426634,8798,9,13,81,103,17540,0.01938949306265632,-608,0,-4,0,0.016169265757161697,0,757,0,259,355,0,1371,498,0.06761734196980768,258961,105081,
0,0.0,0,0,0,0,128664,8190,492706,0.0,153880,552,0.09502848749426634,8798,272,20,10,302,17540,0.01938949306265632,-608,0,252,0,0.006630736579557833,0,577,0,116,31,0,724,461,0.03461732600412185,258961,105081,
0,0.0,0,0,0,0,128664,8190,492706,0.0,153880,552,0.09502848749426634,8798,272,20,10,302,17540,0.01938949306265632,-608,0,252,0,0.006630736579557833,0,577,0,116,31,0,724,461,0.03461732600412185,258961,105081,
0,0.0,0,0,0,0,128664,8190,492706,0.0,153880,552,0.09502848749426634,8798,272,20,10,302,17540,0.01938949306265632,-608,0,252,0,0.006630736579557833,0,577,0,116,31,0,724,461,0.03461732600412185,258961,105081,
0,0.0,0,0,0,0,128664,8190,492706,0.0,153880,552,0.09502848749426634,8798,272,20,10,302,17540,0.01938949306265632,-608,0,252,0,0.006630736579557833,0,577,0,116,31,0,724,461,0.03461732600412185,258961,105081,
0,0.0,0,0,0,0,128664,8190,492706,0.0,153880,552,0.09502848749426634,8798,272,20,10,302,17540,0.01938949306265632,-608,0,252,0,0.006630736579557833,0,577,0,116,31,0,724,461,0.03461732600412185,258961,105081,
0,0.0,0,0,0,0,128664,8190,492706,0.0,153880,552,0.09502848749426634,8798,272,20,10,302,17540,0.01938949306265632,-608,0,252,0,0.006630736579557833,0,577,0,116,31,0,724,461,0.03461732600412185,258961,105081,
0,0.0,0,0,0,0,128664,8190,492706,0.0,153880,552,0.09502848749426634,8798,272,20,10,302,17540,0.01938949306265632,-608,0,252,0,0.006630736579557833,0,577,0,116,31,0,724,461,0.03461732600412185,258961,105081,
0,0.0,0,0,0,0,128664,8190,492706,0.0,153880,552,0.09502848749426634,8798,272,20,10,302,17540,0.01938949306265632,-608,0,252,0,0.006630736579557833,0,577,0,116,31,0,724,461,0.03461732600412185,258961,105081,
0,0.0,0,0,0,0,128664,8190,492706,0.0,153880,552,0.09502848749426634,8798,272,20,10,302,17540,0.01938949306265632,-608,0,252,0,0.006630736579557833,0,577,0,116,31,0,724,461,0.03461732600412185,258961,105081,
0,0.0,0,0,0,0,128664,8190,492706,0.0,153880,552,0.09502848749426634,8798,133,32,2,167,17540,0.01938949306265632,-608,0,101,0,0.08445807300837899,0,577,0,116,31,0,724,461,0.03461732600412185,258961,105081,
0,0.0,0,0,0,0,128664,8190,492706,0.0,153880,552,0.09502848749426634,8798,133,32,2,167,17540,0.01938949306265632,-608,0,101,0,0.08445807300837899,0,577,0,116,31,0,724,461,0.03461732600412185,258961,105081,
0,0.0,0,0,0,0,128664,8190,492706,0.0,153880,552,0.09502848749426634,8798,133,32,2,167,17540,0.01938949306265632,-608,0,101,0,0.08445807300837899,0,577,0,116,31,0,724,461,0.03461732600412185,258961,105081,
0,0.0,0,0,0,0,128664,8190,492706,0.0,153880,552,0.09502848749426634,8798,133,32,2,167,17540,0.01938949306265632,-608,0,101,0,0.08445807300837899,0,577,0,116,31,0,724,461,0.03461732600412185,258961,105081,
0,0.0,0,0,0,0,128664,8190,492706,0.0,153880,552,0.09502848749426634,8798,8,8,79,95,17540,0.01938949306265632,-608,0,0,0,0.009693505852155766,0,372,0,97,625,0,1094,275,0.04888842026154124,258961,105081,
0,0.0,0,0,0,0,128664,8190,492706,0.0,153880,552,0.09502848749426634,8798,8,8,79,95,17540,0.01938949306265632,-608,0,0,0,0.009693505852155766,0,372,0,97,625,0,1094,275,0.04888842026154124,258961,105081,
0,0.0,0,0,0,0,128664,8190,492706,0.0,153880,552,0.09502848749426634,8798,8,8,79,95,17540,0.01938949306265632,-608,0,0,0,0.009693505852155766,0,372,0,97,625,0,1094,275,0.04888842026154124,258961,105081,
0,0.0,0,0,0,0,128664,8190,492706,0.0,153880,552,0.09502848749426634,8798,107,67,304,478,17540,0.01938949306265632,-608,0,40,0,0.07397520808643117,0,497,0,192,672,0,1361,305,0.07144966154352657,258961,105081,
0,0.0,0,0,0,0,128664,8190,492706,0.0,153880,552,0.09502848749426634,8798,51,38,43,132,17540,0.01938949306265632,-608,0,13,0,0.08106740297488813,0,497,0,192,672,0,1361,305,0.07144966154352657,258961,105081,
0,0.0,0,0,0,0,128664,8190,492706,0.0,153880,552,0.09502848749426634,8798,51,38,43,132,17540,0.01938949306265632,-608,0,13,0,0.08106740297488813,0,497,0,192,672,0,1361,305,0.07144966154352657,258961,105081,
0,0.0,0,0,0,0,128664,8190,492706,0.0,153880,552,0.09502848749426634,8798,42,26,36,104,17540,0.01938949306265632,-608,0,16,0,0.058464668456981395,0,497,0,192,672,0,1361,305,0.07144966154352657,258961,105081,
0,0.0,0,0,0,0,128664,8190,492706,0.0,153880,552,0.09502848749426634,8798,42,26,36,104,17540,0.01938949306265632,-608,0,16,0,0.058464668456981395,0,497,0,192,672,0,1361,305,0.07144966154352657,258961,105081,
0,0.0,0,0,0,0,128664,8190,492706,0.0,153880,552,0.09502848749426634,8798,42,26,36,104,17540,0.01938949306265632,-608,0,16,0,0.058464668456981395,0,497,0,192,672,0,1361,305,0.07144966154352657,258961,105081,
0,0.0,0,0,0,0,128664,8190,492706,0.0,153880,552,0.09502848749426634,8798,42,26,36,104,17540,0.01938949306265632,-608,0,16,0,0.058464668456981395,0,497,0,192,672,0,1361,305,0.07144966154352657,258961,105081,
0,0.0,0,0,0,0,128664,8190,492706,0.0,153880,552,0.09502848749426634,8798,42,26,36,104,17540,0.01938949306265632,-608,0,16,0,0.058464668456981395,0,497,0,192,672,0,1361,305,0.07144966154352657,258961,105081,
0,0.0,0,0,0,0,128664,8190,492706,0.0,153880,552,0.09502848749426634,8798,42,26,36,104,17540,0.01938949306265632,-608,0,16,0,0.058464668456981395,0,497,0,192,672,0,1361,305,0.07144966154352657,258961,105081,
0,0.0,0,0,0,0,128664,8190,492706,0.0,153880,552,0.09502848749426634,8798,42,26,36,104,17540,0.01938949306265632,-608,0,16,0,0.058464668456981395,0,497,0,192,672,0,1361,305,0.07144966154352657,258961,105081,
0,0.0,0,0,0,0,128664,8190,492706,0.0,153880,552,0.09502848749426634,8798,277,38,227,542,17540,0.01938949306265632,-608,0,239,0,0.06498366936208923,0,497,0,192,672,0,1361,305,0.07144966154352657,258961,105081,
0,0.0,0,0,0,0,128664,8190,492706,0.0,153880,552,0.09502848749426634,8798,277,38,227,542,17540,0.01938949306265632,-608,0,239,0,0.06498366936208923,0,497,0,192,672,0,1361,305,0.07144966154352657,258961,105081,
0,0.0,0,0,0,0,128664,8190,492706,0.0,153880,552,0.09502848749426634,8798,277,38,227,542,17540,0.01938949306265632,-608,0,239,0,0.06498366936208923,0,497,0,192,672,0,1361,305,0.07144966154352657,258961,105081,
0,0.0,0,0,0,0,128664,8190,492706,0.0,153880,552,0.09502848749426634,8798,171,22,162,355,17540,0.01938949306265632,-608,0,149,0,0.05170231619310116,0,607,0,63,439,0,1109,544,0.14142363977667308,258961,105081,
0,0.0,0,0,0,0,128664,8190,492706,0.0,153880,552,0.09502848749426634,8798,54,3,0,57,17540,0.01938949306265632,-608,0,51,0,0.3478154148257241,0,607,0,63,439,0,1109,544,0.14142363977667308,258961,105081,
0,0.0,0,0,0,0,128664,8190,492706,0.0,153880,552,0.09502848749426634,8798,642,32,2,676,17540,0.01938949306265632,-608,0,610,0,0.03418394079252708,0,1055,0,86,578,0,1719,969,0.027836362509639896,258961,105081,
0,0.0,0,0,0,0,128664,8190,492706,0.0,153880,552,0.09502848749426634,8798,642,32,2,676,17540,0.01938949306265632,-608,0,610,0,0.03418394079252708,0,1055,0,86,578,0,1719,969,0.027836362509639896,258961,105081,
0,0.0,0,0,0,0,128664,8190,492706,0.0,153880,552,0.09502848749426634,8798,642,32,2,676,17540,0.01938949306265632,-608,0,610,0,0.03418394079252708,0,1055,0,86,578,0,1719,969,0.027836362509639896,258961,105081,
13,0.0,0,119,-106,132,128664,8190,492706,0.019874767693535317,153880,552,0.09502848749426634,8798,3,5,98,106,17540,0.01938949306265632,-608,0,-2,0,0.06118198875648351,0,3555,0,1347,2030,0,6932,2208,0.10795252194571142,258961,105081,
13,0.0,0,119,-106,132,128664,8190,492706,0.019874767693535317,153880,552,0.09502848749426634,8798,315,135,15,465,17540,0.01938949306265632,-608,0,180,0,0.16501262612971848,0,3555,0,1347,2030,0,6932,2208,0.10795252194571142,258961,105081,
13,0.0,0,119,-106,132,128664,8190,492706,0.019874767693535317,153880,552,0.09502848749426634,8798,407,90,53,550,17540,0.01938949306265632,-608,0,317,0,0.12554604381880644,0,3555,0,1347,2030,0,6932,2208,0.10795252194571142,258961,105081,
13,0.1875,0,119,-106,132,128664,8190,492706,0.019874767693535317,153880,552,0.09502848749426634,8798,281,56,1,338,17540,0.01938949306265632,-608,2,225,1,0.17693925872467467,3,3555,0,1347,2030,-1,6932,2208,0.10795252194571142,258961,105081,
13,0.1875,0,119,-106,132,128664,8190,492706,0.019874767693535317,153880,552,0.09502848749426634,8798,281,56,1,338,17540,0.01938949306265632,-608,2,225,1,0.17693925872467467,3,3555,0,1347,2030,-1,6932,2208,0.10795252194571142,258961,105081,
13,0.0,0,119,-106,132,128664,8190,492706,0.019874767693535317,153880,552,0.09502848749426634,8798,16,14,205,235,17540,0.01938949306265632,-608,0,2,0,0.029893433697959673,0,3555,0,1347,2030,0,6932,2208,0.10795252194571142,258961,105081,
13,0.0,0,119,-106,132,128664,8190,492706,0.019874767693535317,153880,552,0.09502848749426634,8798,238,9,5,252,17540,0.01938949306265632,-608,0,229,0,0.01645993595940674,0,3555,0,1347,2030,0,6932,2208,0.10795252194571142,258961,105081,
13,0.0,0,119,-106,132,128664,8190,492706,0.019874767693535317,153880,552,0.09502848749426634,8798,14,5,83,102,17540,0.01938949306265632,-608,0,9,0,0.016063430148445114,0,3555,0,1347,2030,0,6932,2208,0.10795252194571142,258961,105081,
51,0.4583333333333333,1,19,32,71,128664,8190,492706,0.055837789661319075,153880,552,0.09502848749426634,8798,39,6,1,46,17540,0.01938949306265632,-608,4,33,39,0.23009345072598084,44,6053,1,3089,1257,35,10399,2964,0.12207513089021535,258961,105081,
51,0.4583333333333333,1,19,32,71,128664,8190,492706,0.055837789661319075,153880,552,0.09502848749426634,8798,39,6,1,46,17540,0.01938949306265632,-608,4,33,39,0.23009345072598084,44,6053,1,3089,1257,35,10399,2964,0.12207513089021535,258961,105081,
51,0.4583333333333333,1,19,32,71,128664,8190,492706,0.055837789661319075,153880,552,0.09502848749426634,8798,39,6,1,46,17540,0.01938949306265632,-608,4,33,39,0.23009345072598084,44,6053,1,3089,1257,35,10399,2964,0.12207513089021535,258961,105081,
51,0.0,1,19,32,71,128664,8190,492706,0.055837789661319075,153880,552,0.09502848749426634,8798,2445,2140,171,4756,17540,0.01938949306265632,-608,0,305,0,0.2617166499810297,0,6053,0,3089,1257,0,10399,2964,0.12207513089021535,258961,105081,
51,0.0,1,19,32,71,128664,8190,492706,0.055837789661319075,153880,552,0.09502848749426634,8798,2445,2140,171,4756,17540,0.01938949306265632,-608,0,305,0,0.2617166499810297,0,6053,0,3089,1257,0,10399,2964,0.12207513089021535,258961,105081,
51,0.3484848484848485,1,19,32,71,128664,8190,492706,0.055837789661319075,153880,552,0.09502848749426634,8798,1213,108,2,1323,17540,0.01938949306265632,-608,13,1105,10,0.06230359549068995,23,6053,0,3089,1257,-3,10399,2964,0.12207513089021535,258961,105081,
51,0.3484848484848485,1,19,32,71,128664,8190,492706,0.055837789661319075,153880,552,0.09502848749426634,8798,1213,108,2,1323,17540,0.01938949306265632,-608,13,1105,10,0.06230359549068995,23,6053,0,3089,1257,-3,10399,2964,0.12207513089021535,258961,105081,
51,0.3484848484848485,1,19,32,71,128664,8190,492706,0.055837789661319075,153880,552,0.09502848749426634,8798,1213,108,2,1323,17540,0.01938949306265632,-608,13,1105,10,0.06230359549068995,23,6053,0,3089,1257,-3,10399,2964,0.12207513089021535,258961,105081,
51,0.3484848484848485,1,19,32,71,128664,8190,492706,0.055837789661319075,153880,552,0.09502848749426634,8798,1213,108,2,1323,17540,0.01938949306265632,-608,13,1105,10,0.06230359549068995,23,6053,0,3089,1257,-3,10399,2964,0.12207513089021535,258961,105081,
51,0.3484848484848485,1,19,32,71,128664,8190,492706,0.055837789661319075,153880,552,0.09502848749426634,8798,1213,108,2,1323,17540,0.01938949306265632,-608,13,1105,10,0.06230359549068995,23,6053,0,3089,1257,-3,10399,2964,0.12207513089021535,258961,105081,
51,0.3484848484848485,1,19,32,71,128664,8190,492706,0.055837789661319075,153880,552,0.09502848749426634,8798,1213,108,2,1323,17540,0.01938949306265632,-608,13,1105,10,0.06230359549068995,23,6053,0,3089,1257,-3,10399,2964,0.12207513089021535,258961,105081,
51,0.3484848484848485,1,19,32,71,128664,8190,492706,0.055837789661319075,153880,552,0.09502848749426634,8798,1213,108,2,1323,17540,0.01938949306265632,-608,13,1105,10,0.06230359549068995,23,6053,0,3089,1257,-3,10399,2964,0.12207513089021535,258961,105081,
51,0.3484848484848485,1,19,32,71,128664,8190,492706,0.055837789661319075,153880,552,0.09502848749426634,8798,1213,108,2,1323,17540,0.01938949306265632,-608,13,1105,10,0.06230359549068995,23,6053,0,3089,1257,-3,10399,2964,0.12207513089021535,258961,105081,
51,0.3484848484848485,1,19,32,71,128664,8190,492706,0.055837789661319075,153880,552,0.09502848749426634,8798,1213,108,2,1323,17540,0.01938949306265632,-608,13,1105,10,0.06230359549068995,23,6053,0,3089,1257,-3,10399,2964,0.12207513089021535,258961,105081,
51,0.3484848484848485,1,19,32,71,128664,8190,492706,0.055837789661319075,153880,552,0.09502848749426634,8798,1213,108,2,1323,17540,0.01938949306265632,-608,13,1105,10,0.06230359549068995,23,6053,0,3089,1257,-3,10399,2964,0.12207513089021535,258961,105081,
51,0.3484848484848485,1,19,32,71,128664,8190,492706,0.055837789661319075,153880,552,0.09502848749426634,8798,1213,108,2,1323,17540,0.01938949306265632,-608,13,1105,10,0.06230359549068995,23,6053,0,3089,1257,-3,10399,2964,0.12207513089021535,258961,105081,
51,0.3484848484848485,1,19,32,71,128664,8190,492706,0.055837789661319075,153880,552,0.09502848749426634,8798,1213,108,2,1323,17540,0.01938949306265632,-608,13,1105,10,0.06230359549068995,23,6053,0,3089,1257,-3,10399,2964,0.12207513089021535,258961,105081,
51,0.3484848484848485,1,19,32,71,128664,8190,492706,0.055837789661319075,153880,552,0.09502848749426634,8798,1213,108,2,1323,17540,0.01938949306265632,-608,13,1105,10,0.06230359549068995,23,6053,0,3089,1257,-3,10399,2964,0.12207513089021535,258961,105081,
51,0.3484848484848485,1,19,32,71,128664,8190,492706,0.055837789661319075,153880,552,0.09502848749426634,8798,1213,108,2,1323,17540,0.01938949306265632,-608,13,1105,10,0.06230359549068995,23,6053,0,3089,1257,-3,10399,2964,0.12207513089021535,258961,105081,
51,0.3484848484848485,1,19,32,71,128664,8190,492706,0.055837789661319075,153880,552,0.09502848749426634,8798,1213,108,2,1323,17540,0.01938949306265632,-608,13,1105,10,0.06230359549068995,23,6053,0,3089,1257,-3,10399,2964,0.12207513089021535,258961,105081,
51,0.3484848484848485,1,19,32,71,128664,8190,492706,0.055837789661319075,153880,552,0.09502848749426634,8798,1213,108,2,1323,17540,0.01938949306265632,-608,13,1105,10,0.06230359549068995,23,6053,0,3089,1257,-3,10399,2964,0.12207513089021535,258961,105081,
51,0.3484848484848485,1,19,32,71,128664,8190,492706,0.055837789661319075,153880,552,0.09502848749426634,8798,1213,108,2,1323,17540,0.01938949306265632,-608,13,1105,10,0.06230359549068995,23,6053,0,3089,1257,-3,10399,2964,0.12207513089021535,258961,105081,
51,0.3484848484848485,1,19,32,71,128664,8190,492706,0.055837789661319075,153880,552,0.09502848749426634,8798,1213,108,2,1323,17540,0.01938949306265632,-608,13,1105,10,0.06230359549068995,23,6053,0,3089,1257,-3,10399,2964,0.12207513089021535,258961,105081,
51,0.3484848484848485,1,19,32,71,128664,8190,492706,0.055837789661319075,153880,552,0.09502848749426634,8798,1213,108,2,1323,17540,0.01938949306265632,-608,13,1105,10,0.06230359549068995,23,6053,0,3089,1257,-3,10399,2964,0.12207513089021535,258961,105081,
51,0.3484848484848485,1,19,32,71,128664,8190,492706,0.055837789661319075,153880,552,0.09502848749426634,8798,1213,108,2,1323,17540,0.01938949306265632,-608,13,1105,10,0.06230359549068995,23,6053,0,3089,1257,-3,10399,2964,0.12207513089021535,258961,105081,
51,0.3484848484848485,1,19,32,71,128664,8190,492706,0.055837789661319075,153880,552,0.09502848749426634,8798,1213,108,2,1323,17540,0.01938949306265632,-608,13,1105,10,0.06230359549068995,23,6053,0,3089,1257,-3,10399,2964,0.12207513089021535,258961,105081,
51,0.3484848484848485,1,19,32,71,128664,8190,492706,0.055837789661319075,153880,552,0.09502848749426634,8798,1213,108,2,1323,17540,0.01938949306265632,-608,13,1105,10,0.06230359549068995,23,6053,0,3089,1257,-3,10399,2964,0.12207513089021535,258961,105081,
51,0.3484848484848485,1,19,32,71,128664,8190,492706,0.055837789661319075,153880,552,0.09502848749426634,8798,1213,108,2,1323,17540,0.01938949306265632,-608,13,1105,10,0.06230359549068995,23,6053,0,3089,1257,-3,10399,2964,0.12207513089021535,258961,105081,
51,0.3484848484848485,1,19,32,71,128664,8190,492706,0.055837789661319075,153880,552,0.09502848749426634,8798,1213,108,2,1323,17540,0.01938949306265632,-608,13,1105,10,0.06230359549068995,23,6053,0,3089,1257,-3,10399,2964,0.12207513089021535,258961,105081,
51,0.3484848484848485,1,19,32,71,128664,8190,492706,0.055837789661319075,153880,552,0.09502848749426634,8798,1213,108,2,1323,17540,0.01938949306265632,-608,13,1105,10,0.06230359549068995,23,6053,0,3089,1257,-3,10399,2964,0.12207513089021535,258961,105081,
51,0.3484848484848485,1,19,32,71,128664,8190,492706,0.055837789661319075,153880,552,0.09502848749426634,8798,1213,108,2,1323,17540,0.01938949306265632,-608,13,1105,10,0.06230359549068995,23,6053,0,3089,1257,-3,10399,2964,0.12207513089021535,258961,105081,
51,0.0,1,19,32,71,128664,8190,492706,0.055837789661319075,153880,552,0.09502848749426634,8798,126,100,9,235,17540,0.01938949306265632,-608,0,26,0,0.07756435793996841,0,6053,0,3089,1257,0,10399,2964,0.12207513089021535,258961,105081,
51,0.0,1,19,32,71,128664,8190,492706,0.055837789661319075,153880,552,0.09502848749426634,8798,16,19,238,273,17540,0.01938949306265632,-608,0,-3,0,0.14933497519063726,0,6053,0,3089,1257,0,10399,2964,0.12207513089021535,258961,105081,
0,0.0,0,16,-16,16,128664,8190,492706,0.042328042328042326,153880,552,0.09502848749426634,8798,226,6,0,232,17540,0.01938949306265632,-608,0,220,0,0.22591555581808995,0,919,0,49,93,0,1061,870,0.1300053261830006,258961,105081,
0,0.0,0,16,-16,16,128664,8190,492706,0.042328042328042326,153880,552,0.09502848749426634,8798,226,6,0,232,17540,0.01938949306265632,-608,0,220,0,0.22591555581808995,0,919,0,49,93,0,1061,870,0.1300053261830006,258961,105081,
0,0.0,0,16,-16,16,128664,8190,492706,0.042328042328042326,153880,552,0.09502848749426634,8798,226,6,0,232,17540,0.01938949306265632,-608,0,220,0,0.22591555581808995,0,919,0,49,93,0,1061,870,0.1300053261830006,258961,105081,
0,0.0,0,16,-16,16,128664,8190,492706,0.042328042328042326,153880,552,0.09502848749426634,8798,226,6,0,232,17540,0.01938949306265632,-608,0,220,0,0.22591555581808995,0,919,0,49,93,0,1061,870,0.1300053261830006,258961,105081,
0,0.0,0,16,-16,16,128664,8190,492706,0.042328042328042326,153880,552,0.09502848749426634,8798,226,6,0,232,17540,0.01938949306265632,-608,0,220,0,0.22591555581808995,0,919,0,49,93,0,1061,870,0.1300053261830006,258961,105081,
0,0.0,0,16,-16,16,128664,8190,492706,0.042328042328042326,153880,552,0.09502848749426634,8798,226,6,0,232,17540,0.01938949306265632,-608,0,220,0,0.22591555581808995,0,919,0,49,93,0,1061,870,0.1300053261830006,258961,105081,
0,0.0,0,16,-16,16,128664,8190,492706,0.042328042328042326,153880,552,0.09502848749426634,8798,226,6,0,232,17540,0.01938949306265632,-608,0,220,0,0.22591555581808995,0,919,0,49,93,0,1061,870,0.1300053261830006,258961,105081,
0,0.0,0,16,-16,16,128664,8190,492706,0.042328042328042326,153880,552,0.09502848749426634,8798,226,6,0,232,17540,0.01938949306265632,-608,0,220,0,0.22591555581808995,0,919,0,49,93,0,1061,870,0.1300053261830006,258961,105081,
0,0.0,0,16,-16,16,128664,8190,492706,0.042328042328042326,153880,552,0.09502848749426634,8798,7,6,80,93,17540,0.01938949306265632,-608,0,1,0,0.13537117903930132,0,919,0,49,93,0,1061,870,0.1300053261830006,258961,105081,
0,0.0,0,16,-16,16,128664,8190,492706,0.042328042328042326,153880,552,0.09502848749426634,8798,7,6,80,93,17540,0.01938949306265632,-608,0,1,0,0.13537117903930132,0,919,0,49,93,0,1061,870,0.1300053261830006,258961,105081,
0,0.2962962962962963,0,16,-16,16,128664,8190,492706,0.042328042328042326,153880,552,0.09502848749426634,8798,666,31,1,698,17540,0.01938949306265632,-608,16,635,0,0.22649490209048165,16,919,0,49,93,-16,1061,870,0.1300053261830006,258961,105081,
0,0.2962962962962963,0,16,-16,16,128664,8190,492706,0.042328042328042326,153880,552,0.09502848749426634,8798,666,31,1,698,17540,0.01938949306265632,-608,16,635,0,0.22649490209048165,16,919,0,49,93,-16,1061,870,0.1300053261830006,258961,105081,
0,0.2962962962962963,0,16,-16,16,128664,8190,492706,0.042328042328042326,153880,552,0.09502848749426634,8798,666,31,1,698,17540,0.01938949306265632,-608,16,635,0,0.22649490209048165,16,919,0,49,93,-16,1061,870,0.1300053261830006,258961,105081,
0,0.2962962962962963,0,16,-16,16,128664,8190,492706,0.042328042328042326,153880,552,0.09502848749426634,8798,666,31,1,698,17540,0.01938949306265632,-608,16,635,0,0.22649490209048165,16,919,0,49,93,-16,1061,870,0.1300053261830006,258961,105081,
0,0.2962962962962963,0,16,-16,16,128664,8190,492706,0.042328042328042326,153880,552,0.09502848749426634,8798,666,31,1,698,17540,0.01938949306265632,-608,16,635,0,0.22649490209048165,16,919,0,49,93,-16,1061,870,0.1300053261830006,258961,105081,
0,0.2962962962962963,0,16,-16,16,128664,8190,492706,0.042328042328042326,153880,552,0.09502848749426634,8798,666,31,1,698,17540,0.01938949306265632,-608,16,635,0,0.22649490209048165,16,919,0,49,93,-16,1061,870,0.1300053261830006,258961,105081,
64,0.20295386058932857,2,38,26,104,128664,8190,492706,0.037569062880289064,153880,552,0.09502848749426634,8798,65,17,0,82,17540,0.01938949306265632,-608,11,48,18,0.2674594364713171,29,2212,0,346,51,7,2609,1866,0.10737479155027309,258961,105081,
64,0.20295386058932857,2,38,26,104,128664,8190,492706,0.037569062880289064,153880,552,0.09502848749426634,8798,65,17,0,82,17540,0.01938949306265632,-608,11,48,18,0.2674594364713171,29,2212,0,346,51,7,2609,1866,0.10737479155027309,258961,105081,
64,0.20295386058932857,2,38,26,104,128664,8190,492706,0.037569062880289064,153880,552,0.09502848749426634,8798,65,17,0,82,17540,0.01938949306265632,-608,11,48,18,0.2674594364713171,29,2212,0,346,51,7,2609,1866,0.10737479155027309,258961,105081,
64,0.047619047619047616,2,38,26,104,128664,8190,492706,0.037569062880289064,153880,552,0.09502848749426634,8798,215,19,3,237,17540,0.01938949306265632,-608,0,196,0,0.1600725257396964,1,2212,1,346,51,0,2609,1866,0.10737479155027309,258961,105081,
64,0.0,2,38,26,104,128664,8190,492706,0.037569062880289064,153880,552,0.09502848749426634,8798,59,8,2,69,17540,0.01938949306265632,-608,0,51,0,0.16186060205500852,0,2212,0,346,51,0,2609,1866,0.10737479155027309,258961,105081,
64,0.0,2,38,26,104,128664,8190,492706,0.037569062880289064,153880,552,0.09502848749426634,8798,114,0,0,114,17540,0.01938949306265632,-608,0,114,0,0.022128757724949044,0,2212,0,346,51,0,2609,1866,0.10737479155027309,258961,105081,
64,0.0,2,38,26,104,128664,8190,492706,0.037569062880289064,153880,552,0.09502848749426634,8798,114,0,0,114,17540,0.01938949306265632,-608,0,114,0,0.022128757724949044,0,2212,0,346,51,0,2609,1866,0.10737479155027309,258961,105081,
64,0.0,2,38,26,104,128664,8190,492706,0.037569062880289064,153880,552,0.09502848749426634,8798,179,7,3,189,17540,0.01938949306265632,-608,0,172,0,0.07939484368611885,0,2212,0,346,51,0,2609,1866,0.10737479155027309,258961,105081,
64,0.0,2,38,26,104,128664,8190,492706,0.037569062880289064,153880,552,0.09502848749426634,8798,125,4,0,129,17540,0.01938949306265632,-608,0,121,0,0.07163939000655581,0,2212,0,346,51,0,2609,1866,0.10737479155027309,258961,105081,
64,0.0,2,38,26,104,128664,8190,492706,0.037569062880289064,153880,552,0.09502848749426634,8798,125,4,0,129,17540,0.01938949306265632,-608,0,121,0,0.07163939000655581,0,2212,0,346,51,0,2609,1866,0.10737479155027309,258961,105081,
127,0.2857894560220141,2,100,27,229,128664,8190,492706,0.09784511532484107,153880,552,0.09502848749426634,8798,675,139,20,834,17540,0.01938949306265632,-608,21,536,57,0.23413499698381157,78,2473,0,751,1390,36,4614,1722,0.11496638547930414,258961,105081,
127,0.2857894560220141,2,100,27,229,128664,8190,492706,0.09784511532484107,153880,552,0.09502848749426634,8798,675,139,20,834,17540,0.01938949306265632,-608,21,536,57,0.23413499698381157,78,2473,0,751,1390,36,4614,1722,0.11496638547930414,258961,105081,
127,0.26231884057971017,2,100,27,229,128664,8190,492706,0.09784511532484107,153880,552,0.09502848749426634,8798,134,110,444,688,17540,0.01938949306265632,-608,3,24,8,0.16487599930334937,11,2473,0,751,1390,5,4614,1722,0.11496638547930414,258961,105081,
127,0.26231884057971017,2,100,27,229,128664,8190,492706,0.09784511532484107,153880,552,0.09502848749426634,8798,134,110,444,688,17540,0.01938949306265632,-608,3,24,8,0.16487599930334937,11,2473,0,751,1390,5,4614,1722,0.11496638547930414,258961,105081,
74,0.0,0,184,-110,258,128664,8190,492706,0.041982143221024386,153880,552,0.09502848749426634,8798,427,118,6,551,17540,0.01938949306265632,-608,0,309,0,0.15498538266459683,0,6376,0,4815,1421,0,12612,1561,0.13183757181397457,258961,105081,
74,0.15255751694310396,0,184,-110,258,128664,8190,492706,0.041982143221024386,153880,552,0.09502848749426634,8798,1711,1075,37,2823,17540,0.01938949306265632,-608,142,636,42,0.11415443824243972,184,6376,0,4815,1421,-100,12612,1561,0.13183757181397457,258961,105081,
74,0.01694915254237288,0,184,-110,258,128664,8190,492706,0.041982143221024386,153880,552,0.09502848749426634,8798,157,28,263,448,17540,0.01938949306265632,-608,0,129,1,0.13151340806247905,1,6376,0,4815,1421,1,12612,1561,0.13183757181397457,258961,105081,
3581,0.11267605633802817,48,6021,-2440,9650,128664,8190,492706,0.1427211368724363,153880,552,0.09502848749426634,8798,12,15,0,27,17540,0.01938949306265632,-608,14,-3,2,0.03221623953175411,16,16622,0,15273,4880,-12,36775,1349,0.14803941399633153,258961,105081,
3581,0.0,48,6021,-2440,9650,128664,8190,492706,0.1427211368724363,153880,552,0.09502848749426634,8798,24,13,0,37,17540,0.01938949306265632,-608,0,11,0,0.0913927038815926,0,16622,0,15273,4880,0,36775,1349,0.14803941399633153,258961,105081,
3581,0.0,48,6021,-2440,9650,128664,8190,492706,0.1427211368724363,153880,552,0.09502848749426634,8798,24,13,0,37,17540,0.01938949306265632,-608,0,11,0,0.0913927038815926,0,16622,0,15273,4880,0,36775,1349,0.14803941399633153,258961,105081,
3581,0.0,48,6021,-2440,9650,128664,8190,492706,0.1427211368724363,153880,552,0.09502848749426634,8798,24,13,0,37,17540,0.01938949306265632,-608,0,11,0,0.0913927038815926,0,16622,0,15273,4880,0,36775,1349,0.14803941399633153,258961,105081,
3581,0.0,48,6021,-2440,9650,128664,8190,492706,0.1427211368724363,153880,552,0.09502848749426634,8798,24,13,0,37,17540,0.01938949306265632,-608,0,11,0,0.0913927038815926,0,16622,0,15273,4880,0,36775,1349,0.14803941399633153,258961,105081,
3581,0.0,48,6021,-2440,9650,128664,8190,492706,0.1427211368724363,153880,552,0.09502848749426634,8798,24,13,0,37,17540,0.01938949306265632,-608,0,11,0,0.0913927038815926,0,16622,0,15273,4880,0,36775,1349,0.14803941399633153,258961,105081,
3581,0.0,48,6021,-2440,9650,128664,8190,492706,0.1427211368724363,153880,552,0.09502848749426634,8798,24,13,0,37,17540,0.01938949306265632,-608,0,11,0,0.0913927038815926,0,16622,0,15273,4880,0,36775,1349,0.14803941399633153,258961,105081,
3581,0.0,48,6021,-2440,9650,128664,8190,492706,0.1427211368724363,153880,552,0.09502848749426634,8798,24,13,0,37,17540,0.01938949306265632,-608,0,11,0,0.0913927038815926,0,16622,0,15273,4880,0,36775,1349,0.14803941399633153,258961,105081,
3581,0.0,48,6021,-2440,9650,128664,8190,492706,0.1427211368724363,153880,552,0.09502848749426634,8798,24,13,0,37,17540,0.01938949306265632,-608,0,11,0,0.0913927038815926,0,16622,0,15273,4880,0,36775,1349,0.14803941399633153,258961,105081,
3581,0.24532740722061108,48,6021,-2440,9650,128664,8190,492706,0.1427211368724363,153880,552,0.09502848749426634,8798,921,12,2,935,17540,0.01938949306265632,-608,12,909,921,0.24532740722061108,935,16622,2,15273,4880,909,36775,1349,0.14803941399633153,258961,105081,
3581,0.24532740722061108,48,6021,-2440,9650,128664,8190,492706,0.1427211368724363,153880,552,0.09502848749426634,8798,921,12,2,935,17540,0.01938949306265632,-608,12,909,921,0.24532740722061108,935,16622,2,15273,4880,909,36775,1349,0.14803941399633153,258961,105081,
3581,0.10586392245492772,48,6021,-2440,9650,128664,8190,492706,0.1427211368724363,153880,552,0.09502848749426634,8798,255,106,4,365,17540,0.01938949306265632,-608,71,149,27,0.09557157704665215,99,16622,1,15273,4880,-44,36775,1349,0.14803941399633153,258961,105081,
3581,0.20073501782093886,48,6021,-2440,9650,128664,8190,492706,0.1427211368724363,153880,552,0.09502848749426634,8798,12,41,2,55,17540,0.01938949306265632,-608,41,-29,12,0.20073501782093886,55,16622,2,15273,4880,-29,36775,1349,0.14803941399633153,258961,105081,
3581,0.17680329075879925,48,6021,-2440,9650,128664,8190,492706,0.1427211368724363,153880,552,0.09502848749426634,8798,3417,1009,1552,5978,17540,0.01938949306265632,-608,15,2408,1659,0.10289749129928642,1685,16622,11,15273,4880,1644,36775,1349,0.14803941399633153,258961,105081,
3581,0.17680329075879925,48,6021,-2440,9650,128664,8190,492706,0.1427211368724363,153880,552,0.09502848749426634,8798,3417,1009,1552,5978,17540,0.01938949306265632,-608,15,2408,1659,0.10289749129928642,1685,16622,11,15273,4880,1644,36775,1349,0.14803941399633153,258961,105081,
3581,0.17680329075879925,48,6021,-2440,9650,128664,8190,492706,0.1427211368724363,153880,552,0.09502848749426634,8798,3417,1009,1552,5978,17540,0.01938949306265632,-608,15,2408,1659,0.10289749129928642,1685,16622,11,15273,4880,1644,36775,1349,0.14803941399633153,258961,105081,
3581,0.17680329075879925,48,6021,-2440,9650,128664,8190,492706,0.1427211368724363,153880,552,0.09502848749426634,8798,3417,1009,1552,5978,17540,0.01938949306265632,-608,15,2408,1659,0.10289749129928642,1685,16622,11,15273,4880,1644,36775,1349,0.14803941399633153,258961,105081,
35,0.014492753623188406,3,48,-13,86,128664,8190,492706,0.0806351284418525,153880,552,0.09502848749426634,8798,21,2,91,114,17540,0.01938949306265632,-608,0,19,2,0.038458356993057156,2,721,0,200,454,2,1375,521,0.05343189480397451,258961,105081,
35,0.10526315789473684,3,48,-13,86,128664,8190,492706,0.0806351284418525,153880,552,0.09502848749426634,8798,190,78,11,279,17540,0.01938949306265632,-608,8,112,13,0.14953990171924042,22,721,1,200,454,5,1375,521,0.05343189480397451,258961,105081,
35,0.08670520231213873,3,48,-13,86,128664,8190,492706,0.0806351284418525,153880,552,0.09502848749426634,8798,137,18,4,159,17540,0.01938949306265632,-608,10,119,5,0.03782827664831169,15,721,0,200,454,-5,1375,521,0.05343189480397451,258961,105081,
35,0.08670520231213873,3,48,-13,86,128664,8190,492706,0.0806351284418525,153880,552,0.09502848749426634,8798,137,18,4,159,17540,0.01938949306265632,-608,10,119,5,0.03782827664831169,15,721,0,200,454,-5,1375,521,0.05343189480397451,258961,105081,
35,0.08670520231213873,3,48,-13,86,128664,8190,492706,0.0806351284418525,153880,552,0.09502848749426634,8798,137,18,4,159,17540,0.01938949306265632,-608,10,119,5,0.03782827664831169,15,721,0,200,454,-5,1375,521,0.05343189480397451,258961,105081,
35,0.04819277108433735,3,48,-13,86,128664,8190,492706,0.0806351284418525,153880,552,0.09502848749426634,8798,147,21,0,168,17540,0.01938949306265632,-608,9,126,3,0.02630970644172888,12,721,0,200,454,-6,1375,521,0.05343189480397451,258961,105081,
35,0.04819277108433735,3,48,-13,86,128664,8190,492706,0.0806351284418525,153880,552,0.09502848749426634,8798,147,21,0,168,17540,0.01938949306265632,-608,9,126,3,0.02630970644172888,12,721,0,200,454,-6,1375,521,0.05343189480397451,258961,105081,
692,0.13597168597168596,0,18,674,710,128664,8190,492706,0.0346066149524868,153880,552,0.09502848749426634,8798,324,3,0,327,17540,0.01938949306265632,-608,3,321,324,0.13597168597168596,327,692,0,18,0,321,710,674,0.0346066149524868,258961,105081,
5,0.022222222222222223,0,17,-12,22,128664,8190,492706,0.016860785956800784,153880,552,0.09502848749426634,8798,4,10,19,33,17540,0.01938949306265632,-608,3,-6,0,0.059594290349432075,3,592,0,93,33,-3,718,499,0.075526396158074,258961,105081,
5,0.014572329453173551,0,17,-12,22,128664,8190,492706,0.016860785956800784,153880,552,0.09502848749426634,8798,533,55,4,592,17540,0.01938949306265632,-608,9,478,4,0.10604302731607956,13,592,0,93,33,-5,718,499,0.075526396158074,258961,105081,
0,0.0,0,0,0,0,128664,8190,492706,0.0,153880,552,0.09502848749426634,8798,288,18,29,335,17540,0.01938949306265632,-608,0,270,0,0.13495318097785086,0,422,0,47,384,0,853,375,0.06854825818058673,258961,105081,
0,0.0,0,0,0,0,128664,8190,492706,0.0,153880,552,0.09502848749426634,8798,288,18,29,335,17540,0.01938949306265632,-608,0,270,0,0.13495318097785086,0,422,0,47,384,0,853,375,0.06854825818058673,258961,105081,
0,0.0,0,0,0,0,128664,8190,492706,0.0,153880,552,0.09502848749426634,8798,288,18,29,335,17540,0.01938949306265632,-608,0,270,0,0.13495318097785086,0,422,0,47,384,0,853,375,0.06854825818058673,258961,105081,
0,0.0,0,0,0,0,128664,8190,492706,0.0,153880,552,0.09502848749426634,8798,17,3,64,84,17540,0.01938949306265632,-608,0,14,0,0.046577793165655516,0,422,0,47,384,0,853,375,0.06854825818058673,258961,105081,
0,0.0,0,0,0,0,128664,8190,492706,0.0,153880,552,0.09502848749426634,8798,14,8,229,251,17540,0.01938949306265632,-608,0,6,0,0.04977852579108235,0,422,0,47,384,0,853,375,0.06854825818058673,258961,105081,
0,0.0,0,0,0,0,128664,8190,492706,0.0,153880,552,0.09502848749426634,8798,14,8,229,251,17540,0.01938949306265632,-608,0,6,0,0.04977852579108235,0,422,0,47,384,0,853,375,0.06854825818058673,258961,105081,
74,0.0,0,5,69,79,128664,8190,492706,0.06810344827586207,153880,552,0.09502848749426634,8798,336,67,4,407,17540,0.01938949306265632,-608,0,269,0,0.1718993080064693,0,1467,0,233,139,0,1839,1234,0.08524235154085358,258961,105081,
74,0.0,0,5,69,79,128664,8190,492706,0.06810344827586207,153880,552,0.09502848749426634,8798,336,67,4,407,17540,0.01938949306265632,-608,0,269,0,0.1718993080064693,0,1467,0,233,139,0,1839,1234,0.08524235154085358,258961,105081,
74,0.0,0,5,69,79,128664,8190,492706,0.06810344827586207,153880,552,0.09502848749426634,8798,336,67,4,407,17540,0.01938949306265632,-608,0,269,0,0.1718993080064693,0,1467,0,233,139,0,1839,1234,0.08524235154085358,258961,105081,
74,0.0,0,5,69,79,128664,8190,492706,0.06810344827586207,153880,552,0.09502848749426634,8798,336,67,4,407,17540,0.01938949306265632,-608,0,269,0,0.1718993080064693,0,1467,0,233,139,0,1839,1234,0.08524235154085358,258961,105081,
74,0.0,0,5,69,79,128664,8190,492706,0.06810344827586207,153880,552,0.09502848749426634,8798,336,67,4,407,17540,0.01938949306265632,-608,0,269,0,0.1718993080064693,0,1467,0,233,139,0,1839,1234,0.08524235154085358,258961,105081,
74,0.0,0,5,69,79,128664,8190,492706,0.06810344827586207,153880,552,0.09502848749426634,8798,336,67,4,407,17540,0.01938949306265632,-608,0,269,0,0.1718993080064693,0,1467,0,233,139,0,1839,1234,0.08524235154085358,258961,105081,
74,0.0,0,5,69,79,128664,8190,492706,0.06810344827586207,153880,552,0.09502848749426634,8798,336,67,4,407,17540,0.01938949306265632,-608,0,269,0,0.1718993080064693,0,1467,0,233,139,0,1839,1234,0.08524235154085358,258961,105081,
74,0.0,0,5,69,79,128664,8190,492706,0.06810344827586207,153880,552,0.09502848749426634,8798,336,67,4,407,17540,0.01938949306265632,-608,0,269,0,0.1718993080064693,0,1467,0,233,139,0,1839,1234,0.08524235154085358,258961,105081,
74,0.0,0,5,69,79,128664,8190,492706,0.06810344827586207,153880,552,0.09502848749426634,8798,595,96,14,705,17540,0.01938949306265632,-608,0,499,0,0.21328051375977858,0,1467,0,233,139,0,1839,1234,0.08524235154085358,258961,105081,
74,0.0,0,5,69,79,128664,8190,492706,0.06810344827586207,153880,552,0.09502848749426634,8798,595,96,14,705,17540,0.01938949306265632,-608,0,499,0,0.21328051375977858,0,1467,0,233,139,0,1839,1234,0.08524235154085358,258961,105081,
74,0.0,0,5,69,79,128664,8190,492706,0.06810344827586207,153880,552,0.09502848749426634,8798,595,96,14,705,17540,0.01938949306265632,-608,0,499,0,0.21328051375977858,0,1467,0,233,139,0,1839,1234,0.08524235154085358,258961,105081,
74,0.0,0,5,69,79,128664,8190,492706,0.06810344827586207,153880,552,0.09502848749426634,8798,595,96,14,705,17540,0.01938949306265632,-608,0,499,0,0.21328051375977858,0,1467,0,233,139,0,1839,1234,0.08524235154085358,258961,105081,
74,0.5448275862068965,0,5,69,79,128664,8190,492706,0.06810344827586207,153880,552,0.09502848749426634,8798,251,15,26,292,17540,0.01938949306265632,-608,5,236,74,0.12677720070436907,79,1467,0,233,139,69,1839,1234,0.08524235154085358,258961,105081,
0,0.0,0,0,0,0,128664,8190,492706,0.0,153880,552,0.09502848749426634,8798,17,3,25,45,17540,0.01938949306265632,-608,0,14,0,0.013336034281723242,0,5695,0,1874,3409,0,10978,3821,0.08025230434268289,258961,105081,
0,0.0,0,0,0,0,128664,8190,492706,0.0,153880,552,0.09502848749426634,8798,65,22,84,171,17540,0.01938949306265632,-608,0,43,0,0.17497593706060002,0,5695,0,1874,3409,0,10978,3821,0.08025230434268289,258961,105081,
0,0.0,0,0,0,0,128664,8190,492706,0.0,153880,552,0.09502848749426634,8798,17,3,25,45,17540,0.01938949306265632,-608,0,14,0,0.009959394491819233,0,5695,0,1874,3409,0,10978,3821,0.08025230434268289,258961,105081,
0,0.0,0,0,0,0,128664,8190,492706,0.0,153880,552,0.09502848749426634,8798,26,9,50,85,17540,0.01938949306265632,-608,0,17,0,0.053670264827476034,0,5695,0,1874,3409,0,10978,3821,0.08025230434268289,258961,105081,
0,0.0,0,0,0,0,128664,8190,492706,0.0,153880,552,0.09502848749426634,8798,26,9,50,85,17540,0.01938949306265632,-608,0,17,0,0.053670264827476034,0,5695,0,1874,3409,0,10978,3821,0.08025230434268289,258961,105081,
0,0.0,0,0,0,0,128664,8190,492706,0.0,153880,552,0.09502848749426634,8798,156,58,112,326,17540,0.01938949306265632,-608,0,98,0,0.16040858863670207,0,5695,0,1874,3409,0,10978,3821,0.08025230434268289,258961,105081,
0,0.0,0,0,0,0,128664,8190,492706,0.0,153880,552,0.09502848749426634,8798,156,58,112,326,17540,0.01938949306265632,-608,0,98,0,0.16040858863670207,0,5695,0,1874,3409,0,10978,3821,0.08025230434268289,258961,105081,
0,0.0,0,0,0,0,128664,8190,492706,0.0,153880,552,0.09502848749426634,8798,2319,784,897,4000,17540,0.01938949306265632,-608,0,1535,0,0.27382900007713235,0,5695,0,1874,3409,0,10978,3821,0.08025230434268289,258961,105081,
0,0.0,0,0,0,0,128664,8190,492706,0.0,153880,552,0.09502848749426634,8798,2319,784,897,4000,17540,0.01938949306265632,-608,0,1535,0,0.27382900007713235,0,5695,0,1874,3409,0,10978,3821,0.08025230434268289,258961,105081,
0,0.0,0,0,0,0,128664,8190,492706,0.0,153880,552,0.09502848749426634,8798,2319,784,897,4000,17540,0.01938949306265632,-608,0,1535,0,0.27382900007713235,0,5695,0,1874,3409,0,10978,3821,0.08025230434268289,258961,105081,
0,0.0,0,0,0,0,128664,8190,492706,0.0,153880,552,0.09502848749426634,8798,2319,784,897,4000,17540,0.01938949306265632,-608,0,1535,0,0.27382900007713235,0,5695,0,1874,3409,0,10978,3821,0.08025230434268289,258961,105081,
0,0.0,0,0,0,0,128664,8190,492706,0.0,153880,552,0.09502848749426634,8798,2319,784,897,4000,17540,0.01938949306265632,-608,0,1535,0,0.27382900007713235,0,5695,0,1874,3409,0,10978,3821,0.08025230434268289,258961,105081,
0,0.0,0,0,0,0,128664,8190,492706,0.0,153880,552,0.09502848749426634,8798,2319,784,897,4000,17540,0.01938949306265632,-608,0,1535,0,0.27382900007713235,0,5695,0,1874,3409,0,10978,3821,0.08025230434268289,258961,105081,
0,0.0,0,0,0,0,128664,8190,492706,0.0,153880,552,0.09502848749426634,8798,2319,784,897,4000,17540,0.01938949306265632,-608,0,1535,0,0.27382900007713235,0,5695,0,1874,3409,0,10978,3821,0.08025230434268289,258961,105081,
0,0.0,0,0,0,0,128664,8190,492706,0.0,153880,552,0.09502848749426634,8798,2319,784,897,4000,17540,0.01938949306265632,-608,0,1535,0,0.27382900007713235,0,5695,0,1874,3409,0,10978,3821,0.08025230434268289,258961,105081,
0,0.0,0,0,0,0,128664,8190,492706,0.0,153880,552,0.09502848749426634,8798,2319,784,897,4000,17540,0.01938949306265632,-608,0,1535,0,0.27382900007713235,0,5695,0,1874,3409,0,10978,3821,0.08025230434268289,258961,105081,
0,0.0,0,0,0,0,128664,8190,492706,0.0,153880,552,0.09502848749426634,8798,2319,784,897,4000,17540,0.01938949306265632,-608,0,1535,0,0.27382900007713235,0,5695,0,1874,3409,0,10978,3821,0.08025230434268289,258961,105081,
0,0.0,0,0,0,0,128664,8190,492706,0.0,153880,552,0.09502848749426634,8798,2319,784,897,4000,17540,0.01938949306265632,-608,0,1535,0,0.27382900007713235,0,5695,0,1874,3409,0,10978,3821,0.08025230434268289,258961,105081,
0,0.0,0,0,0,0,128664,8190,492706,0.0,153880,552,0.09502848749426634,8798,2319,784,897,4000,17540,0.01938949306265632,-608,0,1535,0,0.27382900007713235,0,5695,0,1874,3409,0,10978,3821,0.08025230434268289,258961,105081,
0,0.0,0,0,0,0,128664,8190,492706,0.0,153880,552,0.09502848749426634,8798,2319,784,897,4000,17540,0.01938949306265632,-608,0,1535,0,0.27382900007713235,0,5695,0,1874,3409,0,10978,3821,0.08025230434268289,258961,105081,
0,0.0,0,0,0,0,128664,8190,492706,0.0,153880,552,0.09502848749426634,8798,2319,784,897,4000,17540,0.01938949306265632,-608,0,1535,0,0.27382900007713235,0,5695,0,1874,3409,0,10978,3821,0.08025230434268289,258961,105081,
0,0.0,0,0,0,0,128664,8190,492706,0.0,153880,552,0.09502848749426634,8798,2319,784,897,4000,17540,0.01938949306265632,-608,0,1535,0,0.27382900007713235,0,5695,0,1874,3409,0,10978,3821,0.08025230434268289,258961,105081,
0,0.0,0,0,0,0,128664,8190,492706,0.0,153880,552,0.09502848749426634,8798,2319,784,897,4000,17540,0.01938949306265632,-608,0,1535,0,0.27382900007713235,0,5695,0,1874,3409,0,10978,3821,0.08025230434268289,258961,105081,
0,0.0,0,0,0,0,128664,8190,492706,0.0,153880,552,0.09502848749426634,8798,2319,784,897,4000,17540,0.01938949306265632,-608,0,1535,0,0.27382900007713235,0,5695,0,1874,3409,0,10978,3821,0.08025230434268289,258961,105081,
0,0.0,0,0,0,0,128664,8190,492706,0.0,153880,552,0.09502848749426634,8798,2319,784,897,4000,17540,0.01938949306265632,-608,0,1535,0,0.27382900007713235,0,5695,0,1874,3409,0,10978,3821,0.08025230434268289,258961,105081,
0,0.0,0,0,0,0,128664,8190,492706,0.0,153880,552,0.09502848749426634,8798,2319,784,897,4000,17540,0.01938949306265632,-608,0,1535,0,0.27382900007713235,0,5695,0,1874,3409,0,10978,3821,0.08025230434268289,258961,105081,
0,0.0,0,0,0,0,128664,8190,492706,0.0,153880,552,0.09502848749426634,8798,2319,784,897,4000,17540,0.01938949306265632,-608,0,1535,0,0.27382900007713235,0,5695,0,1874,3409,0,10978,3821,0.08025230434268289,258961,105081,
0,0.0,0,0,0,0,128664,8190,492706,0.0,153880,552,0.09502848749426634,8798,2319,784,897,4000,17540,0.01938949306265632,-608,0,1535,0,0.27382900007713235,0,5695,0,1874,3409,0,10978,3821,0.08025230434268289,258961,105081,
0,0.0,0,0,0,0,128664,8190,492706,0.0,153880,552,0.09502848749426634,8798,2319,784,897,4000,17540,0.01938949306265632,-608,0,1535,0,0.27382900007713235,0,5695,0,1874,3409,0,10978,3821,0.08025230434268289,258961,105081,
0,0.0,0,0,0,0,128664,8190,492706,0.0,153880,552,0.09502848749426634,8798,2319,784,897,4000,17540,0.01938949306265632,-608,0,1535,0,0.27382900007713235,0,5695,0,1874,3409,0,10978,3821,0.08025230434268289,258961,105081,
0,0.0,0,0,0,0,128664,8190,492706,0.0,153880,552,0.09502848749426634,8798,2319,784,897,4000,17540,0.01938949306265632,-608,0,1535,0,0.27382900007713235,0,5695,0,1874,3409,0,10978,3821,0.08025230434268289,258961,105081,
0,0.0,0,0,0,0,128664,8190,492706,0.0,153880,552,0.09502848749426634,8798,2319,784,897,4000,17540,0.01938949306265632,-608,0,1535,0,0.27382900007713235,0,5695,0,1874,3409,0,10978,3821,0.08025230434268289,258961,105081,
0,0.0,0,0,0,0,128664,8190,492706,0.0,153880,552,0.09502848749426634,8798,2319,784,897,4000,17540,0.01938949306265632,-608,0,1535,0,0.27382900007713235,0,5695,0,1874,3409,0,10978,3821,0.08025230434268289,258961,105081,
0,0.0,0,0,0,0,128664,8190,492706,0.0,153880,552,0.09502848749426634,8798,2319,784,897,4000,17540,0.01938949306265632,-608,0,1535,0,0.27382900007713235,0,5695,0,1874,3409,0,10978,3821,0.08025230434268289,258961,105081,
0,0.0,0,0,0,0,128664,8190,492706,0.0,153880,552,0.09502848749426634,8798,2319,784,897,4000,17540,0.01938949306265632,-608,0,1535,0,0.27382900007713235,0,5695,0,1874,3409,0,10978,3821,0.08025230434268289,258961,105081,
0,0.0,0,0,0,0,128664,8190,492706,0.0,153880,552,0.09502848749426634,8798,2319,784,897,4000,17540,0.01938949306265632,-608,0,1535,0,0.27382900007713235,0,5695,0,1874,3409,0,10978,3821,0.08025230434268289,258961,105081,
0,0.0,0,0,0,0,128664,8190,492706,0.0,153880,552,0.09502848749426634,8798,2319,784,897,4000,17540,0.01938949306265632,-608,0,1535,0,0.27382900007713235,0,5695,0,1874,3409,0,10978,3821,0.08025230434268289,258961,105081,
0,0.0,0,0,0,0,128664,8190,492706,0.0,153880,552,0.09502848749426634,8798,2319,784,897,4000,17540,0.01938949306265632,-608,0,1535,0,0.27382900007713235,0,5695,0,1874,3409,0,10978,3821,0.08025230434268289,258961,105081,
0,0.0,0,0,0,0,128664,8190,492706,0.0,153880,552,0.09502848749426634,8798,2319,784,897,4000,17540,0.01938949306265632,-608,0,1535,0,0.27382900007713235,0,5695,0,1874,3409,0,10978,3821,0.08025230434268289,258961,105081,
0,0.0,0,0,0,0,128664,8190,492706,0.0,153880,552,0.09502848749426634,8798,2319,784,897,4000,17540,0.01938949306265632,-608,0,1535,0,0.27382900007713235,0,5695,0,1874,3409,0,10978,3821,0.08025230434268289,258961,105081,
0,0.0,0,0,0,0,128664,8190,492706,0.0,153880,552,0.09502848749426634,8798,2319,784,897,4000,17540,0.01938949306265632,-608,0,1535,0,0.27382900007713235,0,5695,0,1874,3409,0,10978,3821,0.08025230434268289,258961,105081,
0,0.0,0,0,0,0,128664,8190,492706,0.0,153880,552,0.09502848749426634,8798,2319,784,897,4000,17540,0.01938949306265632,-608,0,1535,0,0.27382900007713235,0,5695,0,1874,3409,0,10978,3821,0.08025230434268289,258961,105081,
0,0.0,0,0,0,0,128664,8190,492706,0.0,153880,552,0.09502848749426634,8798,2319,784,897,4000,17540,0.01938949306265632,-608,0,1535,0,0.27382900007713235,0,5695,0,1874,3409,0,10978,3821,0.08025230434268289,258961,105081,
0,0.0,0,0,0,0,128664,8190,492706,0.0,153880,552,0.09502848749426634,8798,2319,784,897,4000,17540,0.01938949306265632,-608,0,1535,0,0.27382900007713235,0,5695,0,1874,3409,0,10978,3821,0.08025230434268289,258961,105081,
0,0.0,0,0,0,0,128664,8190,492706,0.0,153880,552,0.09502848749426634,8798,2319,784,897,4000,17540,0.01938949306265632,-608,0,1535,0,0.27382900007713235,0,5695,0,1874,3409,0,10978,3821,0.08025230434268289,258961,105081,
0,0.0,0,0,0,0,128664,8190,492706,0.0,153880,552,0.09502848749426634,8798,2319,784,897,4000,17540,0.01938949306265632,-608,0,1535,0,0.27382900007713235,0,5695,0,1874,3409,0,10978,3821,0.08025230434268289,258961,105081,
0,0.0,0,0,0,0,128664,8190,492706,0.0,153880,552,0.09502848749426634,8798,2319,784,897,4000,17540,0.01938949306265632,-608,0,1535,0,0.27382900007713235,0,5695,0,1874,3409,0,10978,3821,0.08025230434268289,258961,105081,
0,0.0,0,0,0,0,128664,8190,492706,0.0,153880,552,0.09502848749426634,8798,2319,784,897,4000,17540,0.01938949306265632,-608,0,1535,0,0.27382900007713235,0,5695,0,1874,3409,0,10978,3821,0.08025230434268289,258961,105081,
0,0.0,0,0,0,0,128664,8190,492706,0.0,153880,552,0.09502848749426634,8798,2319,784,897,4000,17540,0.01938949306265632,-608,0,1535,0,0.27382900007713235,0,5695,0,1874,3409,0,10978,3821,0.08025230434268289,258961,105081,
0,0.0,0,0,0,0,128664,8190,492706,0.0,153880,552,0.09502848749426634,8798,2319,784,897,4000,17540,0.01938949306265632,-608,0,1535,0,0.27382900007713235,0,5695,0,1874,3409,0,10978,3821,0.08025230434268289,258961,105081,
0,0.0,0,0,0,0,128664,8190,492706,0.0,153880,552,0.09502848749426634,8798,180,110,118,408,17540,0.01938949306265632,-608,0,70,0,0.057747158159283184,0,5695,0,1874,3409,0,10978,3821,0.08025230434268289,258961,105081,
0,0.0,0,0,0,0,128664,8190,492706,0.0,153880,552,0.09502848749426634,8798,1117,382,1245,2744,17540,0.01938949306265632,-608,0,735,0,0.0852574094701376,0,5695,0,1874,3409,0,10978,3821,0.08025230434268289,258961,105081,
0,0.0,0,0,0,0,128664,8190,492706,0.0,153880,552,0.09502848749426634,8798,1117,382,1245,2744,17540,0.01938949306265632,-608,0,735,0,0.0852574094701376,0,5695,0,1874,3409,0,10978,3821,0.08025230434268289,258961,105081,
0,0.0,0,0,0,0,128664,8190,492706,0.0,153880,552,0.09502848749426634,8798,1117,382,1245,2744,17540,0.01938949306265632,-608,0,735,0,0.0852574094701376,0,5695,0,1874,3409,0,10978,3821,0.08025230434268289,258961,105081,
0,0.0,0,0,0,0,128664,8190,492706,0.0,153880,552,0.09502848749426634,8798,1117,382,1245,2744,17540,0.01938949306265632,-608,0,735,0,0.0852574094701376,0,5695,0,1874,3409,0,10978,3821,0.08025230434268289,258961,105081,
0,0.0,0,0,0,0,128664,8190,492706,0.0,153880,552,0.09502848749426634,8798,1117,382,1245,2744,17540,0.01938949306265632,-608,0,735,0,0.0852574094701376,0,5695,0,1874,3409,0,10978,3821,0.08025230434268289,258961,105081,
0,0.0,0,0,0,0,128664,8190,492706,0.0,153880,552,0.09502848749426634,8798,1117,382,1245,2744,17540,0.01938949306265632,-608,0,735,0,0.0852574094701376,0,5695,0,1874,3409,0,10978,3821,0.08025230434268289,258961,105081,
0,0.0,0,0,0,0,128664,8190,492706,0.0,153880,552,0.09502848749426634,8798,1117,382,1245,2744,17540,0.01938949306265632,-608,0,735,0,0.0852574094701376,0,5695,0,1874,3409,0,10978,3821,0.08025230434268289,258961,105081,
0,0.0,0,0,0,0,128664,8190,492706,0.0,153880,552,0.09502848749426634,8798,1117,382,1245,2744,17540,0.01938949306265632,-608,0,735,0,0.0852574094701376,0,5695,0,1874,3409,0,10978,3821,0.08025230434268289,258961,105081,
0,0.0,0,0,0,0,128664,8190,492706,0.0,153880,552,0.09502848749426634,8798,1117,382,1245,2744,17540,0.01938949306265632,-608,0,735,0,0.0852574094701376,0,5695,0,1874,3409,0,10978,3821,0.08025230434268289,258961,105081,
0,0.0,0,0,0,0,128664,8190,492706,0.0,153880,552,0.09502848749426634,8798,1117,382,1245,2744,17540,0.01938949306265632,-608,0,735,0,0.0852574094701376,0,5695,0,1874,3409,0,10978,3821,0.08025230434268289,258961,105081,
0,0.0,0,0,0,0,128664,8190,492706,0.0,153880,552,0.09502848749426634,8798,1117,382,1245,2744,17540,0.01938949306265632,-608,0,735,0,0.0852574094701376,0,5695,0,1874,3409,0,10978,3821,0.08025230434268289,258961,105081,
0,0.0,0,0,0,0,128664,8190,492706,0.0,153880,552,0.09502848749426634,8798,1117,382,1245,2744,17540,0.01938949306265632,-608,0,735,0,0.0852574094701376,0,5695,0,1874,3409,0,10978,3821,0.08025230434268289,258961,105081,
0,0.0,0,0,0,0,128664,8190,492706,0.0,153880,552,0.09502848749426634,8798,167,100,0,267,17540,0.01938949306265632,-608,0,67,0,0.029657870830895754,0,5695,0,1874,3409,0,10978,3821,0.08025230434268289,258961,105081,
0,0.0,0,0,0,0,128664,8190,492706,0.0,153880,552,0.09502848749426634,8798,213,52,3,268,17540,0.01938949306265632,-608,0,161,0,0.04660111126270373,0,5695,0,1874,3409,0,10978,3821,0.08025230434268289,258961,105081,
0,0.0,0,0,0,0,128664,8190,492706,0.0,153880,552,0.09502848749426634,8798,213,52,3,268,17540,0.01938949306265632,-608,0,161,0,0.04660111126270373,0,5695,0,1874,3409,0,10978,3821,0.08025230434268289,258961,105081,
0,0.0,0,0,0,0,128664,8190,492706,0.0,153880,552,0.09502848749426634,8798,213,52,3,268,17540,0.01938949306265632,-608,0,161,0,0.04660111126270373,0,5695,0,1874,3409,0,10978,3821,0.08025230434268289,258961,105081,
0,0.0,0,0,0,0,128664,8190,492706,0.0,153880,552,0.09502848749426634,8798,17,2,332,351,17540,0.01938949306265632,-608,0,15,0,0.004052630982822688,0,5695,0,1874,3409,0,10978,3821,0.08025230434268289,258961,105081,
0,0.0,0,0,0,0,128664,8190,492706,0.0,153880,552,0.09502848749426634,8798,17,2,332,351,17540,0.01938949306265632,-608,0,15,0,0.004052630982822688,0,5695,0,1874,3409,0,10978,3821,0.08025230434268289,258961,105081,
0,0.0,0,0,0,0,128664,8190,492706,0.0,153880,552,0.09502848749426634,8798,17,2,332,351,17540,0.01938949306265632,-608,0,15,0,0.004052630982822688,0,5695,0,1874,3409,0,10978,3821,0.08025230434268289,258961,105081,
0,0.0,0,0,0,0,128664,8190,492706,0.0,153880,552,0.09502848749426634,8798,17,2,332,351,17540,0.01938949306265632,-608,0,15,0,0.004052630982822688,0,5695,0,1874,3409,0,10978,3821,0.08025230434268289,258961,105081,
0,0.0,0,0,0,0,128664,8190,492706,0.0,153880,552,0.09502848749426634,8798,17,2,332,351,17540,0.01938949306265632,-608,0,15,0,0.004052630982822688,0,5695,0,1874,3409,0,10978,3821,0.08025230434268289,258961,105081,
0,0.0,0,0,0,0,128664,8190,492706,0.0,153880,552,0.09502848749426634,8798,17,2,332,351,17540,0.01938949306265632,-608,0,15,0,0.004052630982822688,0,5695,0,1874,3409,0,10978,3821,0.08025230434268289,258961,105081,
0,0.0,0,0,0,0,128664,8190,492706,0.0,153880,552,0.09502848749426634,8798,17,2,332,351,17540,0.01938949306265632,-608,0,15,0,0.004052630982822688,0,5695,0,1874,3409,0,10978,3821,0.08025230434268289,258961,105081,
0,0.0,0,0,0,0,128664,8190,492706,0.0,153880,552,0.09502848749426634,8798,17,2,332,351,17540,0.01938949306265632,-608,0,15,0,0.004052630982822688,0,5695,0,1874,3409,0,10978,3821,0.08025230434268289,258961,105081,
0,0.0,0,0,0,0,128664,8190,492706,0.0,153880,552,0.09502848749426634,8798,17,2,332,351,17540,0.01938949306265632,-608,0,15,0,0.004052630982822688,0,5695,0,1874,3409,0,10978,3821,0.08025230434268289,258961,105081,
0,0.0,0,0,0,0,128664,8190,492706,0.0,153880,552,0.09502848749426634,8798,17,2,332,351,17540,0.01938949306265632,-608,0,15,0,0.004052630982822688,0,5695,0,1874,3409,0,10978,3821,0.08025230434268289,258961,105081,
0,0.0,0,0,0,0,128664,8190,492706,0.0,153880,552,0.09502848749426634,8798,17,2,332,351,17540,0.01938949306265632,-608,0,15,0,0.004052630982822688,0,5695,0,1874,3409,0,10978,3821,0.08025230434268289,258961,105081,
0,0.0,0,0,0,0,128664,8190,492706,0.0,153880,552,0.09502848749426634,8798,17,2,332,351,17540,0.01938949306265632,-608,0,15,0,0.004052630982822688,0,5695,0,1874,3409,0,10978,3821,0.08025230434268289,258961,105081,
0,0.0,0,0,0,0,128664,8190,492706,0.0,153880,552,0.09502848749426634,8798,17,2,332,351,17540,0.01938949306265632,-608,0,15,0,0.004052630982822688,0,5695,0,1874,3409,0,10978,3821,0.08025230434268289,258961,105081,
0,0.0,0,0,0,0,128664,8190,492706,0.0,153880,552,0.09502848749426634,8798,17,2,332,351,17540,0.01938949306265632,-608,0,15,0,0.004052630982822688,0,5695,0,1874,3409,0,10978,3821,0.08025230434268289,258961,105081,
0,0.0,0,0,0,0,128664,8190,492706,0.0,153880,552,0.09502848749426634,8798,17,2,332,351,17540,0.01938949306265632,-608,0,15,0,0.004052630982822688,0,5695,0,1874,3409,0,10978,3821,0.08025230434268289,258961,105081,
0,0.0,0,0,0,0,128664,8190,492706,0.0,153880,552,0.09502848749426634,8798,17,2,332,351,17540,0.01938949306265632,-608,0,15,0,0.004052630982822688,0,5695,0,1874,3409,0,10978,3821,0.08025230434268289,258961,105081,
0,0.0,0,0,0,0,128664,8190,492706,0.0,153880,552,0.09502848749426634,8798,17,2,332,351,17540,0.01938949306265632,-608,0,15,0,0.004052630982822688,0,5695,0,1874,3409,0,10978,3821,0.08025230434268289,258961,105081,
0,0.0,0,0,0,0,128664,8190,492706,0.0,153880,552,0.09502848749426634,8798,17,2,332,351,17540,0.01938949306265632,-608,0,15,0,0.004052630982822688,0,5695,0,1874,3409,0,10978,3821,0.08025230434268289,258961,105081,
0,0.0,0,0,0,0,128664,8190,492706,0.0,153880,552,0.09502848749426634,8798,17,2,332,351,17540,0.01938949306265632,-608,0,15,0,0.004052630982822688,0,5695,0,1874,3409,0,10978,3821,0.08025230434268289,258961,105081,
0,0.0,0,0,0,0,128664,8190,492706,0.0,153880,552,0.09502848749426634,8798,17,2,332,351,17540,0.01938949306265632,-608,0,15,0,0.004052630982822688,0,5695,0,1874,3409,0,10978,3821,0.08025230434268289,258961,105081,
0,0.0,0,0,0,0,128664,8190,492706,0.0,153880,552,0.09502848749426634,8798,17,2,332,351,17540,0.01938949306265632,-608,0,15,0,0.004052630982822688,0,5695,0,1874,3409,0,10978,3821,0.08025230434268289,258961,105081,
0,0.0,0,0,0,0,128664,8190,492706,0.0,153880,552,0.09502848749426634,8798,13,25,117,155,17540,0.01938949306265632,-608,0,-12,0,0.0025115168540033967,0,5695,0,1874,3409,0,10978,3821,0.08025230434268289,258961,105081,
0,0.0,0,0,0,0,128664,8190,492706,0.0,153880,552,0.09502848749426634,8798,245,12,0,257,17540,0.01938949306265632,-608,0,233,0,0.3428843793986436,0,344,0,15,0,0,359,329,0.2860925558078369,258961,105081,
0,0.0,0,0,0,0,128664,8190,492706,0.0,153880,552,0.09502848749426634,8798,245,12,0,257,17540,0.01938949306265632,-608,0,233,0,0.3428843793986436,0,344,0,15,0,0,359,329,0.2860925558078369,258961,105081,
0,0.0,0,0,0,0,128664,8190,492706,0.0,153880,552,0.09502848749426634,8798,58,1,0,59,17540,0.01938949306265632,-608,0,57,0,0.16346346346346347,0,344,0,15,0,0,359,329,0.2860925558078369,258961,105081,
1,0.0,0,1,0,2,128664,8190,492706,0.002145922746781116,153880,552,0.09502848749426634,8798,66,33,1,100,17540,0.01938949306265632,-608,0,33,0,0.09503751318768629,0,549,0,106,12,0,667,443,0.11766095282831673,258961,105081,
1,0.008583690987124463,0,1,0,2,128664,8190,492706,0.002145922746781116,153880,552,0.09502848749426634,8798,418,56,9,483,17540,0.01938949306265632,-608,1,362,1,0.15845473833792606,2,549,0,106,12,0,667,443,0.11766095282831673,258961,105081,
1,0.008583690987124463,0,1,0,2,128664,8190,492706,0.002145922746781116,153880,552,0.09502848749426634,8798,418,56,9,483,17540,0.01938949306265632,-608,1,362,1,0.15845473833792606,2,549,0,106,12,0,667,443,0.11766095282831673,258961,105081,
1,0.008583690987124463,0,1,0,2,128664,8190,492706,0.002145922746781116,153880,552,0.09502848749426634,8798,418,56,9,483,17540,0.01938949306265632,-608,1,362,1,0.15845473833792606,2,549,0,106,12,0,667,443,0.11766095282831673,258961,105081,
1,0.008583690987124463,0,1,0,2,128664,8190,492706,0.002145922746781116,153880,552,0.09502848749426634,8798,418,56,9,483,17540,0.01938949306265632,-608,1,362,1,0.15845473833792606,2,549,0,106,12,0,667,443,0.11766095282831673,258961,105081,
1,0.008583690987124463,0,1,0,2,128664,8190,492706,0.002145922746781116,153880,552,0.09502848749426634,8798,418,56,9,483,17540,0.01938949306265632,-608,1,362,1,0.15845473833792606,2,549,0,106,12,0,667,443,0.11766095282831673,258961,105081,
1,0.008583690987124463,0,1,0,2,128664,8190,492706,0.002145922746781116,153880,552,0.09502848749426634,8798,418,56,9,483,17540,0.01938949306265632,-608,1,362,1,0.15845473833792606,2,549,0,106,12,0,667,443,0.11766095282831673,258961,105081,
15,0.29411764705882354,1,2,13,18,128664,8190,492706,0.07401960784313726,153880,552,0.09502848749426634,8798,309,130,24,463,17540,0.01938949306265632,-608,2,179,12,0.14983899230424907,15,1286,1,417,1437,10,3140,869,0.10682349513628907,258961,105081,
15,0.29411764705882354,1,2,13,18,128664,8190,492706,0.07401960784313726,153880,552,0.09502848749426634,8798,309,130,24,463,17540,0.01938949306265632,-608,2,179,12,0.14983899230424907,15,1286,1,417,1437,10,3140,869,0.10682349513628907,258961,105081,
15,0.29411764705882354,1,2,13,18,128664,8190,492706,0.07401960784313726,153880,552,0.09502848749426634,8798,309,130,24,463,17540,0.01938949306265632,-608,2,179,12,0.14983899230424907,15,1286,1,417,1437,10,3140,869,0.10682349513628907,258961,105081,
15,0.29411764705882354,1,2,13,18,128664,8190,492706,0.07401960784313726,153880,552,0.09502848749426634,8798,309,130,24,463,17540,0.01938949306265632,-608,2,179,12,0.14983899230424907,15,1286,1,417,1437,10,3140,869,0.10682349513628907,258961,105081,
15,0.29411764705882354,1,2,13,18,128664,8190,492706,0.07401960784313726,153880,552,0.09502848749426634,8798,309,130,24,463,17540,0.01938949306265632,-608,2,179,12,0.14983899230424907,15,1286,1,417,1437,10,3140,869,0.10682349513628907,258961,105081,
15,0.29411764705882354,1,2,13,18,128664,8190,492706,0.07401960784313726,153880,552,0.09502848749426634,8798,309,130,24,463,17540,0.01938949306265632,-608,2,179,12,0.14983899230424907,15,1286,1,417,1437,10,3140,869,0.10682349513628907,258961,105081,
15,0.29411764705882354,1,2,13,18,128664,8190,492706,0.07401960784313726,153880,552,0.09502848749426634,8798,309,130,24,463,17540,0.01938949306265632,-608,2,179,12,0.14983899230424907,15,1286,1,417,1437,10,3140,869,0.10682349513628907,258961,105081,
15,0.29411764705882354,1,2,13,18,128664,8190,492706,0.07401960784313726,153880,552,0.09502848749426634,8798,309,130,24,463,17540,0.01938949306265632,-608,2,179,12,0.14983899230424907,15,1286,1,417,1437,10,3140,869,0.10682349513628907,258961,105081,
15,0.29411764705882354,1,2,13,18,128664,8190,492706,0.07401960784313726,153880,552,0.09502848749426634,8798,309,130,24,463,17540,0.01938949306265632,-608,2,179,12,0.14983899230424907,15,1286,1,417,1437,10,3140,869,0.10682349513628907,258961,105081,
15,0.29411764705882354,1,2,13,18,128664,8190,492706,0.07401960784313726,153880,552,0.09502848749426634,8798,309,130,24,463,17540,0.01938949306265632,-608,2,179,12,0.14983899230424907,15,1286,1,417,1437,10,3140,869,0.10682349513628907,258961,105081,
15,0.29411764705882354,1,2,13,18,128664,8190,492706,0.07401960784313726,153880,552,0.09502848749426634,8798,309,130,24,463,17540,0.01938949306265632,-608,2,179,12,0.14983899230424907,15,1286,1,417,1437,10,3140,869,0.10682349513628907,258961,105081,
15,0.29411764705882354,1,2,13,18,128664,8190,492706,0.07401960784313726,153880,552,0.09502848749426634,8798,309,130,24,463,17540,0.01938949306265632,-608,2,179,12,0.14983899230424907,15,1286,1,417,1437,10,3140,869,0.10682349513628907,258961,105081,
15,0.15,1,2,13,18,128664,8190,492706,0.07401960784313726,153880,552,0.09502848749426634,8798,203,186,684,1073,17540,0.01938949306265632,-608,0,17,3,0.2164151878257862,3,1286,0,417,1437,3,3140,869,0.10682349513628907,258961,105081,
15,0.15,1,2,13,18,128664,8190,492706,0.07401960784313726,153880,552,0.09502848749426634,8798,203,186,684,1073,17540,0.01938949306265632,-608,0,17,3,0.2164151878257862,3,1286,0,417,1437,3,3140,869,0.10682349513628907,258961,105081,
29,0.0,34,14,15,77,128664,8190,492706,0.026851653877569773,153880,552,0.09502848749426634,8798,401,31,5,437,17540,0.01938949306265632,-608,0,370,0,0.14325375926055445,0,14836,0,2779,9055,0,26670,12057,0.11193686808780132,258961,105081,
29,0.0,34,14,15,77,128664,8190,492706,0.026851653877569773,153880,552,0.09502848749426634,8798,401,31,5,437,17540,0.01938949306265632,-608,0,370,0,0.14325375926055445,0,14836,0,2779,9055,0,26670,12057,0.11193686808780132,258961,105081,
29,0.0,34,14,15,77,128664,8190,492706,0.026851653877569773,153880,552,0.09502848749426634,8798,401,31,5,437,17540,0.01938949306265632,-608,0,370,0,0.14325375926055445,0,14836,0,2779,9055,0,26670,12057,0.11193686808780132,258961,105081,
29,0.0,34,14,15,77,128664,8190,492706,0.026851653877569773,153880,552,0.09502848749426634,8798,401,31,5,437,17540,0.01938949306265632,-608,0,370,0,0.14325375926055445,0,14836,0,2779,9055,0,26670,12057,0.11193686808780132,258961,105081,
29,0.25,34,14,15,77,128664,8190,492706,0.026851653877569773,153880,552,0.09502848749426634,8798,486,87,28,601,17540,0.01938949306265632,-608,2,399,5,0.15021031991627634,12,14836,5,2779,9055,3,26670,12057,0.11193686808780132,258961,105081,
29,0.25,34,14,15,77,128664,8190,492706,0.026851653877569773,153880,552,0.09502848749426634,8798,486,87,28,601,17540,0.01938949306265632,-608,2,399,5,0.15021031991627634,12,14836,5,2779,9055,3,26670,12057,0.11193686808780132,258961,105081,
29,0.25,34,14,15,77,128664,8190,492706,0.026851653877569773,153880,552,0.09502848749426634,8798,486,87,28,601,17540,0.01938949306265632,-608,2,399,5,0.15021031991627634,12,14836,5,2779,9055,3,26670,12057,0.11193686808780132,258961,105081,
29,0.25,34,14,15,77,128664,8190,492706,0.026851653877569773,153880,552,0.09502848749426634,8798,486,87,28,601,17540,0.01938949306265632,-608,2,399,5,0.15021031991627634,12,14836,5,2779,9055,3,26670,12057,0.11193686808780132,258961,105081,
29,0.25,34,14,15,77,128664,8190,492706,0.026851653877569773,153880,552,0.09502848749426634,8798,486,87,28,601,17540,0.01938949306265632,-608,2,399,5,0.15021031991627634,12,14836,5,2779,9055,3,26670,12057,0.11193686808780132,258961,105081,
29,0.25,34,14,15,77,128664,8190,492706,0.026851653877569773,153880,552,0.09502848749426634,8798,486,87,28,601,17540,0.01938949306265632,-608,2,399,5,0.15021031991627634,12,14836,5,2779,9055,3,26670,12057,0.11193686808780132,258961,105081,
29,0.25,34,14,15,77,128664,8190,492706,0.026851653877569773,153880,552,0.09502848749426634,8798,486,87,28,601,17540,0.01938949306265632,-608,2,399,5,0.15021031991627634,12,14836,5,2779,9055,3,26670,12057,0.11193686808780132,258961,105081,
29,0.25,34,14,15,77,128664,8190,492706,0.026851653877569773,153880,552,0.09502848749426634,8798,486,87,28,601,17540,0.01938949306265632,-608,2,399,5,0.15021031991627634,12,14836,5,2779,9055,3,26670,12057,0.11193686808780132,258961,105081,
29,0.25,34,14,15,77,128664,8190,492706,0.026851653877569773,153880,552,0.09502848749426634,8798,486,87,28,601,17540,0.01938949306265632,-608,2,399,5,0.15021031991627634,12,14836,5,2779,9055,3,26670,12057,0.11193686808780132,258961,105081,
29,0.3045933734939759,34,14,15,77,128664,8190,492706,0.026851653877569773,153880,552,0.09502848749426634,8798,230,20,91,341,17540,0.01938949306265632,-608,2,210,7,0.21740288841904823,38,14836,29,2779,9055,5,26670,12057,0.11193686808780132,258961,105081,
29,0.0,34,14,15,77,128664,8190,492706,0.026851653877569773,153880,552,0.09502848749426634,8798,148,7,60,215,17540,0.01938949306265632,-608,0,141,0,0.1037112349628648,0,14836,0,2779,9055,0,26670,12057,0.11193686808780132,258961,105081,
29,0.0,34,14,15,77,128664,8190,492706,0.026851653877569773,153880,552,0.09502848749426634,8798,148,7,60,215,17540,0.01938949306265632,-608,0,141,0,0.1037112349628648,0,14836,0,2779,9055,0,26670,12057,0.11193686808780132,258961,105081,
29,0.008130081300813009,34,14,15,77,128664,8190,492706,0.026851653877569773,153880,552,0.09502848749426634,8798,534,111,20,665,17540,0.01938949306265632,-608,1,423,1,0.21432873141993375,2,14836,0,2779,9055,0,26670,12057,0.11193686808780132,258961,105081,
29,0.008130081300813009,34,14,15,77,128664,8190,492706,0.026851653877569773,153880,552,0.09502848749426634,8798,534,111,20,665,17540,0.01938949306265632,-608,1,423,1,0.21432873141993375,2,14836,0,2779,9055,0,26670,12057,0.11193686808780132,258961,105081,
29,0.13333333333333333,34,14,15,77,128664,8190,492706,0.026851653877569773,153880,552,0.09502848749426634,8798,447,513,3751,4711,17540,0.01938949306265632,-608,1,-66,1,0.22977309034731205,2,14836,0,2779,9055,0,26670,12057,0.11193686808780132,258961,105081,
29,0.13333333333333333,34,14,15,77,128664,8190,492706,0.026851653877569773,153880,552,0.09502848749426634,8798,447,513,3751,4711,17540,0.01938949306265632,-608,1,-66,1,0.22977309034731205,2,14836,0,2779,9055,0,26670,12057,0.11193686808780132,258961,105081,
29,0.0,34,14,15,77,128664,8190,492706,0.026851653877569773,153880,552,0.09502848749426634,8798,451,57,34,542,17540,0.01938949306265632,-608,0,394,0,0.1834953298257443,0,14836,0,2779,9055,0,26670,12057,0.11193686808780132,258961,105081,
29,0.0,34,14,15,77,128664,8190,492706,0.026851653877569773,153880,552,0.09502848749426634,8798,451,57,34,542,17540,0.01938949306265632,-608,0,394,0,0.1834953298257443,0,14836,0,2779,9055,0,26670,12057,0.11193686808780132,258961,105081,
29,0.0,34,14,15,77,128664,8190,492706,0.026851653877569773,153880,552,0.09502848749426634,8798,130,22,0,152,17540,0.01938949306265632,-608,0,108,0,0.15701434812120627,0,14836,0,2779,9055,0,26670,12057,0.11193686808780132,258961,105081,
29,0.0,34,14,15,77,128664,8190,492706,0.026851653877569773,153880,552,0.09502848749426634,8798,709,129,108,946,17540,0.01938949306265632,-608,0,580,0,0.22851765374218874,0,14836,0,2779,9055,0,26670,12057,0.11193686808780132,258961,105081,
29,0.0,34,14,15,77,128664,8190,492706,0.026851653877569773,153880,552,0.09502848749426634,8798,709,129,108,946,17540,0.01938949306265632,-608,0,580,0,0.22851765374218874,0,14836,0,2779,9055,0,26670,12057,0.11193686808780132,258961,105081,
29,0.0,34,14,15,77,128664,8190,492706,0.026851653877569773,153880,552,0.09502848749426634,8798,709,129,108,946,17540,0.01938949306265632,-608,0,580,0,0.22851765374218874,0,14836,0,2779,9055,0,26670,12057,0.11193686808780132,258961,105081,
29,0.0,34,14,15,77,128664,8190,492706,0.026851653877569773,153880,552,0.09502848749426634,8798,1381,53,42,1476,17540,0.01938949306265632,-608,0,1328,0,0.11921184343810598,0,14836,0,2779,9055,0,26670,12057,0.11193686808780132,258961,105081,
29,0.0,34,14,15,77,128664,8190,492706,0.026851653877569773,153880,552,0.09502848749426634,8798,1381,53,42,1476,17540,0.01938949306265632,-608,0,1328,0,0.11921184343810598,0,14836,0,2779,9055,0,26670,12057,0.11193686808780132,258961,105081,
29,0.0,34,14,15,77,128664,8190,492706,0.026851653877569773,153880,552,0.09502848749426634,8798,157,132,590,879,17540,0.01938949306265632,-608,0,25,0,0.16924580325710825,0,14836,0,2779,9055,0,26670,12057,0.11193686808780132,258961,105081,
29,0.0,34,14,15,77,128664,8190,492706,0.026851653877569773,153880,552,0.09502848749426634,8798,508,120,36,664,17540,0.01938949306265632,-608,0,388,0,0.1285120112998775,0,14836,0,2779,9055,0,26670,12057,0.11193686808780132,258961,105081,
29,0.0,34,14,15,77,128664,8190,492706,0.026851653877569773,153880,552,0.09502848749426634,8798,508,120,36,664,17540,0.01938949306265632,-608,0,388,0,0.1285120112998775,0,14836,0,2779,9055,0,26670,12057,0.11193686808780132,258961,105081,
29,0.0,34,14,15,77,128664,8190,492706,0.026851653877569773,153880,552,0.09502848749426634,8798,1115,179,33,1327,17540,0.01938949306265632,-608,0,936,0,0.16515468194491875,0,14836,0,2779,9055,0,26670,12057,0.11193686808780132,258961,105081,
29,0.0,34,14,15,77,128664,8190,492706,0.026851653877569773,153880,552,0.09502848749426634,8798,1115,179,33,1327,17540,0.01938949306265632,-608,0,936,0,0.16515468194491875,0,14836,0,2779,9055,0,26670,12057,0.11193686808780132,258961,105081,
29,0.0,34,14,15,77,128664,8190,492706,0.026851653877569773,153880,552,0.09502848749426634,8798,2125,82,2,2209,17540,0.01938949306265632,-608,0,2043,0,0.07100231382344224,0,14836,0,2779,9055,0,26670,12057,0.11193686808780132,258961,105081,
29,0.0,34,14,15,77,128664,8190,492706,0.026851653877569773,153880,552,0.09502848749426634,8798,2125,82,2,2209,17540,0.01938949306265632,-608,0,2043,0,0.07100231382344224,0,14836,0,2779,9055,0,26670,12057,0.11193686808780132,258961,105081,
29,0.0,34,14,15,77,128664,8190,492706,0.026851653877569773,153880,552,0.09502848749426634,8798,2125,82,2,2209,17540,0.01938949306265632,-608,0,2043,0,0.07100231382344224,0,14836,0,2779,9055,0,26670,12057,0.11193686808780132,258961,105081,
29,0.0,34,14,15,77,128664,8190,492706,0.026851653877569773,153880,552,0.09502848749426634,8798,2125,82,2,2209,17540,0.01938949306265632,-608,0,2043,0,0.07100231382344224,0,14836,0,2779,9055,0,26670,12057,0.11193686808780132,258961,105081,
29,0.0,34,14,15,77,128664,8190,492706,0.026851653877569773,153880,552,0.09502848749426634,8798,2125,82,2,2209,17540,0.01938949306265632,-608,0,2043,0,0.07100231382344224,0,14836,0,2779,9055,0,26670,12057,0.11193686808780132,258961,105081,
29,0.0,34,14,15,77,128664,8190,492706,0.026851653877569773,153880,552,0.09502848749426634,8798,2125,82,2,2209,17540,0.01938949306265632,-608,0,2043,0,0.07100231382344224,0,14836,0,2779,9055,0,26670,12057,0.11193686808780132,258961,105081,
29,0.0,34,14,15,77,128664,8190,492706,0.026851653877569773,153880,552,0.09502848749426634,8798,2125,82,2,2209,17540,0.01938949306265632,-608,0,2043,0,0.07100231382344224,0,14836,0,2779,9055,0,26670,12057,0.11193686808780132,258961,105081,
29,0.0,34,14,15,77,128664,8190,492706,0.026851653877569773,153880,552,0.09502848749426634,8798,2125,82,2,2209,17540,0.01938949306265632,-608,0,2043,0,0.07100231382344224,0,14836,0,2779,9055,0,26670,12057,0.11193686808780132,258961,105081,
29,0.0,34,14,15,77,128664,8190,492706,0.026851653877569773,153880,552,0.09502848749426634,8798,2125,82,2,2209,17540,0.01938949306265632,-608,0,2043,0,0.07100231382344224,0,14836,0,2779,9055,0,26670,12057,0.11193686808780132,258961,105081,
29,0.0,34,14,15,77,128664,8190,492706,0.026851653877569773,153880,552,0.09502848749426634,8798,2125,82,2,2209,17540,0.01938949306265632,-608,0,2043,0,0.07100231382344224,0,14836,0,2779,9055,0,26670,12057,0.11193686808780132,258961,105081,
29,0.0,34,14,15,77,128664,8190,492706,0.026851653877569773,153880,552,0.09502848749426634,8798,69,56,564,689,17540,0.01938949306265632,-608,0,13,0,0.12423809491097217,0,14836,0,2779,9055,0,26670,12057,0.11193686808780132,258961,105081,
29,0.0,34,14,15,77,128664,8190,492706,0.026851653877569773,153880,552,0.09502848749426634,8798,69,56,564,689,17540,0.01938949306265632,-608,0,13,0,0.12423809491097217,0,14836,0,2779,9055,0,26670,12057,0.11193686808780132,258961,105081,
29,0.0,34,14,15,77,128664,8190,492706,0.026851653877569773,153880,552,0.09502848749426634,8798,1792,151,37,1980,17540,0.01938949306265632,-608,0,1641,0,0.22184247236131166,0,14836,0,2779,9055,0,26670,12057,0.11193686808780132,258961,105081,
29,0.0,34,14,15,77,128664,8190,492706,0.026851653877569773,153880,552,0.09502848749426634,8798,1792,151,37,1980,17540,0.01938949306265632,-608,0,1641,0,0.22184247236131166,0,14836,0,2779,9055,0,26670,12057,0.11193686808780132,258961,105081,
29,0.0,34,14,15,77,128664,8190,492706,0.026851653877569773,153880,552,0.09502848749426634,8798,1792,151,37,1980,17540,0.01938949306265632,-608,0,1641,0,0.22184247236131166,0,14836,0,2779,9055,0,26670,12057,0.11193686808780132,258961,105081,
29,0.0,34,14,15,77,128664,8190,492706,0.026851653877569773,153880,552,0.09502848749426634,8798,1792,151,37,1980,17540,0.01938949306265632,-608,0,1641,0,0.22184247236131166,0,14836,0,2779,9055,0,26670,12057,0.11193686808780132,258961,105081,
29,0.0,34,14,15,77,128664,8190,492706,0.026851653877569773,153880,552,0.09502848749426634,8798,1792,151,37,1980,17540,0.01938949306265632,-608,0,1641,0,0.22184247236131166,0,14836,0,2779,9055,0,26670,12057,0.11193686808780132,258961,105081,
29,0.0,34,14,15,77,128664,8190,492706,0.026851653877569773,153880,552,0.09502848749426634,8798,1792,151,37,1980,17540,0.01938949306265632,-608,0,1641,0,0.22184247236131166,0,14836,0,2779,9055,0,26670,12057,0.11193686808780132,258961,105081,
29,0.0,34,14,15,77,128664,8190,492706,0.026851653877569773,153880,552,0.09502848749426634,8798,1792,151,37,1980,17540,0.01938949306265632,-608,0,1641,0,0.22184247236131166,0,14836,0,2779,9055,0,26670,12057,0.11193686808780132,258961,105081,
29,0.0,34,14,15,77,128664,8190,492706,0.026851653877569773,153880,552,0.09502848749426634,8798,1792,151,37,1980,17540,0.01938949306265632,-608,0,1641,0,0.22184247236131166,0,14836,0,2779,9055,0,26670,12057,0.11193686808780132,258961,105081,
29,0.0,34,14,15,77,128664,8190,492706,0.026851653877569773,153880,552,0.09502848749426634,8798,1792,151,37,1980,17540,0.01938949306265632,-608,0,1641,0,0.22184247236131166,0,14836,0,2779,9055,0,26670,12057,0.11193686808780132,258961,105081,
29,0.0,34,14,15,77,128664,8190,492706,0.026851653877569773,153880,552,0.09502848749426634,8798,1792,151,37,1980,17540,0.01938949306265632,-608,0,1641,0,0.22184247236131166,0,14836,0,2779,9055,0,26670,12057,0.11193686808780132,258961,105081,
29,0.0,34,14,15,77,128664,8190,492706,0.026851653877569773,153880,552,0.09502848749426634,8798,1792,151,37,1980,17540,0.01938949306265632,-608,0,1641,0,0.22184247236131166,0,14836,0,2779,9055,0,26670,12057,0.11193686808780132,258961,105081,
29,0.0,34,14,15,77,128664,8190,492706,0.026851653877569773,153880,552,0.09502848749426634,8798,1792,151,37,1980,17540,0.01938949306265632,-608,0,1641,0,0.22184247236131166,0,14836,0,2779,9055,0,26670,12057,0.11193686808780132,258961,105081,
29,0.0,34,14,15,77,128664,8190,492706,0.026851653877569773,153880,552,0.09502848749426634,8798,1792,151,37,1980,17540,0.01938949306265632,-608,0,1641,0,0.22184247236131166,0,14836,0,2779,9055,0,26670,12057,0.11193686808780132,258961,105081,
29,0.0,34,14,15,77,128664,8190,492706,0.026851653877569773,153880,552,0.09502848749426634,8798,1792,151,37,1980,17540,0.01938949306265632,-608,0,1641,0,0.22184247236131166,0,14836,0,2779,9055,0,26670,12057,0.11193686808780132,258961,105081,
29,0.0,34,14,15,77,128664,8190,492706,0.026851653877569773,153880,552,0.09502848749426634,8798,1792,151,37,1980,17540,0.01938949306265632,-608,0,1641,0,0.22184247236131166,0,14836,0,2779,9055,0,26670,12057,0.11193686808780132,258961,105081,
29,0.0,34,14,15,77,128664,8190,492706,0.026851653877569773,153880,552,0.09502848749426634,8798,1792,151,37,1980,17540,0.01938949306265632,-608,0,1641,0,0.22184247236131166,0,14836,0,2779,9055,0,26670,12057,0.11193686808780132,258961,105081,
29,0.0,34,14,15,77,128664,8190,492706,0.026851653877569773,153880,552,0.09502848749426634,8798,1792,151,37,1980,17540,0.01938949306265632,-608,0,1641,0,0.22184247236131166,0,14836,0,2779,9055,0,26670,12057,0.11193686808780132,258961,105081,
29,0.0,34,14,15,77,128664,8190,492706,0.026851653877569773,153880,552,0.09502848749426634,8798,1792,151,37,1980,17540,0.01938949306265632,-608,0,1641,0,0.22184247236131166,0,14836,0,2779,9055,0,26670,12057,0.11193686808780132,258961,105081,
29,0.0,34,14,15,77,128664,8190,492706,0.026851653877569773,153880,552,0.09502848749426634,8798,1792,151,37,1980,17540,0.01938949306265632,-608,0,1641,0,0.22184247236131166,0,14836,0,2779,9055,0,26670,12057,0.11193686808780132,258961,105081,
29,0.0,34,14,15,77,128664,8190,492706,0.026851653877569773,153880,552,0.09502848749426634,8798,1792,151,37,1980,17540,0.01938949306265632,-608,0,1641,0,0.22184247236131166,0,14836,0,2779,9055,0,26670,12057,0.11193686808780132,258961,105081,
29,0.0,34,14,15,77,128664,8190,492706,0.026851653877569773,153880,552,0.09502848749426634,8798,160,39,6,205,17540,0.01938949306265632,-608,0,121,0,0.09756968193067289,0,14836,0,2779,9055,0,26670,12057,0.11193686808780132,258961,105081,
29,0.0,34,14,15,77,128664,8190,492706,0.026851653877569773,153880,552,0.09502848749426634,8798,160,39,6,205,17540,0.01938949306265632,-608,0,121,0,0.09756968193067289,0,14836,0,2779,9055,0,26670,12057,0.11193686808780132,258961,105081,
29,0.0,34,14,15,77,128664,8190,492706,0.026851653877569773,153880,552,0.09502848749426634,8798,147,8,3,158,17540,0.01938949306265632,-608,0,139,0,0.011142218549953425,0,14836,0,2779,9055,0,26670,12057,0.11193686808780132,258961,105081,
29,0.0,34,14,15,77,128664,8190,492706,0.026851653877569773,153880,552,0.09502848749426634,8798,15,22,616,653,17540,0.01938949306265632,-608,0,-7,0,0.02594647826436528,0,14836,0,2779,9055,0,26670,12057,0.11193686808780132,258961,105081,
29,0.0,34,14,15,77,128664,8190,492706,0.026851653877569773,153880,552,0.09502848749426634,8798,15,22,616,653,17540,0.01938949306265632,-608,0,-7,0,0.02594647826436528,0,14836,0,2779,9055,0,26670,12057,0.11193686808780132,258961,105081,
29,0.24,34,14,15,77,128664,8190,492706,0.026851653877569773,153880,552,0.09502848749426634,8798,678,85,75,838,17540,0.01938949306265632,-608,4,593,2,0.15058136880022016,6,14836,0,2779,9055,-2,26670,12057,0.11193686808780132,258961,105081,
29,0.24,34,14,15,77,128664,8190,492706,0.026851653877569773,153880,552,0.09502848749426634,8798,678,85,75,838,17540,0.01938949306265632,-608,4,593,2,0.15058136880022016,6,14836,0,2779,9055,-2,26670,12057,0.11193686808780132,258961,105081,
29,0.24,34,14,15,77,128664,8190,492706,0.026851653877569773,153880,552,0.09502848749426634,8798,678,85,75,838,17540,0.01938949306265632,-608,4,593,2,0.15058136880022016,6,14836,0,2779,9055,-2,26670,12057,0.11193686808780132,258961,105081,
29,0.24,34,14,15,77,128664,8190,492706,0.026851653877569773,153880,552,0.09502848749426634,8798,678,85,75,838,17540,0.01938949306265632,-608,4,593,2,0.15058136880022016,6,14836,0,2779,9055,-2,26670,12057,0.11193686808780132,258961,105081,
29,0.24,34,14,15,77,128664,8190,492706,0.026851653877569773,153880,552,0.09502848749426634,8798,678,85,75,838,17540,0.01938949306265632,-608,4,593,2,0.15058136880022016,6,14836,0,2779,9055,-2,26670,12057,0.11193686808780132,258961,105081,
29,0.24,34,14,15,77,128664,8190,492706,0.026851653877569773,153880,552,0.09502848749426634,8798,678,85,75,838,17540,0.01938949306265632,-608,4,593,2,0.15058136880022016,6,14836,0,2779,9055,-2,26670,12057,0.11193686808780132,258961,105081,
29,0.1388888888888889,34,14,15,77,128664,8190,492706,0.026851653877569773,153880,552,0.09502848749426634,8798,220,214,45,479,17540,0.01938949306265632,-608,1,6,4,0.13378810976161784,5,14836,0,2779,9055,3,26670,12057,0.11193686808780132,258961,105081,
29,0.1388888888888889,34,14,15,77,128664,8190,492706,0.026851653877569773,153880,552,0.09502848749426634,8798,220,214,45,479,17540,0.01938949306265632,-608,1,6,4,0.13378810976161784,5,14836,0,2779,9055,3,26670,12057,0.11193686808780132,258961,105081,
29,0.0,34,14,15,77,128664,8190,492706,0.026851653877569773,153880,552,0.09502848749426634,8798,165,79,17,261,17540,0.01938949306265632,-608,0,86,0,0.14120890328250496,0,14836,0,2779,9055,0,26670,12057,0.11193686808780132,258961,105081,
29,0.0,34,14,15,77,128664,8190,492706,0.026851653877569773,153880,552,0.09502848749426634,8798,165,79,17,261,17540,0.01938949306265632,-608,0,86,0,0.14120890328250496,0,14836,0,2779,9055,0,26670,12057,0.11193686808780132,258961,105081,
29,0.0,34,14,15,77,128664,8190,492706,0.026851653877569773,153880,552,0.09502848749426634,8798,20,7,81,108,17540,0.01938949306265632,-608,0,13,0,0.06105078421563565,0,14836,0,2779,9055,0,26670,12057,0.11193686808780132,258961,105081,
29,0.08928571428571429,34,14,15,77,128664,8190,492706,0.026851653877569773,153880,552,0.09502848749426634,8798,451,211,1402,2064,17540,0.01938949306265632,-608,2,240,8,0.19984732345864298,10,14836,0,2779,9055,6,26670,12057,0.11193686808780132,258961,105081,
0,0.0,0,0,0,0,128664,8190,492706,0.0,153880,552,0.09502848749426634,8798,125,42,14,181,17540,0.01938949306265632,-608,0,83,0,0.03707829481372263,0,689,0,133,56,0,878,556,0.028728551651535417,258961,105081,
0,0.0,0,0,0,0,128664,8190,492706,0.0,153880,552,0.09502848749426634,8798,125,42,14,181,17540,0.01938949306265632,-608,0,83,0,0.03707829481372263,0,689,0,133,56,0,878,556,0.028728551651535417,258961,105081,
0,0.0,0,0,0,0,128664,8190,492706,0.0,153880,552,0.09502848749426634,8798,125,42,14,181,17540,0.01938949306265632,-608,0,83,0,0.03707829481372263,0,689,0,133,56,0,878,556,0.028728551651535417,258961,105081,
0,0.0,0,0,0,0,128664,8190,492706,0.0,153880,552,0.09502848749426634,8798,125,42,14,181,17540,0.01938949306265632,-608,0,83,0,0.03707829481372263,0,689,0,133,56,0,878,556,0.028728551651535417,258961,105081,
0,0.0,0,0,0,0,128664,8190,492706,0.0,153880,552,0.09502848749426634,8798,10,3,4,17,17540,0.01938949306265632,-608,0,7,0,0.18033033033033033,0,689,0,133,56,0,878,556,0.028728551651535417,258961,105081,
0,0.0,0,0,0,0,128664,8190,492706,0.0,153880,552,0.09502848749426634,8798,10,3,4,17,17540,0.01938949306265632,-608,0,7,0,0.18033033033033033,0,689,0,133,56,0,878,556,0.028728551651535417,258961,105081,
0,0.0,0,0,0,0,128664,8190,492706,0.0,153880,552,0.09502848749426634,8798,10,3,4,17,17540,0.01938949306265632,-608,0,7,0,0.18033033033033033,0,689,0,133,56,0,878,556,0.028728551651535417,258961,105081,
5,0.0,14,64,-59,83,128664,8190,492706,0.03412828947368421,153880,552,0.09502848749426634,8798,24,5,4,33,17540,0.01938949306265632,-608,0,19,0,0.03334507841803778,0,3118,0,370,802,0,4290,2748,0.05915317298486832,258961,105081,
5,0.0,14,64,-59,83,128664,8190,492706,0.03412828947368421,153880,552,0.09502848749426634,8798,81,3,0,84,17540,0.01938949306265632,-608,0,78,0,0.04107987644259927,0,3118,0,370,802,0,4290,2748,0.05915317298486832,258961,105081,
5,0.0,14,64,-59,83,128664,8190,492706,0.03412828947368421,153880,552,0.09502848749426634,8798,88,30,16,134,17540,0.01938949306265632,-608,0,58,0,0.11181129445094938,0,3118,0,370,802,0,4290,2748,0.05915317298486832,258961,105081,
5,0.0,14,64,-59,83,128664,8190,492706,0.03412828947368421,153880,552,0.09502848749426634,8798,88,30,16,134,17540,0.01938949306265632,-608,0,58,0,0.11181129445094938,0,3118,0,370,802,0,4290,2748,0.05915317298486832,258961,105081,
5,0.0,14,64,-59,83,128664,8190,492706,0.03412828947368421,153880,552,0.09502848749426634,8798,88,30,16,134,17540,0.01938949306265632,-608,0,58,0,0.11181129445094938,0,3118,0,370,802,0,4290,2748,0.05915317298486832,258961,105081,
5,0.0,14,64,-59,83,128664,8190,492706,0.03412828947368421,153880,552,0.09502848749426634,8798,8,7,46,61,17540,0.01938949306265632,-608,0,1,0,0.03255976244162707,0,3118,0,370,802,0,4290,2748,0.05915317298486832,258961,105081,
5,0.0,14,64,-59,83,128664,8190,492706,0.03412828947368421,153880,552,0.09502848749426634,8798,964,66,33,1063,17540,0.01938949306265632,-608,0,898,0,0.07872752102562441,0,3118,0,370,802,0,4290,2748,0.05915317298486832,258961,105081,
5,0.0,14,64,-59,83,128664,8190,492706,0.03412828947368421,153880,552,0.09502848749426634,8798,964,66,33,1063,17540,0.01938949306265632,-608,0,898,0,0.07872752102562441,0,3118,0,370,802,0,4290,2748,0.05915317298486832,258961,105081,
5,0.0,14,64,-59,83,128664,8190,492706,0.03412828947368421,153880,552,0.09502848749426634,8798,964,66,33,1063,17540,0.01938949306265632,-608,0,898,0,0.07872752102562441,0,3118,0,370,802,0,4290,2748,0.05915317298486832,258961,105081,
5,0.0,14,64,-59,83,128664,8190,492706,0.03412828947368421,153880,552,0.09502848749426634,8798,964,66,33,1063,17540,0.01938949306265632,-608,0,898,0,0.07872752102562441,0,3118,0,370,802,0,4290,2748,0.05915317298486832,258961,105081,
5,0.0,14,64,-59,83,128664,8190,492706,0.03412828947368421,153880,552,0.09502848749426634,8798,964,66,33,1063,17540,0.01938949306265632,-608,0,898,0,0.07872752102562441,0,3118,0,370,802,0,4290,2748,0.05915317298486832,258961,105081,
5,0.0,14,64,-59,83,128664,8190,492706,0.03412828947368421,153880,552,0.09502848749426634,8798,964,66,33,1063,17540,0.01938949306265632,-608,0,898,0,0.07872752102562441,0,3118,0,370,802,0,4290,2748,0.05915317298486832,258961,105081,
5,0.0,14,64,-59,83,128664,8190,492706,0.03412828947368421,153880,552,0.09502848749426634,8798,964,66,33,1063,17540,0.01938949306265632,-608,0,898,0,0.07872752102562441,0,3118,0,370,802,0,4290,2748,0.05915317298486832,258961,105081,
5,0.0,14,64,-59,83,128664,8190,492706,0.03412828947368421,153880,552,0.09502848749426634,8798,964,66,33,1063,17540,0.01938949306265632,-608,0,898,0,0.07872752102562441,0,3118,0,370,802,0,4290,2748,0.05915317298486832,258961,105081,
5,0.0,14,64,-59,83,128664,8190,492706,0.03412828947368421,153880,552,0.09502848749426634,8798,964,66,33,1063,17540,0.01938949306265632,-608,0,898,0,0.07872752102562441,0,3118,0,370,802,0,4290,2748,0.05915317298486832,258961,105081,
5,0.0,14,64,-59,83,128664,8190,492706,0.03412828947368421,153880,552,0.09502848749426634,8798,964,66,33,1063,17540,0.01938949306265632,-608,0,898,0,0.07872752102562441,0,3118,0,370,802,0,4290,2748,0.05915317298486832,258961,105081,
5,0.0,14,64,-59,83,128664,8190,492706,0.03412828947368421,153880,552,0.09502848749426634,8798,964,66,33,1063,17540,0.01938949306265632,-608,0,898,0,0.07872752102562441,0,3118,0,370,802,0,4290,2748,0.05915317298486832,258961,105081,
5,0.0,14,64,-59,83,128664,8190,492706,0.03412828947368421,153880,552,0.09502848749426634,8798,964,66,33,1063,17540,0.01938949306265632,-608,0,898,0,0.07872752102562441,0,3118,0,370,802,0,4290,2748,0.05915317298486832,258961,105081,
5,0.0,14,64,-59,83,128664,8190,492706,0.03412828947368421,153880,552,0.09502848749426634,8798,964,66,33,1063,17540,0.01938949306265632,-608,0,898,0,0.07872752102562441,0,3118,0,370,802,0,4290,2748,0.05915317298486832,258961,105081,
5,0.0,14,64,-59,83,128664,8190,492706,0.03412828947368421,153880,552,0.09502848749426634,8798,964,66,33,1063,17540,0.01938949306265632,-608,0,898,0,0.07872752102562441,0,3118,0,370,802,0,4290,2748,0.05915317298486832,258961,105081,
5,0.0,14,64,-59,83,128664,8190,492706,0.03412828947368421,153880,552,0.09502848749426634,8798,964,66,33,1063,17540,0.01938949306265632,-608,0,898,0,0.07872752102562441,0,3118,0,370,802,0,4290,2748,0.05915317298486832,258961,105081,
5,0.0,14,64,-59,83,128664,8190,492706,0.03412828947368421,153880,552,0.09502848749426634,8798,964,66,33,1063,17540,0.01938949306265632,-608,0,898,0,0.07872752102562441,0,3118,0,370,802,0,4290,2748,0.05915317298486832,258961,105081,
5,0.0,14,64,-59,83,128664,8190,492706,0.03412828947368421,153880,552,0.09502848749426634,8798,964,66,33,1063,17540,0.01938949306265632,-608,0,898,0,0.07872752102562441,0,3118,0,370,802,0,4290,2748,0.05915317298486832,258961,105081,
5,0.0,14,64,-59,83,128664,8190,492706,0.03412828947368421,153880,552,0.09502848749426634,8798,553,23,17,593,17540,0.01938949306265632,-608,0,530,0,0.07064272328340689,0,3118,0,370,802,0,4290,2748,0.05915317298486832,258961,105081,
5,0.0,14,64,-59,83,128664,8190,492706,0.03412828947368421,153880,552,0.09502848749426634,8798,820,51,49,920,17540,0.01938949306265632,-608,0,769,0,0.10331252860701032,0,3118,0,370,802,0,4290,2748,0.05915317298486832,258961,105081,
5,0.0,14,64,-59,83,128664,8190,492706,0.03412828947368421,153880,552,0.09502848749426634,8798,820,51,49,920,17540,0.01938949306265632,-608,0,769,0,0.10331252860701032,0,3118,0,370,802,0,4290,2748,0.05915317298486832,258961,105081,
5,0.0,14,64,-59,83,128664,8190,492706,0.03412828947368421,153880,552,0.09502848749426634,8798,820,51,49,920,17540,0.01938949306265632,-608,0,769,0,0.10331252860701032,0,3118,0,370,802,0,4290,2748,0.05915317298486832,258961,105081,
5,0.0,14,64,-59,83,128664,8190,492706,0.03412828947368421,153880,552,0.09502848749426634,8798,820,51,49,920,17540,0.01938949306265632,-608,0,769,0,0.10331252860701032,0,3118,0,370,802,0,4290,2748,0.05915317298486832,258961,105081,
5,0.0,14,64,-59,83,128664,8190,492706,0.03412828947368421,153880,552,0.09502848749426634,8798,820,51,49,920,17540,0.01938949306265632,-608,0,769,0,0.10331252860701032,0,3118,0,370,802,0,4290,2748,0.05915317298486832,258961,105081,
5,0.5460526315789473,14,64,-59,83,128664,8190,492706,0.03412828947368421,153880,552,0.09502848749426634,8798,179,69,21,269,17540,0.01938949306265632,-608,64,110,5,0.07832818831664956,83,3118,14,370,802,-59,4290,2748,0.05915317298486832,258961,105081,
5,0.0,14,64,-59,83,128664,8190,492706,0.03412828947368421,153880,552,0.09502848749426634,8798,60,7,0,67,17540,0.01938949306265632,-608,0,53,0,0.004919842942909651,0,3118,0,370,802,0,4290,2748,0.05915317298486832,258961,105081,
18,0.3225806451612903,0,27,-9,45,128664,8190,492706,0.09266699654858053,153880,552,0.09502848749426634,8798,322,96,14,432,17540,0.01938949306265632,-608,5,226,5,0.1294794771867903,10,922,0,347,937,0,2206,575,0.17011447049379344,258961,105081,
18,0.015503875968992248,0,27,-9,45,128664,8190,492706,0.09266699654858053,153880,552,0.09502848749426634,8798,104,152,493,749,17540,0.01938949306265632,-608,1,-48,1,0.11822949000133105,2,922,0,347,937,0,2206,575,0.17011447049379344,258961,105081,
18,0.015503875968992248,0,27,-9,45,128664,8190,492706,0.09266699654858053,153880,552,0.09502848749426634,8798,104,152,493,749,17540,0.01938949306265632,-608,1,-48,1,0.11822949000133105,2,922,0,347,937,0,2206,575,0.17011447049379344,258961,105081,
18,0.015503875968992248,0,27,-9,45,128664,8190,492706,0.09266699654858053,153880,552,0.09502848749426634,8798,104,152,493,749,17540,0.01938949306265632,-608,1,-48,1,0.11822949000133105,2,922,0,347,937,0,2206,575,0.17011447049379344,258961,105081,
18,0.015503875968992248,0,27,-9,45,128664,8190,492706,0.09266699654858053,153880,552,0.09502848749426634,8798,104,152,493,749,17540,0.01938949306265632,-608,1,-48,1,0.11822949000133105,2,922,0,347,937,0,2206,575,0.17011447049379344,258961,105081,
18,0.2923076923076923,0,27,-9,45,128664,8190,492706,0.09266699654858053,153880,552,0.09502848749426634,8798,329,43,4,376,17540,0.01938949306265632,-608,14,286,5,0.241885403610949,19,922,0,347,937,-9,2206,575,0.17011447049379344,258961,105081,
0,0.0,0,0,0,0,128664,8190,492706,0.0,153880,552,0.09502848749426634,8798,39,49,966,1054,17540,0.01938949306265632,-608,0,-10,0,0.055447612319132505,0,1767,0,442,2888,0,5097,1325,0.039122582523365174,258961,105081,
0,0.0,0,0,0,0,128664,8190,492706,0.0,153880,552,0.09502848749426634,8798,39,49,966,1054,17540,0.01938949306265632,-608,0,-10,0,0.055447612319132505,0,1767,0,442,2888,0,5097,1325,0.039122582523365174,258961,105081,
0,0.0,0,0,0,0,128664,8190,492706,0.0,153880,552,0.09502848749426634,8798,39,49,966,1054,17540,0.01938949306265632,-608,0,-10,0,0.055447612319132505,0,1767,0,442,2888,0,5097,1325,0.039122582523365174,258961,105081,
0,0.0,0,0,0,0,128664,8190,492706,0.0,153880,552,0.09502848749426634,8798,39,49,966,1054,17540,0.01938949306265632,-608,0,-10,0,0.055447612319132505,0,1767,0,442,2888,0,5097,1325,0.039122582523365174,258961,105081,
0,0.0,0,0,0,0,128664,8190,492706,0.0,153880,552,0.09502848749426634,8798,39,49,966,1054,17540,0.01938949306265632,-608,0,-10,0,0.055447612319132505,0,1767,0,442,2888,0,5097,1325,0.039122582523365174,258961,105081,
0,0.0,0,0,0,0,128664,8190,492706,0.0,153880,552,0.09502848749426634,8798,1,53,169,223,17540,0.01938949306265632,-608,0,-52,0,0.07049524638664992,0,1767,0,442,2888,0,5097,1325,0.039122582523365174,258961,105081,
15,0.0,0,5,10,20,128664,8190,492706,0.06097560975609756,153880,552,0.09502848749426634,8798,61,140,19,220,17540,0.01938949306265632,-608,0,-79,0,0.21150388300313436,0,589,0,298,304,0,1191,291,0.2535525433271984,258961,105081,
15,0.0,0,5,10,20,128664,8190,492706,0.06097560975609756,153880,552,0.09502848749426634,8798,61,140,19,220,17540,0.01938949306265632,-608,0,-79,0,0.21150388300313436,0,589,0,298,304,0,1191,291,0.2535525433271984,258961,105081,
15,0.0,0,5,10,20,128664,8190,492706,0.06097560975609756,153880,552,0.09502848749426634,8798,119,59,61,239,17540,0.01938949306265632,-608,0,60,0,0.23912250747498282,0,589,0,298,304,0,1191,291,0.2535525433271984,258961,105081,
15,0.0,0,5,10,20,128664,8190,492706,0.06097560975609756,153880,552,0.09502848749426634,8798,119,59,61,239,17540,0.01938949306265632,-608,0,60,0,0.23912250747498282,0,589,0,298,304,0,1191,291,0.2535525433271984,258961,105081,
15,0.0,0,5,10,20,128664,8190,492706,0.06097560975609756,153880,552,0.09502848749426634,8798,119,59,61,239,17540,0.01938949306265632,-608,0,60,0,0.23912250747498282,0,589,0,298,304,0,1191,291,0.2535525433271984,258961,105081,
15,0.0,0,5,10,20,128664,8190,492706,0.06097560975609756,153880,552,0.09502848749426634,8798,119,59,61,239,17540,0.01938949306265632,-608,0,60,0,0.23912250747498282,0,589,0,298,304,0,1191,291,0.2535525433271984,258961,105081,
15,0.0,0,5,10,20,128664,8190,492706,0.06097560975609756,153880,552,0.09502848749426634,8798,88,20,207,315,17540,0.01938949306265632,-608,0,68,0,0.13515020377585793,0,589,0,298,304,0,1191,291,0.2535525433271984,258961,105081,
15,0.0,0,5,10,20,128664,8190,492706,0.06097560975609756,153880,552,0.09502848749426634,8798,88,20,207,315,17540,0.01938949306265632,-608,0,68,0,0.13515020377585793,0,589,0,298,304,0,1191,291,0.2535525433271984,258961,105081,
15,0.0,0,5,10,20,128664,8190,492706,0.06097560975609756,153880,552,0.09502848749426634,8798,88,20,207,315,17540,0.01938949306265632,-608,0,68,0,0.13515020377585793,0,589,0,298,304,0,1191,291,0.2535525433271984,258961,105081,
18,0.0,0,0,18,18,128664,8190,492706,0.06818181818181818,153880,552,0.09502848749426634,8798,158,22,0,180,17540,0.01938949306265632,-608,0,136,0,0.17006281341370072,0,213,0,62,23,0,298,151,0.09105950983400467,258961,105081,
0,0.0,0,0,0,0,128664,8190,492706,0.0,153880,552,0.09502848749426634,8798,842,55,5,902,17540,0.01938949306265632,-608,0,787,0,0.148013013746052,0,2459,0,391,796,0,3646,2068,0.039942651725339784,258961,105081,
0,0.0,0,0,0,0,128664,8190,492706,0.0,153880,552,0.09502848749426634,8798,670,58,0,728,17540,0.01938949306265632,-608,0,612,0,0.05607325507049541,0,2459,0,391,796,0,3646,2068,0.039942651725339784,258961,105081,
0,0.0,0,0,0,0,128664,8190,492706,0.0,153880,552,0.09502848749426634,8798,670,58,0,728,17540,0.01938949306265632,-608,0,612,0,0.05607325507049541,0,2459,0,391,796,0,3646,2068,0.039942651725339784,258961,105081,
9,0.14874141876430205,0,3,6,12,128664,8190,492706,0.01300786332839772,153880,552,0.09502848749426634,8798,12,6,201,219,17540,0.01938949306265632,-608,2,6,8,0.03968019467529591,10,656,0,231,632,6,1519,425,0.0652358999102669,258961,105081,
9,0.14874141876430205,0,3,6,12,128664,8190,492706,0.01300786332839772,153880,552,0.09502848749426634,8798,12,6,201,219,17540,0.01938949306265632,-608,2,6,8,0.03968019467529591,10,656,0,231,632,6,1519,425,0.0652358999102669,258961,105081,
9,0.14874141876430205,0,3,6,12,128664,8190,492706,0.01300786332839772,153880,552,0.09502848749426634,8798,12,6,201,219,17540,0.01938949306265632,-608,2,6,8,0.03968019467529591,10,656,0,231,632,6,1519,425,0.0652358999102669,258961,105081,
9,0.14874141876430205,0,3,6,12,128664,8190,492706,0.01300786332839772,153880,552,0.09502848749426634,8798,12,6,201,219,17540,0.01938949306265632,-608,2,6,8,0.03968019467529591,10,656,0,231,632,6,1519,425,0.0652358999102669,258961,105081,
9,0.14874141876430205,0,3,6,12,128664,8190,492706,0.01300786332839772,153880,552,0.09502848749426634,8798,12,6,201,219,17540,0.01938949306265632,-608,2,6,8,0.03968019467529591,10,656,0,231,632,6,1519,425,0.0652358999102669,258961,105081,
9,0.14874141876430205,0,3,6,12,128664,8190,492706,0.01300786332839772,153880,552,0.09502848749426634,8798,12,6,201,219,17540,0.01938949306265632,-608,2,6,8,0.03968019467529591,10,656,0,231,632,6,1519,425,0.0652358999102669,258961,105081,
9,0.0,0,3,6,12,128664,8190,492706,0.01300786332839772,153880,552,0.09502848749426634,8798,13,7,111,131,17540,0.01938949306265632,-608,0,6,0,0.016071582898068915,0,656,0,231,632,0,1519,425,0.0652358999102669,258961,105081,
9,0.0,0,3,6,12,128664,8190,492706,0.01300786332839772,153880,552,0.09502848749426634,8798,74,29,61,164,17540,0.01938949306265632,-608,0,45,0,0.12446860792953378,0,656,0,231,632,0,1519,425,0.0652358999102669,258961,105081,
9,0.0,0,3,6,12,128664,8190,492706,0.01300786332839772,153880,552,0.09502848749426634,8798,74,29,61,164,17540,0.01938949306265632,-608,0,45,0,0.12446860792953378,0,656,0,231,632,0,1519,425,0.0652358999102669,258961,105081,
9,0.0,0,3,6,12,128664,8190,492706,0.01300786332839772,153880,552,0.09502848749426634,8798,74,29,61,164,17540,0.01938949306265632,-608,0,45,0,0.12446860792953378,0,656,0,231,632,0,1519,425,0.0652358999102669,258961,105081,
9,0.0,0,3,6,12,128664,8190,492706,0.01300786332839772,153880,552,0.09502848749426634,8798,74,29,61,164,17540,0.01938949306265632,-608,0,45,0,0.12446860792953378,0,656,0,231,632,0,1519,425,0.0652358999102669,258961,105081,
0,0.0,0,0,0,0,128664,8190,492706,0.0,153880,552,0.09502848749426634,8798,91,14,2,107,17540,0.01938949306265632,-608,0,77,0,0.05656365204319701,0,91,0,14,2,0,107,77,0.05656365204319701,258961,105081,
0,0.0,0,0,0,0,128664,8190,492706,0.0,153880,552,0.09502848749426634,8798,51,0,0,51,17540,0.01938949306265632,-608,0,51,0,0.5,0,237,0,20,13,0,270,217,0.08851873344784843,258961,105081,
0,0.0,0,0,0,0,128664,8190,492706,0.0,153880,552,0.09502848749426634,8798,489,25,6,520,17540,0.01938949306265632,-608,0,464,0,0.40402425531328195,0,519,0,43,26,0,588,476,0.22763276931244483,258961,105081,
0,0.0,0,0,0,0,128664,8190,492706,0.0,153880,552,0.09502848749426634,8798,25,12,20,57,17540,0.01938949306265632,-608,0,13,0,0.18743886743886745,0,519,0,43,26,0,588,476,0.22763276931244483,258961,105081,
0,0.0,0,0,0,0,128664,8190,492706,0.0,153880,552,0.09502848749426634,8798,48,10,0,58,17540,0.01938949306265632,-608,0,38,0,0.2959297983569828,0,4576,0,56,2,0,4634,4520,0.044484626774046306,258961,105081,
0,0.0,0,0,0,0,128664,8190,492706,0.0,153880,552,0.09502848749426634,8798,48,10,0,58,17540,0.01938949306265632,-608,0,38,0,0.2959297983569828,0,4576,0,56,2,0,4634,4520,0.044484626774046306,258961,105081,
0,0.0,0,0,0,0,128664,8190,492706,0.0,153880,552,0.09502848749426634,8798,48,10,0,58,17540,0.01938949306265632,-608,0,38,0,0.2959297983569828,0,4576,0,56,2,0,4634,4520,0.044484626774046306,258961,105081,
0,0.0,0,0,0,0,128664,8190,492706,0.0,153880,552,0.09502848749426634,8798,48,10,0,58,17540,0.01938949306265632,-608,0,38,0,0.2959297983569828,0,4576,0,56,2,0,4634,4520,0.044484626774046306,258961,105081,
0,0.0,0,0,0,0,128664,8190,492706,0.0,153880,552,0.09502848749426634,8798,0,1,0,1,17540,0.01938949306265632,-608,0,-1,0,0.013513513513513514,0,4576,0,56,2,0,4634,4520,0.044484626774046306,258961,105081,
0,0.0,0,0,0,0,128664,8190,492706,0.0,153880,552,0.09502848749426634,8798,0,1,0,1,17540,0.01938949306265632,-608,0,-1,0,0.013513513513513514,0,4576,0,56,2,0,4634,4520,0.044484626774046306,258961,105081,
0,0.0,0,0,0,0,128664,8190,492706,0.0,153880,552,0.09502848749426634,8798,894,4,0,898,17540,0.01938949306265632,-608,0,890,0,0.15151049961941676,0,4576,0,56,2,0,4634,4520,0.044484626774046306,258961,105081,
0,0.0,0,0,0,0,128664,8190,492706,0.0,153880,552,0.09502848749426634,8798,894,4,0,898,17540,0.01938949306265632,-608,0,890,0,0.15151049961941676,0,4576,0,56,2,0,4634,4520,0.044484626774046306,258961,105081,
0,0.0,0,0,0,0,128664,8190,492706,0.0,153880,552,0.09502848749426634,8798,894,4,0,898,17540,0.01938949306265632,-608,0,890,0,0.15151049961941676,0,4576,0,56,2,0,4634,4520,0.044484626774046306,258961,105081,
0,0.0,0,0,0,0,128664,8190,492706,0.0,153880,552,0.09502848749426634,8798,894,4,0,898,17540,0.01938949306265632,-608,0,890,0,0.15151049961941676,0,4576,0,56,2,0,4634,4520,0.044484626774046306,258961,105081,
0,0.0,0,0,0,0,128664,8190,492706,0.0,153880,552,0.09502848749426634,8798,894,4,0,898,17540,0.01938949306265632,-608,0,890,0,0.15151049961941676,0,4576,0,56,2,0,4634,4520,0.044484626774046306,258961,105081,
0,0.0,0,0,0,0,128664,8190,492706,0.0,153880,552,0.09502848749426634,8798,894,4,0,898,17540,0.01938949306265632,-608,0,890,0,0.15151049961941676,0,4576,0,56,2,0,4634,4520,0.044484626774046306,258961,105081,
0,0.0,0,0,0,0,128664,8190,492706,0.0,153880,552,0.09502848749426634,8798,894,4,0,898,17540,0.01938949306265632,-608,0,890,0,0.15151049961941676,0,4576,0,56,2,0,4634,4520,0.044484626774046306,258961,105081,
0,0.0,0,0,0,0,128664,8190,492706,0.0,153880,552,0.09502848749426634,8798,1055,4,0,1059,17540,0.01938949306265632,-608,0,1051,0,0.09785439227283366,0,4576,0,56,2,0,4634,4520,0.044484626774046306,258961,105081,
0,0.0,0,0,0,0,128664,8190,492706,0.0,153880,552,0.09502848749426634,8798,1055,4,0,1059,17540,0.01938949306265632,-608,0,1051,0,0.09785439227283366,0,4576,0,56,2,0,4634,4520,0.044484626774046306,258961,105081,
0,0.0,0,0,0,0,128664,8190,492706,0.0,153880,552,0.09502848749426634,8798,482,4,0,486,17540,0.01938949306265632,-608,0,478,0,0.055661078269858194,0,4576,0,56,2,0,4634,4520,0.044484626774046306,258961,105081,
0,0.0,0,0,0,0,128664,8190,492706,0.0,153880,552,0.09502848749426634,8798,482,4,0,486,17540,0.01938949306265632,-608,0,478,0,0.055661078269858194,0,4576,0,56,2,0,4634,4520,0.044484626774046306,258961,105081,
0,0.0,0,0,0,0,128664,8190,492706,0.0,153880,552,0.09502848749426634,8798,482,4,0,486,17540,0.01938949306265632,-608,0,478,0,0.055661078269858194,0,4576,0,56,2,0,4634,4520,0.044484626774046306,258961,105081,
0,0.0,0,0,0,0,128664,8190,492706,0.0,153880,552,0.09502848749426634,8798,482,4,0,486,17540,0.01938949306265632,-608,0,478,0,0.055661078269858194,0,4576,0,56,2,0,4634,4520,0.044484626774046306,258961,105081,
0,0.0,0,0,0,0,128664,8190,492706,0.0,153880,552,0.09502848749426634,8798,482,4,0,486,17540,0.01938949306265632,-608,0,478,0,0.055661078269858194,0,4576,0,56,2,0,4634,4520,0.044484626774046306,258961,105081,
0,0.0,0,0,0,0,128664,8190,492706,0.0,153880,552,0.09502848749426634,8798,482,4,0,486,17540,0.01938949306265632,-608,0,478,0,0.055661078269858194,0,4576,0,56,2,0,4634,4520,0.044484626774046306,258961,105081,
0,0.0,0,0,0,0,128664,8190,492706,0.0,153880,552,0.09502848749426634,8798,482,4,0,486,17540,0.01938949306265632,-608,0,478,0,0.055661078269858194,0,4576,0,56,2,0,4634,4520,0.044484626774046306,258961,105081,
0,0.0,0,0,0,0,128664,8190,492706,0.0,153880,552,0.09502848749426634,8798,482,4,0,486,17540,0.01938949306265632,-608,0,478,0,0.055661078269858194,0,4576,0,56,2,0,4634,4520,0.044484626774046306,258961,105081,
0,0.0,0,0,0,0,128664,8190,492706,0.0,153880,552,0.09502848749426634,8798,482,4,0,486,17540,0.01938949306265632,-608,0,478,0,0.055661078269858194,0,4576,0,56,2,0,4634,4520,0.044484626774046306,258961,105081,
0,0.0,0,0,0,0,128664,8190,492706,0.0,153880,552,0.09502848749426634,8798,482,4,0,486,17540,0.01938949306265632,-608,0,478,0,0.055661078269858194,0,4576,0,56,2,0,4634,4520,0.044484626774046306,258961,105081,
0,0.0,0,0,0,0,128664,8190,492706,0.0,153880,552,0.09502848749426634,8798,0,1,1,2,17540,0.01938949306265632,-608,0,-1,0,0.036274509803921565,0,4576,0,56,2,0,4634,4520,0.044484626774046306,258961,105081,
0,0.0,0,0,0,0,128664,8190,492706,0.0,153880,552,0.09502848749426634,8798,0,1,1,2,17540,0.01938949306265632,-608,0,-1,0,0.036274509803921565,0,4576,0,56,2,0,4634,4520,0.044484626774046306,258961,105081,
0,0.0,0,0,0,0,128664,8190,492706,0.0,153880,552,0.09502848749426634,8798,0,1,1,2,17540,0.01938949306265632,-608,0,-1,0,0.036274509803921565,0,4576,0,56,2,0,4634,4520,0.044484626774046306,258961,105081,
0,0.0,0,0,0,0,128664,8190,492706,0.0,153880,552,0.09502848749426634,8798,342,2,0,344,17540,0.01938949306265632,-608,0,340,0,0.02921935790168139,0,4576,0,56,2,0,4634,4520,0.044484626774046306,258961,105081,
0,0.0,0,0,0,0,128664,8190,492706,0.0,153880,552,0.09502848749426634,8798,342,2,0,344,17540,0.01938949306265632,-608,0,340,0,0.02921935790168139,0,4576,0,56,2,0,4634,4520,0.044484626774046306,258961,105081,
0,0.0,0,0,0,0,128664,8190,492706,0.0,153880,552,0.09502848749426634,8798,342,2,0,344,17540,0.01938949306265632,-608,0,340,0,0.02921935790168139,0,4576,0,56,2,0,4634,4520,0.044484626774046306,258961,105081,
0,0.0,0,0,0,0,128664,8190,492706,0.0,153880,552,0.09502848749426634,8798,5,6,0,11,17540,0.01938949306265632,-608,0,-1,0,0.10659385113268609,0,4576,0,56,2,0,4634,4520,0.044484626774046306,258961,105081,
0,0.0,0,0,0,0,128664,8190,492706,0.0,153880,552,0.09502848749426634,8798,0,1,0,1,17540,0.01938949306265632,-608,0,-1,0,0.004347826086956522,0,4576,0,56,2,0,4634,4520,0.044484626774046306,258961,105081,
0,0.0,0,0,0,0,128664,8190,492706,0.0,153880,552,0.09502848749426634,8798,0,1,0,1,17540,0.01938949306265632,-608,0,-1,0,0.004347826086956522,0,4576,0,56,2,0,4634,4520,0.044484626774046306,258961,105081,
0,0.0,0,0,0,0,128664,8190,492706,0.0,153880,552,0.09502848749426634,8798,0,1,0,1,17540,0.01938949306265632,-608,0,-1,0,0.004347826086956522,0,4576,0,56,2,0,4634,4520,0.044484626774046306,258961,105081,
0,0.0,0,0,0,0,128664,8190,492706,0.0,153880,552,0.09502848749426634,8798,86,0,0,86,17540,0.01938949306265632,-608,0,86,0,0.007433658916068804,0,4576,0,56,2,0,4634,4520,0.044484626774046306,258961,105081,
0,0.0,0,0,0,0,128664,8190,492706,0.0,153880,552,0.09502848749426634,8798,86,0,0,86,17540,0.01938949306265632,-608,0,86,0,0.007433658916068804,0,4576,0,56,2,0,4634,4520,0.044484626774046306,258961,105081,
0,0.0,0,0,0,0,128664,8190,492706,0.0,153880,552,0.09502848749426634,8798,86,0,0,86,17540,0.01938949306265632,-608,0,86,0,0.007433658916068804,0,4576,0,56,2,0,4634,4520,0.044484626774046306,258961,105081,
0,0.0,0,0,0,0,128664,8190,492706,0.0,153880,552,0.09502848749426634,8798,0,1,0,1,17540,0.01938949306265632,-608,0,-1,0,0.004132231404958678,0,664,0,23,0,0,687,641,0.02190264593942428,258961,105081,
0,0.0,0,0,0,0,128664,8190,492706,0.0,153880,552,0.09502848749426634,8798,0,1,0,1,17540,0.01938949306265632,-608,0,-1,0,0.004132231404958678,0,664,0,23,0,0,687,641,0.02190264593942428,258961,105081,
0,0.0,0,0,0,0,128664,8190,492706,0.0,153880,552,0.09502848749426634,8798,0,1,0,1,17540,0.01938949306265632,-608,0,-1,0,0.004132231404958678,0,664,0,23,0,0,687,641,0.02190264593942428,258961,105081,
0,0.0,0,0,0,0,128664,8190,492706,0.0,153880,552,0.09502848749426634,8798,0,1,0,1,17540,0.01938949306265632,-608,0,-1,0,0.004132231404958678,0,664,0,23,0,0,687,641,0.02190264593942428,258961,105081,
0,0.0,0,0,0,0,128664,8190,492706,0.0,153880,552,0.09502848749426634,8798,0,1,0,1,17540,0.01938949306265632,-608,0,-1,0,0.004132231404958678,0,664,0,23,0,0,687,641,0.02190264593942428,258961,105081,
0,0.0,0,0,0,0,128664,8190,492706,0.0,153880,552,0.09502848749426634,8798,0,1,0,1,17540,0.01938949306265632,-608,0,-1,0,0.004132231404958678,0,664,0,23,0,0,687,641,0.02190264593942428,258961,105081,
0,0.0,0,0,0,0,128664,8190,492706,0.0,153880,552,0.09502848749426634,8798,474,21,0,495,17540,0.01938949306265632,-608,0,453,0,0.0867111281176747,0,664,0,23,0,0,687,641,0.02190264593942428,258961,105081,
0,0.0,0,0,0,0,128664,8190,492706,0.0,153880,552,0.09502848749426634,8798,474,21,0,495,17540,0.01938949306265632,-608,0,453,0,0.0867111281176747,0,664,0,23,0,0,687,641,0.02190264593942428,258961,105081,
0,0.0,0,0,0,0,128664,8190,492706,0.0,153880,552,0.09502848749426634,8798,474,21,0,495,17540,0.01938949306265632,-608,0,453,0,0.0867111281176747,0,664,0,23,0,0,687,641,0.02190264593942428,258961,105081,
0,0.0,0,0,0,0,128664,8190,492706,0.0,153880,552,0.09502848749426634,8798,474,21,0,495,17540,0.01938949306265632,-608,0,453,0,0.0867111281176747,0,664,0,23,0,0,687,641,0.02190264593942428,258961,105081,
0,0.0,0,0,0,0,128664,8190,492706,0.0,153880,552,0.09502848749426634,8798,474,21,0,495,17540,0.01938949306265632,-608,0,453,0,0.0867111281176747,0,664,0,23,0,0,687,641,0.02190264593942428,258961,105081,
0,0.0,0,0,0,0,128664,8190,492706,0.0,153880,552,0.09502848749426634,8798,474,21,0,495,17540,0.01938949306265632,-608,0,453,0,0.0867111281176747,0,664,0,23,0,0,687,641,0.02190264593942428,258961,105081,
0,0.0,0,0,0,0,128664,8190,492706,0.0,153880,552,0.09502848749426634,8798,474,21,0,495,17540,0.01938949306265632,-608,0,453,0,0.0867111281176747,0,664,0,23,0,0,687,641,0.02190264593942428,258961,105081,
0,0.0,0,0,0,0,128664,8190,492706,0.0,153880,552,0.09502848749426634,8798,474,21,0,495,17540,0.01938949306265632,-608,0,453,0,0.0867111281176747,0,664,0,23,0,0,687,641,0.02190264593942428,258961,105081,
0,0.0,0,0,0,0,128664,8190,492706,0.0,153880,552,0.09502848749426634,8798,317,2,0,319,17540,0.01938949306265632,-608,0,315,0,0.0177521781457668,0,1556,0,26,0,0,1582,1530,0.020436826836138088,258961,105081,
0,0.0,0,0,0,0,128664,8190,492706,0.0,153880,552,0.09502848749426634,8798,317,2,0,319,17540,0.01938949306265632,-608,0,315,0,0.0177521781457668,0,1556,0,26,0,0,1582,1530,0.020436826836138088,258961,105081,
0,0.0,0,0,0,0,128664,8190,492706,0.0,153880,552,0.09502848749426634,8798,916,1,0,917,17540,0.01938949306265632,-608,0,915,0,0.09774682971014492,0,1556,0,26,0,0,1582,1530,0.020436826836138088,258961,105081,
0,0.0,0,0,0,0,128664,8190,492706,0.0,153880,552,0.09502848749426634,8798,0,1,0,1,17540,0.01938949306265632,-608,0,-1,0,0.0033112582781456954,0,1556,0,26,0,0,1582,1530,0.020436826836138088,258961,105081,
0,0.0,0,0,0,0,128664,8190,492706,0.0,153880,552,0.09502848749426634,8798,313,4,0,317,17540,0.01938949306265632,-608,0,309,0,0.02137984381906586,0,1556,0,26,0,0,1582,1530,0.020436826836138088,258961,105081,
0,0.0,0,0,0,0,128664,8190,492706,0.0,153880,552,0.09502848749426634,8798,313,4,0,317,17540,0.01938949306265632,-608,0,309,0,0.02137984381906586,0,1556,0,26,0,0,1582,1530,0.020436826836138088,258961,105081,
0,0.0,0,0,0,0,128664,8190,492706,0.0,153880,552,0.09502848749426634,8798,0,1,0,1,17540,0.01938949306265632,-608,0,-1,0,0.003067484662576687,0,1556,0,26,0,0,1582,1530,0.020436826836138088,258961,105081,
0,0.0,0,0,0,0,128664,8190,492706,0.0,153880,552,0.09502848749426634,8798,0,2,0,2,17540,0.01938949306265632,-608,0,-2,0,0.003898635477582846,0,166,0,21,0,0,187,145,0.008015651325491932,258961,105081,
0,0.0,0,0,0,0,128664,8190,492706,0.0,153880,552,0.09502848749426634,8798,0,2,0,2,17540,0.01938949306265632,-608,0,-2,0,0.003898635477582846,0,166,0,21,0,0,187,145,0.008015651325491932,258961,105081,
0,0.0,0,0,0,0,128664,8190,492706,0.0,153880,552,0.09502848749426634,8798,0,2,0,2,17540,0.01938949306265632,-608,0,-2,0,0.003898635477582846,0,166,0,21,0,0,187,145,0.008015651325491932,258961,105081,
0,0.0,0,0,0,0,128664,8190,492706,0.0,153880,552,0.09502848749426634,8798,0,2,0,2,17540,0.01938949306265632,-608,0,-2,0,0.003898635477582846,0,166,0,21,0,0,187,145,0.008015651325491932,258961,105081,
0,0.0,0,0,0,0,128664,8190,492706,0.0,153880,552,0.09502848749426634,8798,0,2,0,2,17540,0.01938949306265632,-608,0,-2,0,0.003898635477582846,0,166,0,21,0,0,187,145,0.008015651325491932,258961,105081,
9,0.0,1,4,5,14,128664,8190,492706,0.01786663628768892,153880,552,0.09502848749426634,8798,211,4,0,215,17540,0.01938949306265632,-608,0,207,0,0.07761234376139742,0,2001,0,202,7,0,2210,1799,0.0603343001398117,258961,105081,
9,0.3,1,4,5,14,128664,8190,492706,0.01786663628768892,153880,552,0.09502848749426634,8798,5,5,1,11,17540,0.01938949306265632,-608,3,0,5,0.15158730158730158,9,2001,1,202,7,2,2210,1799,0.0603343001398117,258961,105081,
9,0.3,1,4,5,14,128664,8190,492706,0.01786663628768892,153880,552,0.09502848749426634,8798,5,5,1,11,17540,0.01938949306265632,-608,3,0,5,0.15158730158730158,9,2001,1,202,7,2,2210,1799,0.0603343001398117,258961,105081,
9,0.3,1,4,5,14,128664,8190,492706,0.01786663628768892,153880,552,0.09502848749426634,8798,5,5,1,11,17540,0.01938949306265632,-608,3,0,5,0.15158730158730158,9,2001,1,202,7,2,2210,1799,0.0603343001398117,258961,105081,
9,0.0,1,4,5,14,128664,8190,492706,0.01786663628768892,153880,552,0.09502848749426634,8798,28,25,2,55,17540,0.01938949306265632,-608,0,3,0,0.08678082593276472,0,2001,0,202,7,0,2210,1799,0.0603343001398117,258961,105081,
9,0.0,1,4,5,14,128664,8190,492706,0.01786663628768892,153880,552,0.09502848749426634,8798,28,25,2,55,17540,0.01938949306265632,-608,0,3,0,0.08678082593276472,0,2001,0,202,7,0,2210,1799,0.0603343001398117,258961,105081,
9,0.0,1,4,5,14,128664,8190,492706,0.01786663628768892,153880,552,0.09502848749426634,8798,28,25,2,55,17540,0.01938949306265632,-608,0,3,0,0.08678082593276472,0,2001,0,202,7,0,2210,1799,0.0603343001398117,258961,105081,
9,0.0,1,4,5,14,128664,8190,492706,0.01786663628768892,153880,552,0.09502848749426634,8798,28,25,2,55,17540,0.01938949306265632,-608,0,3,0,0.08678082593276472,0,2001,0,202,7,0,2210,1799,0.0603343001398117,258961,105081,
9,0.0,1,4,5,14,128664,8190,492706,0.01786663628768892,153880,552,0.09502848749426634,8798,28,25,2,55,17540,0.01938949306265632,-608,0,3,0,0.08678082593276472,0,2001,0,202,7,0,2210,1799,0.0603343001398117,258961,105081,
9,0.0,1,4,5,14,128664,8190,492706,0.01786663628768892,153880,552,0.09502848749426634,8798,28,25,2,55,17540,0.01938949306265632,-608,0,3,0,0.08678082593276472,0,2001,0,202,7,0,2210,1799,0.0603343001398117,258961,105081,
9,0.0,1,4,5,14,128664,8190,492706,0.01786663628768892,153880,552,0.09502848749426634,8798,28,25,2,55,17540,0.01938949306265632,-608,0,3,0,0.08678082593276472,0,2001,0,202,7,0,2210,1799,0.0603343001398117,258961,105081,
9,0.0,1,4,5,14,128664,8190,492706,0.01786663628768892,153880,552,0.09502848749426634,8798,26,20,2,48,17540,0.01938949306265632,-608,0,6,0,0.05765511647532184,0,2001,0,202,7,0,2210,1799,0.0603343001398117,258961,105081,
9,0.0,1,4,5,14,128664,8190,492706,0.01786663628768892,153880,552,0.09502848749426634,8798,26,20,2,48,17540,0.01938949306265632,-608,0,6,0,0.05765511647532184,0,2001,0,202,7,0,2210,1799,0.0603343001398117,258961,105081,
9,0.007017543859649123,1,4,5,14,128664,8190,492706,0.01786663628768892,153880,552,0.09502848749426634,8798,1,3,0,4,17540,0.01938949306265632,-608,1,-2,1,0.004824561403508772,2,2001,0,202,7,0,2210,1799,0.0603343001398117,258961,105081,
9,0.007017543859649123,1,4,5,14,128664,8190,492706,0.01786663628768892,153880,552,0.09502848749426634,8798,1,3,0,4,17540,0.01938949306265632,-608,1,-2,1,0.004824561403508772,2,2001,0,202,7,0,2210,1799,0.0603343001398117,258961,105081,
0,0.0,0,0,0,0,128664,8190,492706,0.0,153880,552,0.09502848749426634,8798,182,179,1,362,17540,0.01938949306265632,-608,0,3,0,0.270172978802838,0,182,0,179,1,0,362,3,0.270172978802838,258961,105081,
0,0.0,0,0,0,0,128664,8190,492706,0.0,153880,552,0.09502848749426634,8798,182,179,1,362,17540,0.01938949306265632,-608,0,3,0,0.270172978802838,0,182,0,179,1,0,362,3,0.270172978802838,258961,105081,
3,0.0,0,3,0,6,128664,8190,492706,8.883335829090546E-4,153880,552,0.09502848749426634,8798,1033,1851,78,2962,17540,0.01938949306265632,-608,0,-818,0,0.23004296242876135,0,3993,0,8849,1013,0,13855,-4856,0.14147068643317218,258961,105081,
3,0.0,0,3,0,6,128664,8190,492706,8.883335829090546E-4,153880,552,0.09502848749426634,8798,1033,1851,78,2962,17540,0.01938949306265632,-608,0,-818,0,0.23004296242876135,0,3993,0,8849,1013,0,13855,-4856,0.14147068643317218,258961,105081,
3,0.0,0,3,0,6,128664,8190,492706,8.883335829090546E-4,153880,552,0.09502848749426634,8798,1033,1851,78,2962,17540,0.01938949306265632,-608,0,-818,0,0.23004296242876135,0,3993,0,8849,1013,0,13855,-4856,0.14147068643317218,258961,105081,
3,0.0,0,3,0,6,128664,8190,492706,8.883335829090546E-4,153880,552,0.09502848749426634,8798,1033,1851,78,2962,17540,0.01938949306265632,-608,0,-818,0,0.23004296242876135,0,3993,0,8849,1013,0,13855,-4856,0.14147068643317218,258961,105081,
3,0.0,0,3,0,6,128664,8190,492706,8.883335829090546E-4,153880,552,0.09502848749426634,8798,1033,1851,78,2962,17540,0.01938949306265632,-608,0,-818,0,0.23004296242876135,0,3993,0,8849,1013,0,13855,-4856,0.14147068643317218,258961,105081,
3,0.0,0,3,0,6,128664,8190,492706,8.883335829090546E-4,153880,552,0.09502848749426634,8798,1033,1851,78,2962,17540,0.01938949306265632,-608,0,-818,0,0.23004296242876135,0,3993,0,8849,1013,0,13855,-4856,0.14147068643317218,258961,105081,
3,0.0,0,3,0,6,128664,8190,492706,8.883335829090546E-4,153880,552,0.09502848749426634,8798,1033,1851,78,2962,17540,0.01938949306265632,-608,0,-818,0,0.23004296242876135,0,3993,0,8849,1013,0,13855,-4856,0.14147068643317218,258961,105081,
3,0.0,0,3,0,6,128664,8190,492706,8.883335829090546E-4,153880,552,0.09502848749426634,8798,1033,1851,78,2962,17540,0.01938949306265632,-608,0,-818,0,0.23004296242876135,0,3993,0,8849,1013,0,13855,-4856,0.14147068643317218,258961,105081,
3,0.0,0,3,0,6,128664,8190,492706,8.883335829090546E-4,153880,552,0.09502848749426634,8798,1033,1851,78,2962,17540,0.01938949306265632,-608,0,-818,0,0.23004296242876135,0,3993,0,8849,1013,0,13855,-4856,0.14147068643317218,258961,105081,
3,0.0,0,3,0,6,128664,8190,492706,8.883335829090546E-4,153880,552,0.09502848749426634,8798,1033,1851,78,2962,17540,0.01938949306265632,-608,0,-818,0,0.23004296242876135,0,3993,0,8849,1013,0,13855,-4856,0.14147068643317218,258961,105081,
3,0.0,0,3,0,6,128664,8190,492706,8.883335829090546E-4,153880,552,0.09502848749426634,8798,1033,1851,78,2962,17540,0.01938949306265632,-608,0,-818,0,0.23004296242876135,0,3993,0,8849,1013,0,13855,-4856,0.14147068643317218,258961,105081,
3,0.0,0,3,0,6,128664,8190,492706,8.883335829090546E-4,153880,552,0.09502848749426634,8798,130,507,11,648,17540,0.01938949306265632,-608,0,-377,0,0.1298385248154158,0,3993,0,8849,1013,0,13855,-4856,0.14147068643317218,258961,105081,
3,0.01078167115902965,0,3,0,6,128664,8190,492706,8.883335829090546E-4,153880,552,0.09502848749426634,8798,147,887,361,1395,17540,0.01938949306265632,-608,2,-740,2,0.12989363309577576,4,3993,0,8849,1013,0,13855,-4856,0.14147068643317218,258961,105081,
3,0.005208333333333333,0,3,0,6,128664,8190,492706,8.883335829090546E-4,153880,552,0.09502848749426634,8798,284,1203,9,1496,17540,0.01938949306265632,-608,1,-919,1,0.1279431998351642,2,3993,0,8849,1013,0,13855,-4856,0.14147068643317218,258961,105081,
3,0.005208333333333333,0,3,0,6,128664,8190,492706,8.883335829090546E-4,153880,552,0.09502848749426634,8798,284,1203,9,1496,17540,0.01938949306265632,-608,1,-919,1,0.1279431998351642,2,3993,0,8849,1013,0,13855,-4856,0.14147068643317218,258961,105081,
3,0.005208333333333333,0,3,0,6,128664,8190,492706,8.883335829090546E-4,153880,552,0.09502848749426634,8798,284,1203,9,1496,17540,0.01938949306265632,-608,1,-919,1,0.1279431998351642,2,3993,0,8849,1013,0,13855,-4856,0.14147068643317218,258961,105081,
3,0.005208333333333333,0,3,0,6,128664,8190,492706,8.883335829090546E-4,153880,552,0.09502848749426634,8798,284,1203,9,1496,17540,0.01938949306265632,-608,1,-919,1,0.1279431998351642,2,3993,0,8849,1013,0,13855,-4856,0.14147068643317218,258961,105081,
3,0.0,0,3,0,6,128664,8190,492706,8.883335829090546E-4,153880,552,0.09502848749426634,8798,249,476,11,736,17540,0.01938949306265632,-608,0,-227,0,0.08477537655421752,0,3993,0,8849,1013,0,13855,-4856,0.14147068643317218,258961,105081,
3,0.0,0,3,0,6,128664,8190,492706,8.883335829090546E-4,153880,552,0.09502848749426634,8798,249,476,11,736,17540,0.01938949306265632,-608,0,-227,0,0.08477537655421752,0,3993,0,8849,1013,0,13855,-4856,0.14147068643317218,258961,105081,
3,0.0,0,3,0,6,128664,8190,492706,8.883335829090546E-4,153880,552,0.09502848749426634,8798,249,476,11,736,17540,0.01938949306265632,-608,0,-227,0,0.08477537655421752,0,3993,0,8849,1013,0,13855,-4856,0.14147068643317218,258961,105081,
3,0.0,0,3,0,6,128664,8190,492706,8.883335829090546E-4,153880,552,0.09502848749426634,8798,249,476,11,736,17540,0.01938949306265632,-608,0,-227,0,0.08477537655421752,0,3993,0,8849,1013,0,13855,-4856,0.14147068643317218,258961,105081,
3,0.0,0,3,0,6,128664,8190,492706,8.883335829090546E-4,153880,552,0.09502848749426634,8798,76,245,41,362,17540,0.01938949306265632,-608,0,-169,0,0.0986525161931618,0,3993,0,8849,1013,0,13855,-4856,0.14147068643317218,258961,105081,
3,0.0,0,3,0,6,128664,8190,492706,8.883335829090546E-4,153880,552,0.09502848749426634,8798,508,483,5,996,17540,0.01938949306265632,-608,0,25,0,0.20118074364001975,0,3993,0,8849,1013,0,13855,-4856,0.14147068643317218,258961,105081,
3,0.0,0,3,0,6,128664,8190,492706,8.883335829090546E-4,153880,552,0.09502848749426634,8798,508,483,5,996,17540,0.01938949306265632,-608,0,25,0,0.20118074364001975,0,3993,0,8849,1013,0,13855,-4856,0.14147068643317218,258961,105081,
3,0.0,0,3,0,6,128664,8190,492706,8.883335829090546E-4,153880,552,0.09502848749426634,8798,508,483,5,996,17540,0.01938949306265632,-608,0,25,0,0.20118074364001975,0,3993,0,8849,1013,0,13855,-4856,0.14147068643317218,258961,105081,
3,0.0,0,3,0,6,128664,8190,492706,8.883335829090546E-4,153880,552,0.09502848749426634,8798,508,483,5,996,17540,0.01938949306265632,-608,0,25,0,0.20118074364001975,0,3993,0,8849,1013,0,13855,-4856,0.14147068643317218,258961,105081,
3,0.0,0,3,0,6,128664,8190,492706,8.883335829090546E-4,153880,552,0.09502848749426634,8798,692,1325,92,2109,17540,0.01938949306265632,-608,0,-633,0,0.13374682218911035,0,3993,0,8849,1013,0,13855,-4856,0.14147068643317218,258961,105081,
3,0.0,0,3,0,6,128664,8190,492706,8.883335829090546E-4,153880,552,0.09502848749426634,8798,692,1325,92,2109,17540,0.01938949306265632,-608,0,-633,0,0.13374682218911035,0,3993,0,8849,1013,0,13855,-4856,0.14147068643317218,258961,105081,
3,0.0,0,3,0,6,128664,8190,492706,8.883335829090546E-4,153880,552,0.09502848749426634,8798,692,1325,92,2109,17540,0.01938949306265632,-608,0,-633,0,0.13374682218911035,0,3993,0,8849,1013,0,13855,-4856,0.14147068643317218,258961,105081,
3,0.0,0,3,0,6,128664,8190,492706,8.883335829090546E-4,153880,552,0.09502848749426634,8798,692,1325,92,2109,17540,0.01938949306265632,-608,0,-633,0,0.13374682218911035,0,3993,0,8849,1013,0,13855,-4856,0.14147068643317218,258961,105081,
3,0.0,0,3,0,6,128664,8190,492706,8.883335829090546E-4,153880,552,0.09502848749426634,8798,581,864,267,1712,17540,0.01938949306265632,-608,0,-283,0,0.10841830023347498,0,3993,0,8849,1013,0,13855,-4856,0.14147068643317218,258961,105081,
3,0.0,0,3,0,6,128664,8190,492706,8.883335829090546E-4,153880,552,0.09502848749426634,8798,581,864,267,1712,17540,0.01938949306265632,-608,0,-283,0,0.10841830023347498,0,3993,0,8849,1013,0,13855,-4856,0.14147068643317218,258961,105081,
3,0.0,0,3,0,6,128664,8190,492706,8.883335829090546E-4,153880,552,0.09502848749426634,8798,581,864,267,1712,17540,0.01938949306265632,-608,0,-283,0,0.10841830023347498,0,3993,0,8849,1013,0,13855,-4856,0.14147068643317218,258961,105081,
3,0.0,0,3,0,6,128664,8190,492706,8.883335829090546E-4,153880,552,0.09502848749426634,8798,581,864,267,1712,17540,0.01938949306265632,-608,0,-283,0,0.10841830023347498,0,3993,0,8849,1013,0,13855,-4856,0.14147068643317218,258961,105081,
3,0.0,0,3,0,6,128664,8190,492706,8.883335829090546E-4,153880,552,0.09502848749426634,8798,581,864,267,1712,17540,0.01938949306265632,-608,0,-283,0,0.10841830023347498,0,3993,0,8849,1013,0,13855,-4856,0.14147068643317218,258961,105081,
3,0.0,0,3,0,6,128664,8190,492706,8.883335829090546E-4,153880,552,0.09502848749426634,8798,63,2,61,126,17540,0.01938949306265632,-608,0,61,0,0.23104331639583436,0,3993,0,8849,1013,0,13855,-4856,0.14147068643317218,258961,105081,
3,0.0,0,3,0,6,128664,8190,492706,8.883335829090546E-4,153880,552,0.09502848749426634,8798,7,30,0,37,17540,0.01938949306265632,-608,0,-23,0,0.1625874460032876,0,3993,0,8849,1013,0,13855,-4856,0.14147068643317218,258961,105081,
0,0.0,0,0,0,0,128664,8190,492706,0.0,153880,552,0.09502848749426634,8798,61,123,0,184,17540,0.01938949306265632,-608,0,-62,0,0.10046775983354087,0,902,0,2118,237,0,3257,-1216,0.09799757685557905,258961,105081,
0,0.0,0,0,0,0,128664,8190,492706,0.0,153880,552,0.09502848749426634,8798,61,123,0,184,17540,0.01938949306265632,-608,0,-62,0,0.10046775983354087,0,902,0,2118,237,0,3257,-1216,0.09799757685557905,258961,105081,
0,0.0,0,0,0,0,128664,8190,492706,0.0,153880,552,0.09502848749426634,8798,20,245,1,266,17540,0.01938949306265632,-608,0,-225,0,0.05555085510088957,0,902,0,2118,237,0,3257,-1216,0.09799757685557905,258961,105081,
0,0.0,0,0,0,0,128664,8190,492706,0.0,153880,552,0.09502848749426634,8798,79,197,0,276,17540,0.01938949306265632,-608,0,-118,0,0.059627471769205215,0,902,0,2118,237,0,3257,-1216,0.09799757685557905,258961,105081,
0,0.0,0,0,0,0,128664,8190,492706,0.0,153880,552,0.09502848749426634,8798,211,631,180,1022,17540,0.01938949306265632,-608,0,-420,0,0.10911995870419153,0,902,0,2118,237,0,3257,-1216,0.09799757685557905,258961,105081,
0,0.0,0,0,0,0,128664,8190,492706,0.0,153880,552,0.09502848749426634,8798,211,631,180,1022,17540,0.01938949306265632,-608,0,-420,0,0.10911995870419153,0,902,0,2118,237,0,3257,-1216,0.09799757685557905,258961,105081,
0,0.0,0,0,0,0,128664,8190,492706,0.0,153880,552,0.09502848749426634,8798,211,631,180,1022,17540,0.01938949306265632,-608,0,-420,0,0.10911995870419153,0,902,0,2118,237,0,3257,-1216,0.09799757685557905,258961,105081,
0,0.0,0,0,0,0,128664,8190,492706,0.0,153880,552,0.09502848749426634,8798,211,631,180,1022,17540,0.01938949306265632,-608,0,-420,0,0.10911995870419153,0,902,0,2118,237,0,3257,-1216,0.09799757685557905,258961,105081,
0,0.0,0,0,0,0,128664,8190,492706,0.0,153880,552,0.09502848749426634,8798,211,631,180,1022,17540,0.01938949306265632,-608,0,-420,0,0.10911995870419153,0,902,0,2118,237,0,3257,-1216,0.09799757685557905,258961,105081,
0,0.0,0,0,0,0,128664,8190,492706,0.0,153880,552,0.09502848749426634,8798,211,631,180,1022,17540,0.01938949306265632,-608,0,-420,0,0.10911995870419153,0,902,0,2118,237,0,3257,-1216,0.09799757685557905,258961,105081,
0,0.0,0,0,0,0,128664,8190,492706,0.0,153880,552,0.09502848749426634,8798,211,631,180,1022,17540,0.01938949306265632,-608,0,-420,0,0.10911995870419153,0,902,0,2118,237,0,3257,-1216,0.09799757685557905,258961,105081,
0,0.0,0,0,0,0,128664,8190,492706,0.0,153880,552,0.09502848749426634,8798,41,240,19,300,17540,0.01938949306265632,-608,0,-199,0,0.045783905447900806,0,902,0,2118,237,0,3257,-1216,0.09799757685557905,258961,105081,
0,0.0,0,0,0,0,128664,8190,492706,0.0,153880,552,0.09502848749426634,8798,41,240,19,300,17540,0.01938949306265632,-608,0,-199,0,0.045783905447900806,0,902,0,2118,237,0,3257,-1216,0.09799757685557905,258961,105081,
0,0.0,0,0,0,0,128664,8190,492706,0.0,153880,552,0.09502848749426634,8798,41,240,19,300,17540,0.01938949306265632,-608,0,-199,0,0.045783905447900806,0,902,0,2118,237,0,3257,-1216,0.09799757685557905,258961,105081,
0,0.0,0,0,0,0,128664,8190,492706,0.0,153880,552,0.09502848749426634,8798,86,271,19,376,17540,0.01938949306265632,-608,0,-185,0,0.09704754965141668,0,902,0,2118,237,0,3257,-1216,0.09799757685557905,258961,105081,
0,0.0,0,0,0,0,128664,8190,492706,0.0,153880,552,0.09502848749426634,8798,86,271,19,376,17540,0.01938949306265632,-608,0,-185,0,0.09704754965141668,0,902,0,2118,237,0,3257,-1216,0.09799757685557905,258961,105081,
0,0.0,0,0,0,0,128664,8190,492706,0.0,153880,552,0.09502848749426634,8798,86,271,19,376,17540,0.01938949306265632,-608,0,-185,0,0.09704754965141668,0,902,0,2118,237,0,3257,-1216,0.09799757685557905,258961,105081,
0,0.0,0,0,0,0,128664,8190,492706,0.0,153880,552,0.09502848749426634,8798,86,271,19,376,17540,0.01938949306265632,-608,0,-185,0,0.09704754965141668,0,902,0,2118,237,0,3257,-1216,0.09799757685557905,258961,105081,
0,0.0,0,0,0,0,128664,8190,492706,0.0,153880,552,0.09502848749426634,8798,86,271,19,376,17540,0.01938949306265632,-608,0,-185,0,0.09704754965141668,0,902,0,2118,237,0,3257,-1216,0.09799757685557905,258961,105081,
0,0.0,0,0,0,0,128664,8190,492706,0.0,153880,552,0.09502848749426634,8798,86,271,19,376,17540,0.01938949306265632,-608,0,-185,0,0.09704754965141668,0,902,0,2118,237,0,3257,-1216,0.09799757685557905,258961,105081,
0,0.0,0,0,0,0,128664,8190,492706,0.0,153880,552,0.09502848749426634,8798,259,254,11,524,17540,0.01938949306265632,-608,0,5,0,0.14513028083563878,0,902,0,2118,237,0,3257,-1216,0.09799757685557905,258961,105081,
0,0.0,0,0,0,0,128664,8190,492706,0.0,153880,552,0.09502848749426634,8798,259,254,11,524,17540,0.01938949306265632,-608,0,5,0,0.14513028083563878,0,902,0,2118,237,0,3257,-1216,0.09799757685557905,258961,105081,
0,0.0,0,0,0,0,128664,8190,492706,0.0,153880,552,0.09502848749426634,8798,259,254,11,524,17540,0.01938949306265632,-608,0,5,0,0.14513028083563878,0,902,0,2118,237,0,3257,-1216,0.09799757685557905,258961,105081,
0,0.0,0,0,0,0,128664,8190,492706,0.0,153880,552,0.09502848749426634,8798,259,254,11,524,17540,0.01938949306265632,-608,0,5,0,0.14513028083563878,0,902,0,2118,237,0,3257,-1216,0.09799757685557905,258961,105081,
0,0.0,0,0,0,0,128664,8190,492706,0.0,153880,552,0.09502848749426634,8798,259,254,11,524,17540,0.01938949306265632,-608,0,5,0,0.14513028083563878,0,902,0,2118,237,0,3257,-1216,0.09799757685557905,258961,105081,
0,0.0,0,0,0,0,128664,8190,492706,0.0,153880,552,0.09502848749426634,8798,46,69,7,122,17540,0.01938949306265632,-608,0,-23,0,0.0955858615490685,0,902,0,2118,237,0,3257,-1216,0.09799757685557905,258961,105081,
47,0.23044397463002114,4,18,29,69,128664,8190,492706,0.030876984044733706,153880,552,0.09502848749426634,8798,25,33,190,248,17540,0.01938949306265632,-608,16,-8,14,0.1345938224118625,34,3051,4,255,1878,-2,5184,2796,0.06474977293528786,258961,105081,
47,0.23044397463002114,4,18,29,69,128664,8190,492706,0.030876984044733706,153880,552,0.09502848749426634,8798,25,33,190,248,17540,0.01938949306265632,-608,16,-8,14,0.1345938224118625,34,3051,4,255,1878,-2,5184,2796,0.06474977293528786,258961,105081,
47,0.23044397463002114,4,18,29,69,128664,8190,492706,0.030876984044733706,153880,552,0.09502848749426634,8798,25,33,190,248,17540,0.01938949306265632,-608,16,-8,14,0.1345938224118625,34,3051,4,255,1878,-2,5184,2796,0.06474977293528786,258961,105081,
47,0.23044397463002114,4,18,29,69,128664,8190,492706,0.030876984044733706,153880,552,0.09502848749426634,8798,25,33,190,248,17540,0.01938949306265632,-608,16,-8,14,0.1345938224118625,34,3051,4,255,1878,-2,5184,2796,0.06474977293528786,258961,105081,
47,0.23044397463002114,4,18,29,69,128664,8190,492706,0.030876984044733706,153880,552,0.09502848749426634,8798,25,33,190,248,17540,0.01938949306265632,-608,16,-8,14,0.1345938224118625,34,3051,4,255,1878,-2,5184,2796,0.06474977293528786,258961,105081,
47,0.23044397463002114,4,18,29,69,128664,8190,492706,0.030876984044733706,153880,552,0.09502848749426634,8798,25,33,190,248,17540,0.01938949306265632,-608,16,-8,14,0.1345938224118625,34,3051,4,255,1878,-2,5184,2796,0.06474977293528786,258961,105081,
47,0.23044397463002114,4,18,29,69,128664,8190,492706,0.030876984044733706,153880,552,0.09502848749426634,8798,25,33,190,248,17540,0.01938949306265632,-608,16,-8,14,0.1345938224118625,34,3051,4,255,1878,-2,5184,2796,0.06474977293528786,258961,105081,
47,0.23044397463002114,4,18,29,69,128664,8190,492706,0.030876984044733706,153880,552,0.09502848749426634,8798,25,33,190,248,17540,0.01938949306265632,-608,16,-8,14,0.1345938224118625,34,3051,4,255,1878,-2,5184,2796,0.06474977293528786,258961,105081,
47,0.23044397463002114,4,18,29,69,128664,8190,492706,0.030876984044733706,153880,552,0.09502848749426634,8798,25,33,190,248,17540,0.01938949306265632,-608,16,-8,14,0.1345938224118625,34,3051,4,255,1878,-2,5184,2796,0.06474977293528786,258961,105081,
47,0.23044397463002114,4,18,29,69,128664,8190,492706,0.030876984044733706,153880,552,0.09502848749426634,8798,25,33,190,248,17540,0.01938949306265632,-608,16,-8,14,0.1345938224118625,34,3051,4,255,1878,-2,5184,2796,0.06474977293528786,258961,105081,
47,0.23044397463002114,4,18,29,69,128664,8190,492706,0.030876984044733706,153880,552,0.09502848749426634,8798,25,33,190,248,17540,0.01938949306265632,-608,16,-8,14,0.1345938224118625,34,3051,4,255,1878,-2,5184,2796,0.06474977293528786,258961,105081,
47,0.23044397463002114,4,18,29,69,128664,8190,492706,0.030876984044733706,153880,552,0.09502848749426634,8798,25,33,190,248,17540,0.01938949306265632,-608,16,-8,14,0.1345938224118625,34,3051,4,255,1878,-2,5184,2796,0.06474977293528786,258961,105081,
47,0.23044397463002114,4,18,29,69,128664,8190,492706,0.030876984044733706,153880,552,0.09502848749426634,8798,25,33,190,248,17540,0.01938949306265632,-608,16,-8,14,0.1345938224118625,34,3051,4,255,1878,-2,5184,2796,0.06474977293528786,258961,105081,
47,0.23044397463002114,4,18,29,69,128664,8190,492706,0.030876984044733706,153880,552,0.09502848749426634,8798,25,33,190,248,17540,0.01938949306265632,-608,16,-8,14,0.1345938224118625,34,3051,4,255,1878,-2,5184,2796,0.06474977293528786,258961,105081,
47,0.23044397463002114,4,18,29,69,128664,8190,492706,0.030876984044733706,153880,552,0.09502848749426634,8798,25,33,190,248,17540,0.01938949306265632,-608,16,-8,14,0.1345938224118625,34,3051,4,255,1878,-2,5184,2796,0.06474977293528786,258961,105081,
47,0.23044397463002114,4,18,29,69,128664,8190,492706,0.030876984044733706,153880,552,0.09502848749426634,8798,25,33,190,248,17540,0.01938949306265632,-608,16,-8,14,0.1345938224118625,34,3051,4,255,1878,-2,5184,2796,0.06474977293528786,258961,105081,
47,0.23044397463002114,4,18,29,69,128664,8190,492706,0.030876984044733706,153880,552,0.09502848749426634,8798,25,33,190,248,17540,0.01938949306265632,-608,16,-8,14,0.1345938224118625,34,3051,4,255,1878,-2,5184,2796,0.06474977293528786,258961,105081,
47,0.23044397463002114,4,18,29,69,128664,8190,492706,0.030876984044733706,153880,552,0.09502848749426634,8798,25,33,190,248,17540,0.01938949306265632,-608,16,-8,14,0.1345938224118625,34,3051,4,255,1878,-2,5184,2796,0.06474977293528786,258961,105081,
47,0.23044397463002114,4,18,29,69,128664,8190,492706,0.030876984044733706,153880,552,0.09502848749426634,8798,25,33,190,248,17540,0.01938949306265632,-608,16,-8,14,0.1345938224118625,34,3051,4,255,1878,-2,5184,2796,0.06474977293528786,258961,105081,
47,0.23044397463002114,4,18,29,69,128664,8190,492706,0.030876984044733706,153880,552,0.09502848749426634,8798,25,33,190,248,17540,0.01938949306265632,-608,16,-8,14,0.1345938224118625,34,3051,4,255,1878,-2,5184,2796,0.06474977293528786,258961,105081,
47,0.23044397463002114,4,18,29,69,128664,8190,492706,0.030876984044733706,153880,552,0.09502848749426634,8798,25,33,190,248,17540,0.01938949306265632,-608,16,-8,14,0.1345938224118625,34,3051,4,255,1878,-2,5184,2796,0.06474977293528786,258961,105081,
47,0.23044397463002114,4,18,29,69,128664,8190,492706,0.030876984044733706,153880,552,0.09502848749426634,8798,25,33,190,248,17540,0.01938949306265632,-608,16,-8,14,0.1345938224118625,34,3051,4,255,1878,-2,5184,2796,0.06474977293528786,258961,105081,
47,0.23044397463002114,4,18,29,69,128664,8190,492706,0.030876984044733706,153880,552,0.09502848749426634,8798,25,33,190,248,17540,0.01938949306265632,-608,16,-8,14,0.1345938224118625,34,3051,4,255,1878,-2,5184,2796,0.06474977293528786,258961,105081,
47,0.23044397463002114,4,18,29,69,128664,8190,492706,0.030876984044733706,153880,552,0.09502848749426634,8798,25,33,190,248,17540,0.01938949306265632,-608,16,-8,14,0.1345938224118625,34,3051,4,255,1878,-2,5184,2796,0.06474977293528786,258961,105081,
47,0.23044397463002114,4,18,29,69,128664,8190,492706,0.030876984044733706,153880,552,0.09502848749426634,8798,25,33,190,248,17540,0.01938949306265632,-608,16,-8,14,0.1345938224118625,34,3051,4,255,1878,-2,5184,2796,0.06474977293528786,258961,105081,
47,0.23044397463002114,4,18,29,69,128664,8190,492706,0.030876984044733706,153880,552,0.09502848749426634,8798,25,33,190,248,17540,0.01938949306265632,-608,16,-8,14,0.1345938224118625,34,3051,4,255,1878,-2,5184,2796,0.06474977293528786,258961,105081,
47,0.23044397463002114,4,18,29,69,128664,8190,492706,0.030876984044733706,153880,552,0.09502848749426634,8798,25,33,190,248,17540,0.01938949306265632,-608,16,-8,14,0.1345938224118625,34,3051,4,255,1878,-2,5184,2796,0.06474977293528786,258961,105081,
47,0.23044397463002114,4,18,29,69,128664,8190,492706,0.030876984044733706,153880,552,0.09502848749426634,8798,25,33,190,248,17540,0.01938949306265632,-608,16,-8,14,0.1345938224118625,34,3051,4,255,1878,-2,5184,2796,0.06474977293528786,258961,105081,
47,0.23044397463002114,4,18,29,69,128664,8190,492706,0.030876984044733706,153880,552,0.09502848749426634,8798,25,33,190,248,17540,0.01938949306265632,-608,16,-8,14,0.1345938224118625,34,3051,4,255,1878,-2,5184,2796,0.06474977293528786,258961,105081,
47,0.23044397463002114,4,18,29,69,128664,8190,492706,0.030876984044733706,153880,552,0.09502848749426634,8798,25,33,190,248,17540,0.01938949306265632,-608,16,-8,14,0.1345938224118625,34,3051,4,255,1878,-2,5184,2796,0.06474977293528786,258961,105081,
1259,0.17614572244342133,226,841,418,2326,128664,8190,492706,0.08853886633817586,153880,552,0.09502848749426634,8798,2043,1373,1856,5272,17540,0.01938949306265632,-608,156,670,245,0.18981966345407597,414,10372,13,6207,6886,89,23465,4165,0.1030345720538558,258961,105081,
1259,0.17614572244342133,226,841,418,2326,128664,8190,492706,0.08853886633817586,153880,552,0.09502848749426634,8798,2043,1373,1856,5272,17540,0.01938949306265632,-608,156,670,245,0.18981966345407597,414,10372,13,6207,6886,89,23465,4165,0.1030345720538558,258961,105081,
0,0.0,0,0,0,0,128664,8190,492706,0.0,153880,552,0.09502848749426634,8798,818,22,1,841,17540,0.01938949306265632,-608,0,796,0,0.31167867070719796,0,1980,0,40,58,0,2078,1940,0.16233814803906702,258961,105081,
0,0.0,0,0,0,0,128664,8190,492706,0.0,153880,552,0.09502848749426634,8798,818,22,1,841,17540,0.01938949306265632,-608,0,796,0,0.31167867070719796,0,1980,0,40,58,0,2078,1940,0.16233814803906702,258961,105081,
0,0.0,0,0,0,0,128664,8190,492706,0.0,153880,552,0.09502848749426634,8798,818,22,1,841,17540,0.01938949306265632,-608,0,796,0,0.31167867070719796,0,1980,0,40,58,0,2078,1940,0.16233814803906702,258961,105081,
0,0.0,0,0,0,0,128664,8190,492706,0.0,153880,552,0.09502848749426634,8798,818,22,1,841,17540,0.01938949306265632,-608,0,796,0,0.31167867070719796,0,1980,0,40,58,0,2078,1940,0.16233814803906702,258961,105081,
0,0.0,0,0,0,0,128664,8190,492706,0.0,153880,552,0.09502848749426634,8798,818,22,1,841,17540,0.01938949306265632,-608,0,796,0,0.31167867070719796,0,1980,0,40,58,0,2078,1940,0.16233814803906702,258961,105081,
0,0.0,0,0,0,0,128664,8190,492706,0.0,153880,552,0.09502848749426634,8798,1161,17,51,1229,17540,0.01938949306265632,-608,0,1144,0,0.17097134351365836,0,1980,0,40,58,0,2078,1940,0.16233814803906702,258961,105081,
0,0.0,0,0,0,0,128664,8190,492706,0.0,153880,552,0.09502848749426634,8798,1161,17,51,1229,17540,0.01938949306265632,-608,0,1144,0,0.17097134351365836,0,1980,0,40,58,0,2078,1940,0.16233814803906702,258961,105081,
0,0.0,0,0,0,0,128664,8190,492706,0.0,153880,552,0.09502848749426634,8798,1161,17,51,1229,17540,0.01938949306265632,-608,0,1144,0,0.17097134351365836,0,1980,0,40,58,0,2078,1940,0.16233814803906702,258961,105081,
0,0.0,0,0,0,0,128664,8190,492706,0.0,153880,552,0.09502848749426634,8798,1161,17,51,1229,17540,0.01938949306265632,-608,0,1144,0,0.17097134351365836,0,1980,0,40,58,0,2078,1940,0.16233814803906702,258961,105081,
0,0.0,0,0,0,0,128664,8190,492706,0.0,153880,552,0.09502848749426634,8798,1161,17,51,1229,17540,0.01938949306265632,-608,0,1144,0,0.17097134351365836,0,1980,0,40,58,0,2078,1940,0.16233814803906702,258961,105081,
0,0.0,0,0,0,0,128664,8190,492706,0.0,153880,552,0.09502848749426634,8798,1161,17,51,1229,17540,0.01938949306265632,-608,0,1144,0,0.17097134351365836,0,1980,0,40,58,0,2078,1940,0.16233814803906702,258961,105081,
0,0.0,0,0,0,0,128664,8190,492706,0.0,153880,552,0.09502848749426634,8798,1161,17,51,1229,17540,0.01938949306265632,-608,0,1144,0,0.17097134351365836,0,1980,0,40,58,0,2078,1940,0.16233814803906702,258961,105081,
0,0.0,0,0,0,0,128664,8190,492706,0.0,153880,552,0.09502848749426634,8798,1161,17,51,1229,17540,0.01938949306265632,-608,0,1144,0,0.17097134351365836,0,1980,0,40,58,0,2078,1940,0.16233814803906702,258961,105081,
0,0.0,0,0,0,0,128664,8190,492706,0.0,153880,552,0.09502848749426634,8798,1161,17,51,1229,17540,0.01938949306265632,-608,0,1144,0,0.17097134351365836,0,1980,0,40,58,0,2078,1940,0.16233814803906702,258961,105081,
0,0.0,0,0,0,0,128664,8190,492706,0.0,153880,552,0.09502848749426634,8798,1161,17,51,1229,17540,0.01938949306265632,-608,0,1144,0,0.17097134351365836,0,1980,0,40,58,0,2078,1940,0.16233814803906702,258961,105081,
0,0.0,0,0,0,0,128664,8190,492706,0.0,153880,552,0.09502848749426634,8798,1161,17,51,1229,17540,0.01938949306265632,-608,0,1144,0,0.17097134351365836,0,1980,0,40,58,0,2078,1940,0.16233814803906702,258961,105081,
0,0.0,0,0,0,0,128664,8190,492706,0.0,153880,552,0.09502848749426634,8798,1,1,6,8,17540,0.01938949306265632,-608,0,0,0,0.00436442989634479,0,1980,0,40,58,0,2078,1940,0.16233814803906702,258961,105081,
0,0.0,0,0,0,0,128664,8190,492706,0.0,153880,552,0.09502848749426634,8798,159,15,0,174,17540,0.01938949306265632,-608,0,144,0,0.22570371622256022,0,1097,0,139,65,0,1301,958,0.08574638031880223,258961,105081,
0,0.0,0,0,0,0,128664,8190,492706,0.0,153880,552,0.09502848749426634,8798,19,8,0,27,17540,0.01938949306265632,-608,0,11,0,0.13523289097059588,0,1097,0,139,65,0,1301,958,0.08574638031880223,258961,105081,
0,0.0,0,0,0,0,128664,8190,492706,0.0,153880,552,0.09502848749426634,8798,19,8,0,27,17540,0.01938949306265632,-608,0,11,0,0.13523289097059588,0,1097,0,139,65,0,1301,958,0.08574638031880223,258961,105081,
0,0.0,0,0,0,0,128664,8190,492706,0.0,153880,552,0.09502848749426634,8798,117,4,1,122,17540,0.01938949306265632,-608,0,113,0,0.05167082811852668,0,1097,0,139,65,0,1301,958,0.08574638031880223,258961,105081,
0,0.0,0,0,0,0,128664,8190,492706,0.0,153880,552,0.09502848749426634,8798,667,79,32,778,17540,0.01938949306265632,-608,0,588,0,0.11125513466649609,0,1097,0,139,65,0,1301,958,0.08574638031880223,258961,105081,
0,0.0,0,0,0,0,128664,8190,492706,0.0,153880,552,0.09502848749426634,8798,667,79,32,778,17540,0.01938949306265632,-608,0,588,0,0.11125513466649609,0,1097,0,139,65,0,1301,958,0.08574638031880223,258961,105081,
0,0.0,0,0,0,0,128664,8190,492706,0.0,153880,552,0.09502848749426634,8798,667,79,32,778,17540,0.01938949306265632,-608,0,588,0,0.11125513466649609,0,1097,0,139,65,0,1301,958,0.08574638031880223,258961,105081,
0,0.0,0,0,0,0,128664,8190,492706,0.0,153880,552,0.09502848749426634,8798,82,13,16,111,17540,0.01938949306265632,-608,0,69,0,0.05032240440816205,0,1097,0,139,65,0,1301,958,0.08574638031880223,258961,105081,
0,0.0,0,0,0,0,128664,8190,492706,0.0,153880,552,0.09502848749426634,8798,82,13,16,111,17540,0.01938949306265632,-608,0,69,0,0.05032240440816205,0,1097,0,139,65,0,1301,958,0.08574638031880223,258961,105081,
0,0.0,0,0,0,0,128664,8190,492706,0.0,153880,552,0.09502848749426634,8798,82,13,16,111,17540,0.01938949306265632,-608,0,69,0,0.05032240440816205,0,1097,0,139,65,0,1301,958,0.08574638031880223,258961,105081,
0,0.0,0,0,0,0,128664,8190,492706,0.0,153880,552,0.09502848749426634,8798,4,8,16,28,17540,0.01938949306265632,-608,0,-4,0,0.012096978374014251,0,1097,0,139,65,0,1301,958,0.08574638031880223,258961,105081,
0,0.0,0,0,0,0,128664,8190,492706,0.0,153880,552,0.09502848749426634,8798,82,13,16,111,17540,0.01938949306265632,-608,0,69,0,0.05032240440816205,0,1097,0,139,65,0,1301,958,0.08574638031880223,258961,105081,
0,0.0,0,0,0,0,128664,8190,492706,0.0,153880,552,0.09502848749426634,8798,82,13,16,111,17540,0.01938949306265632,-608,0,69,0,0.05032240440816205,0,1097,0,139,65,0,1301,958,0.08574638031880223,258961,105081,
0,0.0,0,0,0,0,128664,8190,492706,0.0,153880,552,0.09502848749426634,8798,82,13,16,111,17540,0.01938949306265632,-608,0,69,0,0.05032240440816205,0,1097,0,139,65,0,1301,958,0.08574638031880223,258961,105081,
0,0.0,0,0,0,0,128664,8190,492706,0.0,153880,552,0.09502848749426634,8798,49,12,0,61,17540,0.01938949306265632,-608,0,37,0,0.013942709471260396,0,1097,0,139,65,0,1301,958,0.08574638031880223,258961,105081,
0,0.0,0,0,0,0,128664,8190,492706,0.0,153880,552,0.09502848749426634,8798,49,12,0,61,17540,0.01938949306265632,-608,0,37,0,0.013942709471260396,0,1097,0,139,65,0,1301,958,0.08574638031880223,258961,105081,
0,0.0,0,0,0,0,128664,8190,492706,0.0,153880,552,0.09502848749426634,8798,49,12,0,61,17540,0.01938949306265632,-608,0,37,0,0.013942709471260396,0,1097,0,139,65,0,1301,958,0.08574638031880223,258961,105081,
0,0.0,0,0,0,0,128664,8190,492706,0.0,153880,552,0.09502848749426634,8798,49,12,0,61,17540,0.01938949306265632,-608,0,37,0,0.013942709471260396,0,1097,0,139,65,0,1301,958,0.08574638031880223,258961,105081,
0,0.0,0,0,0,0,128664,8190,492706,0.0,153880,552,0.09502848749426634,8798,49,12,0,61,17540,0.01938949306265632,-608,0,37,0,0.013942709471260396,0,1097,0,139,65,0,1301,958,0.08574638031880223,258961,105081,
0,0.0,0,0,0,0,128664,8190,492706,0.0,153880,552,0.09502848749426634,8798,49,12,0,61,17540,0.01938949306265632,-608,0,37,0,0.013942709471260396,0,1097,0,139,65,0,1301,958,0.08574638031880223,258961,105081,
0,0.0,0,0,0,0,128664,8190,492706,0.0,153880,552,0.09502848749426634,8798,49,12,0,61,17540,0.01938949306265632,-608,0,37,0,0.013942709471260396,0,1097,0,139,65,0,1301,958,0.08574638031880223,258961,105081,
0,0.0,0,0,0,0,128664,8190,492706,0.0,153880,552,0.09502848749426634,8798,4,8,16,28,17540,0.01938949306265632,-608,0,-4,0,0.012096978374014251,0,1097,0,139,65,0,1301,958,0.08574638031880223,258961,105081,
0,0.0,0,0,0,0,128664,8190,492706,0.0,153880,552,0.09502848749426634,8798,126,565,890,1581,17540,0.01938949306265632,-608,0,-439,0,0.2589142551410437,0,613,0,580,895,0,2088,33,0.2181625008978411,258961,105081,
0,0.0,0,0,0,0,128664,8190,492706,0.0,153880,552,0.09502848749426634,8798,126,565,890,1581,17540,0.01938949306265632,-608,0,-439,0,0.2589142551410437,0,613,0,580,895,0,2088,33,0.2181625008978411,258961,105081,
0,0.0,0,0,0,0,128664,8190,492706,0.0,153880,552,0.09502848749426634,8798,126,565,890,1581,17540,0.01938949306265632,-608,0,-439,0,0.2589142551410437,0,613,0,580,895,0,2088,33,0.2181625008978411,258961,105081,
0,0.0,0,0,0,0,128664,8190,492706,0.0,153880,552,0.09502848749426634,8798,126,565,890,1581,17540,0.01938949306265632,-608,0,-439,0,0.2589142551410437,0,613,0,580,895,0,2088,33,0.2181625008978411,258961,105081,
0,0.0,0,0,0,0,128664,8190,492706,0.0,153880,552,0.09502848749426634,8798,126,565,890,1581,17540,0.01938949306265632,-608,0,-439,0,0.2589142551410437,0,613,0,580,895,0,2088,33,0.2181625008978411,258961,105081,
0,0.0,0,0,0,0,128664,8190,492706,0.0,153880,552,0.09502848749426634,8798,126,565,890,1581,17540,0.01938949306265632,-608,0,-439,0,0.2589142551410437,0,613,0,580,895,0,2088,33,0.2181625008978411,258961,105081,
0,0.0,0,0,0,0,128664,8190,492706,0.0,153880,552,0.09502848749426634,8798,54,933,2,989,17540,0.01938949306265632,-608,0,-879,0,0.3329362274336021,0,54,0,933,2,0,989,-879,0.16646811371680106,258961,105081,
0,0.0,0,0,0,0,128664,8190,492706,0.0,153880,552,0.09502848749426634,8798,121,71,1,193,17540,0.01938949306265632,-608,0,50,0,0.10203622087862631,0,5083,0,4581,137,0,9801,502,0.0860911972093915,258961,105081,
0,0.0,0,0,0,0,128664,8190,492706,0.0,153880,552,0.09502848749426634,8798,24,45,0,69,17540,0.01938949306265632,-608,0,-21,0,0.16325503295803742,0,5083,0,4581,137,0,9801,502,0.0860911972093915,258961,105081,
0,0.0,0,0,0,0,128664,8190,492706,0.0,153880,552,0.09502848749426634,8798,315,57,0,372,17540,0.01938949306265632,-608,0,258,0,0.053734417442644664,0,5083,0,4581,137,0,9801,502,0.0860911972093915,258961,105081,
0,0.0,0,0,0,0,128664,8190,492706,0.0,153880,552,0.09502848749426634,8798,916,174,26,1116,17540,0.01938949306265632,-608,0,742,0,0.0712350412159767,0,5083,0,4581,137,0,9801,502,0.0860911972093915,258961,105081,
0,0.0,0,0,0,0,128664,8190,492706,0.0,153880,552,0.09502848749426634,8798,916,174,26,1116,17540,0.01938949306265632,-608,0,742,0,0.0712350412159767,0,5083,0,4581,137,0,9801,502,0.0860911972093915,258961,105081,
45,0.0,1,0,45,46,128664,8190,492706,0.015870676100628932,153880,552,0.09502848749426634,8798,219,105,449,773,17540,0.01938949306265632,-608,0,114,0,0.16732978249898153,0,2886,0,1334,1291,0,5511,1552,0.15149786100139423,258961,105081,
45,0.0,1,0,45,46,128664,8190,492706,0.015870676100628932,153880,552,0.09502848749426634,8798,219,105,449,773,17540,0.01938949306265632,-608,0,114,0,0.16732978249898153,0,2886,0,1334,1291,0,5511,1552,0.15149786100139423,258961,105081,
45,0.0,1,0,45,46,128664,8190,492706,0.015870676100628932,153880,552,0.09502848749426634,8798,219,105,449,773,17540,0.01938949306265632,-608,0,114,0,0.16732978249898153,0,2886,0,1334,1291,0,5511,1552,0.15149786100139423,258961,105081,
45,0.0,1,0,45,46,128664,8190,492706,0.015870676100628932,153880,552,0.09502848749426634,8798,219,105,449,773,17540,0.01938949306265632,-608,0,114,0,0.16732978249898153,0,2886,0,1334,1291,0,5511,1552,0.15149786100139423,258961,105081,
45,0.0,1,0,45,46,128664,8190,492706,0.015870676100628932,153880,552,0.09502848749426634,8798,676,128,9,813,17540,0.01938949306265632,-608,0,548,0,0.06707002050040517,0,2886,0,1334,1291,0,5511,1552,0.15149786100139423,258961,105081,
45,0.0,1,0,45,46,128664,8190,492706,0.015870676100628932,153880,552,0.09502848749426634,8798,676,128,9,813,17540,0.01938949306265632,-608,0,548,0,0.06707002050040517,0,2886,0,1334,1291,0,5511,1552,0.15149786100139423,258961,105081,
45,0.0,1,0,45,46,128664,8190,492706,0.015870676100628932,153880,552,0.09502848749426634,8798,676,128,9,813,17540,0.01938949306265632,-608,0,548,0,0.06707002050040517,0,2886,0,1334,1291,0,5511,1552,0.15149786100139423,258961,105081,
45,0.0,1,0,45,46,128664,8190,492706,0.015870676100628932,153880,552,0.09502848749426634,8798,41,67,93,201,17540,0.01938949306265632,-608,0,-26,0,0.1744164370470659,0,2886,0,1334,1291,0,5511,1552,0.15149786100139423,258961,105081,
45,0.0,1,0,45,46,128664,8190,492706,0.015870676100628932,153880,552,0.09502848749426634,8798,52,175,414,641,17540,0.01938949306265632,-608,0,-123,0,0.07654451556977585,0,2886,0,1334,1291,0,5511,1552,0.15149786100139423,258961,105081,
45,0.0,1,0,45,46,128664,8190,492706,0.015870676100628932,153880,552,0.09502848749426634,8798,52,175,414,641,17540,0.01938949306265632,-608,0,-123,0,0.07654451556977585,0,2886,0,1334,1291,0,5511,1552,0.15149786100139423,258961,105081,
45,0.0,1,0,45,46,128664,8190,492706,0.015870676100628932,153880,552,0.09502848749426634,8798,52,175,414,641,17540,0.01938949306265632,-608,0,-123,0,0.07654451556977585,0,2886,0,1334,1291,0,5511,1552,0.15149786100139423,258961,105081,
45,0.0,1,0,45,46,128664,8190,492706,0.015870676100628932,153880,552,0.09502848749426634,8798,630,58,1,689,17540,0.01938949306265632,-608,0,572,0,0.0771895258046543,0,2886,0,1334,1291,0,5511,1552,0.15149786100139423,258961,105081,
45,0.0,1,0,45,46,128664,8190,492706,0.015870676100628932,153880,552,0.09502848749426634,8798,630,58,1,689,17540,0.01938949306265632,-608,0,572,0,0.0771895258046543,0,2886,0,1334,1291,0,5511,1552,0.15149786100139423,258961,105081,
45,0.0,1,0,45,46,128664,8190,492706,0.015870676100628932,153880,552,0.09502848749426634,8798,630,58,1,689,17540,0.01938949306265632,-608,0,572,0,0.0771895258046543,0,2886,0,1334,1291,0,5511,1552,0.15149786100139423,258961,105081,
45,0.0,1,0,45,46,128664,8190,492706,0.015870676100628932,153880,552,0.09502848749426634,8798,630,58,1,689,17540,0.01938949306265632,-608,0,572,0,0.0771895258046543,0,2886,0,1334,1291,0,5511,1552,0.15149786100139423,258961,105081,
45,0.0,1,0,45,46,128664,8190,492706,0.015870676100628932,153880,552,0.09502848749426634,8798,630,58,1,689,17540,0.01938949306265632,-608,0,572,0,0.0771895258046543,0,2886,0,1334,1291,0,5511,1552,0.15149786100139423,258961,105081,
45,0.0,1,0,45,46,128664,8190,492706,0.015870676100628932,153880,552,0.09502848749426634,8798,630,58,1,689,17540,0.01938949306265632,-608,0,572,0,0.0771895258046543,0,2886,0,1334,1291,0,5511,1552,0.15149786100139423,258961,105081,
45,0.0,1,0,45,46,128664,8190,492706,0.015870676100628932,153880,552,0.09502848749426634,8798,630,58,1,689,17540,0.01938949306265632,-608,0,572,0,0.0771895258046543,0,2886,0,1334,1291,0,5511,1552,0.15149786100139423,258961,105081,
45,0.0,1,0,45,46,128664,8190,492706,0.015870676100628932,153880,552,0.09502848749426634,8798,630,58,1,689,17540,0.01938949306265632,-608,0,572,0,0.0771895258046543,0,2886,0,1334,1291,0,5511,1552,0.15149786100139423,258961,105081,
45,0.0,1,0,45,46,128664,8190,492706,0.015870676100628932,153880,552,0.09502848749426634,8798,630,58,1,689,17540,0.01938949306265632,-608,0,572,0,0.0771895258046543,0,2886,0,1334,1291,0,5511,1552,0.15149786100139423,258961,105081,
45,0.0,1,0,45,46,128664,8190,492706,0.015870676100628932,153880,552,0.09502848749426634,8798,630,58,1,689,17540,0.01938949306265632,-608,0,572,0,0.0771895258046543,0,2886,0,1334,1291,0,5511,1552,0.15149786100139423,258961,105081,
45,0.0,1,0,45,46,128664,8190,492706,0.015870676100628932,153880,552,0.09502848749426634,8798,630,58,1,689,17540,0.01938949306265632,-608,0,572,0,0.0771895258046543,0,2886,0,1334,1291,0,5511,1552,0.15149786100139423,258961,105081,
45,0.0,1,0,45,46,128664,8190,492706,0.015870676100628932,153880,552,0.09502848749426634,8798,630,58,1,689,17540,0.01938949306265632,-608,0,572,0,0.0771895258046543,0,2886,0,1334,1291,0,5511,1552,0.15149786100139423,258961,105081,
45,0.0,1,0,45,46,128664,8190,492706,0.015870676100628932,153880,552,0.09502848749426634,8798,630,58,1,689,17540,0.01938949306265632,-608,0,572,0,0.0771895258046543,0,2886,0,1334,1291,0,5511,1552,0.15149786100139423,258961,105081,
45,0.0,1,0,45,46,128664,8190,492706,0.015870676100628932,153880,552,0.09502848749426634,8798,630,58,1,689,17540,0.01938949306265632,-608,0,572,0,0.0771895258046543,0,2886,0,1334,1291,0,5511,1552,0.15149786100139423,258961,105081,
45,0.0,1,0,45,46,128664,8190,492706,0.015870676100628932,153880,552,0.09502848749426634,8798,630,58,1,689,17540,0.01938949306265632,-608,0,572,0,0.0771895258046543,0,2886,0,1334,1291,0,5511,1552,0.15149786100139423,258961,105081,
45,0.0,1,0,45,46,128664,8190,492706,0.015870676100628932,153880,552,0.09502848749426634,8798,630,58,1,689,17540,0.01938949306265632,-608,0,572,0,0.0771895258046543,0,2886,0,1334,1291,0,5511,1552,0.15149786100139423,258961,105081,
45,0.0,1,0,45,46,128664,8190,492706,0.015870676100628932,153880,552,0.09502848749426634,8798,630,58,1,689,17540,0.01938949306265632,-608,0,572,0,0.0771895258046543,0,2886,0,1334,1291,0,5511,1552,0.15149786100139423,258961,105081,
45,0.0,1,0,45,46,128664,8190,492706,0.015870676100628932,153880,552,0.09502848749426634,8798,630,58,1,689,17540,0.01938949306265632,-608,0,572,0,0.0771895258046543,0,2886,0,1334,1291,0,5511,1552,0.15149786100139423,258961,105081,
45,0.0,1,0,45,46,128664,8190,492706,0.015870676100628932,153880,552,0.09502848749426634,8798,630,58,1,689,17540,0.01938949306265632,-608,0,572,0,0.0771895258046543,0,2886,0,1334,1291,0,5511,1552,0.15149786100139423,258961,105081,
45,0.0,1,0,45,46,128664,8190,492706,0.015870676100628932,153880,552,0.09502848749426634,8798,630,58,1,689,17540,0.01938949306265632,-608,0,572,0,0.0771895258046543,0,2886,0,1334,1291,0,5511,1552,0.15149786100139423,258961,105081,
45,0.0,1,0,45,46,128664,8190,492706,0.015870676100628932,153880,552,0.09502848749426634,8798,630,58,1,689,17540,0.01938949306265632,-608,0,572,0,0.0771895258046543,0,2886,0,1334,1291,0,5511,1552,0.15149786100139423,258961,105081,
45,0.0,1,0,45,46,128664,8190,492706,0.015870676100628932,153880,552,0.09502848749426634,8798,630,58,1,689,17540,0.01938949306265632,-608,0,572,0,0.0771895258046543,0,2886,0,1334,1291,0,5511,1552,0.15149786100139423,258961,105081,
45,0.0,1,0,45,46,128664,8190,492706,0.015870676100628932,153880,552,0.09502848749426634,8798,391,58,4,453,17540,0.01938949306265632,-608,0,333,0,0.159092035083679,0,2886,0,1334,1291,0,5511,1552,0.15149786100139423,258961,105081,
45,0.0,1,0,45,46,128664,8190,492706,0.015870676100628932,153880,552,0.09502848749426634,8798,391,58,4,453,17540,0.01938949306265632,-608,0,333,0,0.159092035083679,0,2886,0,1334,1291,0,5511,1552,0.15149786100139423,258961,105081,
45,0.0,1,0,45,46,128664,8190,492706,0.015870676100628932,153880,552,0.09502848749426634,8798,391,58,4,453,17540,0.01938949306265632,-608,0,333,0,0.159092035083679,0,2886,0,1334,1291,0,5511,1552,0.15149786100139423,258961,105081,
45,0.041666666666666664,1,0,45,46,128664,8190,492706,0.015870676100628932,153880,552,0.09502848749426634,8798,56,73,95,224,17540,0.01938949306265632,-608,0,-17,0,0.04510439401658955,1,2886,1,1334,1291,0,5511,1552,0.15149786100139423,258961,105081,
0,0.0,0,0,0,0,128664,8190,492706,0.0,153880,552,0.09502848749426634,8798,31,12,0,43,17540,0.01938949306265632,-608,0,19,0,0.20022909507445588,0,120,0,36,1,0,157,84,0.17322040299421726,258961,105081,
0,0.0,0,0,0,0,128664,8190,492706,0.0,153880,552,0.09502848749426634,8798,76,1,0,77,17540,0.01938949306265632,-608,0,75,0,0.025913595389677392,0,120,0,36,1,0,157,84,0.17322040299421726,258961,105081,
7,0.1875,0,0,7,7,128664,8190,492706,0.06081691297208539,153880,552,0.09502848749426634,8798,227,3,0,230,17540,0.01938949306265632,-608,0,224,3,0.3888398115429917,3,358,0,5,0,3,363,353,0.18999158471666341,258961,105081,
0,0.0,0,0,0,0,128664,8190,492706,0.0,153880,552,0.09502848749426634,8798,110,10,0,120,17540,0.01938949306265632,-608,0,100,0,0.3592356987009984,0,210,0,86,0,0,296,124,0.272031398229024,258961,105081,
0,0.0,0,0,0,0,128664,8190,492706,0.0,153880,552,0.09502848749426634,8798,37,0,0,37,17540,0.01938949306265632,-608,0,37,0,0.19786096256684493,0,423,0,36,0,0,459,387,0.13435561114483574,258961,105081,
0,0.0,0,0,0,0,128664,8190,492706,0.0,153880,552,0.09502848749426634,8798,119,3,0,122,17540,0.01938949306265632,-608,0,116,0,0.10758689036678273,0,423,0,36,0,0,459,387,0.13435561114483574,258961,105081,
0,0.0,0,0,0,0,128664,8190,492706,0.0,153880,552,0.09502848749426634,8798,119,3,0,122,17540,0.01938949306265632,-608,0,116,0,0.10758689036678273,0,423,0,36,0,0,459,387,0.13435561114483574,258961,105081,
0,0.0,0,0,0,0,128664,8190,492706,0.0,153880,552,0.09502848749426634,8798,53,2,0,55,17540,0.01938949306265632,-608,0,51,0,0.09598643154923742,0,423,0,36,0,0,459,387,0.13435561114483574,258961,105081,
0,0.0,0,0,0,0,128664,8190,492706,0.0,153880,552,0.09502848749426634,8798,53,2,0,55,17540,0.01938949306265632,-608,0,51,0,0.09598643154923742,0,423,0,36,0,0,459,387,0.13435561114483574,258961,105081,
18,0.0,0,18,0,36,128664,8190,492706,0.00466370503868629,153880,552,0.09502848749426634,8798,0,1,0,1,17540,0.01938949306265632,-608,0,-1,0,0.01,0,5273,0,203,54,0,5530,5070,0.050362438565902036,258961,105081,
18,0.0,0,18,0,36,128664,8190,492706,0.00466370503868629,153880,552,0.09502848749426634,8798,0,1,0,1,17540,0.01938949306265632,-608,0,-1,0,0.01,0,5273,0,203,54,0,5530,5070,0.050362438565902036,258961,105081,
18,0.0,0,18,0,36,128664,8190,492706,0.00466370503868629,153880,552,0.09502848749426634,8798,0,1,0,1,17540,0.01938949306265632,-608,0,-1,0,0.00641025641025641,0,5273,0,203,54,0,5530,5070,0.050362438565902036,258961,105081,
18,0.0,0,18,0,36,128664,8190,492706,0.00466370503868629,153880,552,0.09502848749426634,8798,0,1,0,1,17540,0.01938949306265632,-608,0,-1,0,0.00641025641025641,0,5273,0,203,54,0,5530,5070,0.050362438565902036,258961,105081,
18,0.0,0,18,0,36,128664,8190,492706,0.00466370503868629,153880,552,0.09502848749426634,8798,0,1,0,1,17540,0.01938949306265632,-608,0,-1,0,0.00641025641025641,0,5273,0,203,54,0,5530,5070,0.050362438565902036,258961,105081,
18,0.0,0,18,0,36,128664,8190,492706,0.00466370503868629,153880,552,0.09502848749426634,8798,0,1,0,1,17540,0.01938949306265632,-608,0,-1,0,0.00641025641025641,0,5273,0,203,54,0,5530,5070,0.050362438565902036,258961,105081,
18,0.0,0,18,0,36,128664,8190,492706,0.00466370503868629,153880,552,0.09502848749426634,8798,0,1,0,1,17540,0.01938949306265632,-608,0,-1,0,0.00641025641025641,0,5273,0,203,54,0,5530,5070,0.050362438565902036,258961,105081,
18,0.0,0,18,0,36,128664,8190,492706,0.00466370503868629,153880,552,0.09502848749426634,8798,0,1,0,1,17540,0.01938949306265632,-608,0,-1,0,0.00641025641025641,0,5273,0,203,54,0,5530,5070,0.050362438565902036,258961,105081,
18,0.0,0,18,0,36,128664,8190,492706,0.00466370503868629,153880,552,0.09502848749426634,8798,0,1,0,1,17540,0.01938949306265632,-608,0,-1,0,0.00641025641025641,0,5273,0,203,54,0,5530,5070,0.050362438565902036,258961,105081,
18,0.0,0,18,0,36,128664,8190,492706,0.00466370503868629,153880,552,0.09502848749426634,8798,0,1,0,1,17540,0.01938949306265632,-608,0,-1,0,0.00641025641025641,0,5273,0,203,54,0,5530,5070,0.050362438565902036,258961,105081,
18,0.007585335018963337,0,18,0,36,128664,8190,492706,0.00466370503868629,153880,552,0.09502848749426634,8798,310,3,0,313,17540,0.01938949306265632,-608,3,307,3,0.01633556667601215,6,5273,0,203,54,0,5530,5070,0.050362438565902036,258961,105081,
18,0.007585335018963337,0,18,0,36,128664,8190,492706,0.00466370503868629,153880,552,0.09502848749426634,8798,310,3,0,313,17540,0.01938949306265632,-608,3,307,3,0.01633556667601215,6,5273,0,203,54,0,5530,5070,0.050362438565902036,258961,105081,
18,0.007585335018963337,0,18,0,36,128664,8190,492706,0.00466370503868629,153880,552,0.09502848749426634,8798,310,3,0,313,17540,0.01938949306265632,-608,3,307,3,0.01633556667601215,6,5273,0,203,54,0,5530,5070,0.050362438565902036,258961,105081,
18,0.031638418079096044,0,18,0,36,128664,8190,492706,0.00466370503868629,153880,552,0.09502848749426634,8798,630,14,0,644,17540,0.01938949306265632,-608,14,616,14,0.039455154093649775,28,5273,0,203,54,0,5530,5070,0.050362438565902036,258961,105081,
18,0.031638418079096044,0,18,0,36,128664,8190,492706,0.00466370503868629,153880,552,0.09502848749426634,8798,630,14,0,644,17540,0.01938949306265632,-608,14,616,14,0.039455154093649775,28,5273,0,203,54,0,5530,5070,0.050362438565902036,258961,105081,
0,0.0,0,0,0,0,128664,8190,492706,0.0,153880,552,0.09502848749426634,8798,86,61,0,147,17540,0.01938949306265632,-608,0,25,0,0.1470720937580896,0,1730,0,1443,3003,0,6176,287,0.04619980550282602,258961,105081,
0,0.0,0,0,0,0,128664,8190,492706,0.0,153880,552,0.09502848749426634,8798,86,61,0,147,17540,0.01938949306265632,-608,0,25,0,0.1470720937580896,0,1730,0,1443,3003,0,6176,287,0.04619980550282602,258961,105081,
0,0.0,0,0,0,0,128664,8190,492706,0.0,153880,552,0.09502848749426634,8798,139,797,2202,3138,17540,0.01938949306265632,-608,0,-658,0,0.2347727571506081,0,1730,0,1443,3003,0,6176,287,0.04619980550282602,258961,105081,
0,0.0,0,0,0,0,128664,8190,492706,0.0,153880,552,0.09502848749426634,8798,139,797,2202,3138,17540,0.01938949306265632,-608,0,-658,0,0.2347727571506081,0,1730,0,1443,3003,0,6176,287,0.04619980550282602,258961,105081,
0,0.0,0,0,0,0,128664,8190,492706,0.0,153880,552,0.09502848749426634,8798,139,797,2202,3138,17540,0.01938949306265632,-608,0,-658,0,0.2347727571506081,0,1730,0,1443,3003,0,6176,287,0.04619980550282602,258961,105081,
186,0.0,32,75,111,293,128664,8190,492706,0.05627295966171268,153880,552,0.09502848749426634,8798,80,0,0,80,17540,0.01938949306265632,-608,0,80,0,0.6153846153846154,0,8461,0,2611,6468,0,17540,5850,0.10657665209355899,258961,105081,
1,0.0,0,1,0,2,128664,8190,492706,5.162622612287042E-4,153880,552,0.09502848749426634,8798,22,21,168,211,17540,0.01938949306265632,-608,0,1,0,0.06805966316431021,0,1643,0,1769,1286,0,4698,-126,0.19262973866057076,258961,105081,
1,0.0,0,1,0,2,128664,8190,492706,5.162622612287042E-4,153880,552,0.09502848749426634,8798,22,21,168,211,17540,0.01938949306265632,-608,0,1,0,0.06805966316431021,0,1643,0,1769,1286,0,4698,-126,0.19262973866057076,258961,105081,
1,0.0,0,1,0,2,128664,8190,492706,5.162622612287042E-4,153880,552,0.09502848749426634,8798,262,19,6,287,17540,0.01938949306265632,-608,0,243,0,0.27924301035477134,0,1643,0,1769,1286,0,4698,-126,0.19262973866057076,258961,105081,
1,0.0,0,1,0,2,128664,8190,492706,5.162622612287042E-4,153880,552,0.09502848749426634,8798,146,362,235,743,17540,0.01938949306265632,-608,0,-216,0,0.1879501012809097,0,1643,0,1769,1286,0,4698,-126,0.19262973866057076,258961,105081,
1,0.0,0,1,0,2,128664,8190,492706,5.162622612287042E-4,153880,552,0.09502848749426634,8798,146,362,235,743,17540,0.01938949306265632,-608,0,-216,0,0.1879501012809097,0,1643,0,1769,1286,0,4698,-126,0.19262973866057076,258961,105081,
1,0.0,0,1,0,2,128664,8190,492706,3.062318174858368E-4,153880,552,0.09502848749426634,8798,279,5,0,284,17540,0.01938949306265632,-608,0,274,0,0.27148783025958256,0,3440,0,990,224,0,4654,2450,0.07716994826124138,258961,105081,
1,0.0,0,1,0,2,128664,8190,492706,3.062318174858368E-4,153880,552,0.09502848749426634,8798,231,27,4,262,17540,0.01938949306265632,-608,0,204,0,0.0659298552881395,0,3440,0,990,224,0,4654,2450,0.07716994826124138,258961,105081,
1,0.0,0,1,0,2,128664,8190,492706,3.062318174858368E-4,153880,552,0.09502848749426634,8798,231,27,4,262,17540,0.01938949306265632,-608,0,204,0,0.0659298552881395,0,3440,0,990,224,0,4654,2450,0.07716994826124138,258961,105081,
1,0.0,0,1,0,2,128664,8190,492706,3.062318174858368E-4,153880,552,0.09502848749426634,8798,1513,382,71,1966,17540,0.01938949306265632,-608,0,1131,0,0.2015127251935173,0,3440,0,990,224,0,4654,2450,0.07716994826124138,258961,105081,
1,0.0,0,1,0,2,128664,8190,492706,3.062318174858368E-4,153880,552,0.09502848749426634,8798,1513,382,71,1966,17540,0.01938949306265632,-608,0,1131,0,0.2015127251935173,0,3440,0,990,224,0,4654,2450,0.07716994826124138,258961,105081,
1,0.0,0,1,0,2,128664,8190,492706,3.062318174858368E-4,153880,552,0.09502848749426634,8798,1513,382,71,1966,17540,0.01938949306265632,-608,0,1131,0,0.2015127251935173,0,3440,0,990,224,0,4654,2450,0.07716994826124138,258961,105081,
1,0.0,0,1,0,2,128664,8190,492706,3.062318174858368E-4,153880,552,0.09502848749426634,8798,1513,382,71,1966,17540,0.01938949306265632,-608,0,1131,0,0.2015127251935173,0,3440,0,990,224,0,4654,2450,0.07716994826124138,258961,105081,
1,0.0,0,1,0,2,128664,8190,492706,3.062318174858368E-4,153880,552,0.09502848749426634,8798,1513,382,71,1966,17540,0.01938949306265632,-608,0,1131,0,0.2015127251935173,0,3440,0,990,224,0,4654,2450,0.07716994826124138,258961,105081,
1,0.0,0,1,0,2,128664,8190,492706,3.062318174858368E-4,153880,552,0.09502848749426634,8798,1513,382,71,1966,17540,0.01938949306265632,-608,0,1131,0,0.2015127251935173,0,3440,0,990,224,0,4654,2450,0.07716994826124138,258961,105081,
1,0.006430868167202572,0,1,0,2,128664,8190,492706,3.062318174858368E-4,153880,552,0.09502848749426634,8798,478,360,49,887,17540,0.01938949306265632,-608,1,118,1,0.047024899768418366,2,3440,0,990,224,0,4654,2450,0.07716994826124138,258961,105081,
1,0.006430868167202572,0,1,0,2,128664,8190,492706,3.062318174858368E-4,153880,552,0.09502848749426634,8798,478,360,49,887,17540,0.01938949306265632,-608,1,118,1,0.047024899768418366,2,3440,0,990,224,0,4654,2450,0.07716994826124138,258961,105081,
1,0.006430868167202572,0,1,0,2,128664,8190,492706,3.062318174858368E-4,153880,552,0.09502848749426634,8798,478,360,49,887,17540,0.01938949306265632,-608,1,118,1,0.047024899768418366,2,3440,0,990,224,0,4654,2450,0.07716994826124138,258961,105081,
1,0.006430868167202572,0,1,0,2,128664,8190,492706,3.062318174858368E-4,153880,552,0.09502848749426634,8798,478,360,49,887,17540,0.01938949306265632,-608,1,118,1,0.047024899768418366,2,3440,0,990,224,0,4654,2450,0.07716994826124138,258961,105081,
1,0.006430868167202572,0,1,0,2,128664,8190,492706,3.062318174858368E-4,153880,552,0.09502848749426634,8798,478,360,49,887,17540,0.01938949306265632,-608,1,118,1,0.047024899768418366,2,3440,0,990,224,0,4654,2450,0.07716994826124138,258961,105081,
1,0.006430868167202572,0,1,0,2,128664,8190,492706,3.062318174858368E-4,153880,552,0.09502848749426634,8798,478,360,49,887,17540,0.01938949306265632,-608,1,118,1,0.047024899768418366,2,3440,0,990,224,0,4654,2450,0.07716994826124138,258961,105081,
1,0.0,0,1,0,2,128664,8190,492706,3.062318174858368E-4,153880,552,0.09502848749426634,8798,46,49,6,101,17540,0.01938949306265632,-608,0,-3,0,0.08994473754138105,0,3440,0,990,224,0,4654,2450,0.07716994826124138,258961,105081,
0,0.0,0,0,0,0,128664,8190,492706,0.0,153880,552,0.09502848749426634,8798,27,83,1,111,17540,0.01938949306265632,-608,0,-56,0,0.11833145721046541,0,101,0,106,1,0,208,-5,0.17039821935355715,258961,105081,
0,0.0,0,0,0,0,128664,8190,492706,0.0,153880,552,0.09502848749426634,8798,27,83,1,111,17540,0.01938949306265632,-608,0,-56,0,0.11833145721046541,0,101,0,106,1,0,208,-5,0.17039821935355715,258961,105081,
0,0.0,0,0,0,0,128664,8190,492706,0.0,153880,552,0.09502848749426634,8798,27,83,1,111,17540,0.01938949306265632,-608,0,-56,0,0.11833145721046541,0,101,0,106,1,0,208,-5,0.17039821935355715,258961,105081,
0,0.0,0,0,0,0,128664,8190,492706,0.0,153880,552,0.09502848749426634,8798,27,83,1,111,17540,0.01938949306265632,-608,0,-56,0,0.11833145721046541,0,101,0,106,1,0,208,-5,0.17039821935355715,258961,105081,
0,0.0,0,0,0,0,128664,8190,492706,0.0,153880,552,0.09502848749426634,8798,193,51,0,244,17540,0.01938949306265632,-608,0,142,0,0.061567853083044854,0,362,0,61,0,0,423,301,0.025127024970636513,258961,105081,
0,0.0,0,0,0,0,128664,8190,492706,0.0,153880,552,0.09502848749426634,8798,247,12,4,263,17540,0.01938949306265632,-608,0,235,0,0.36717736343932517,0,962,0,311,55,0,1328,651,0.21657325570884609,258961,105081,
0,0.0,0,0,0,0,128664,8190,492706,0.0,153880,552,0.09502848749426634,8798,247,12,4,263,17540,0.01938949306265632,-608,0,235,0,0.36717736343932517,0,962,0,311,55,0,1328,651,0.21657325570884609,258961,105081,
0,0.0,0,0,0,0,128664,8190,492706,0.0,153880,552,0.09502848749426634,8798,397,282,51,730,17540,0.01938949306265632,-608,0,115,0,0.21392362186169622,0,962,0,311,55,0,1328,651,0.21657325570884609,258961,105081,
0,0.0,0,0,0,0,128664,8190,492706,0.0,153880,552,0.09502848749426634,8798,397,282,51,730,17540,0.01938949306265632,-608,0,115,0,0.21392362186169622,0,962,0,311,55,0,1328,651,0.21657325570884609,258961,105081,
0,0.0,0,0,0,0,128664,8190,492706,0.0,153880,552,0.09502848749426634,8798,397,282,51,730,17540,0.01938949306265632,-608,0,115,0,0.21392362186169622,0,962,0,311,55,0,1328,651,0.21657325570884609,258961,105081,
0,0.0,0,0,0,0,128664,8190,492706,0.0,153880,552,0.09502848749426634,8798,397,282,51,730,17540,0.01938949306265632,-608,0,115,0,0.21392362186169622,0,962,0,311,55,0,1328,651,0.21657325570884609,258961,105081,
0,0.0,0,0,0,0,128664,8190,492706,0.0,153880,552,0.09502848749426634,8798,397,282,51,730,17540,0.01938949306265632,-608,0,115,0,0.21392362186169622,0,962,0,311,55,0,1328,651,0.21657325570884609,258961,105081,
0,0.0,0,0,0,0,128664,8190,492706,0.0,153880,552,0.09502848749426634,8798,2,2,33,37,17540,0.01938949306265632,-608,0,0,0,0.08003168634740912,0,345,0,14,33,0,392,331,0.09766843076027788,258961,105081,
0,0.0,0,0,0,0,128664,8190,492706,0.0,153880,552,0.09502848749426634,8798,2,2,33,37,17540,0.01938949306265632,-608,0,0,0,0.08003168634740912,0,345,0,14,33,0,392,331,0.09766843076027788,258961,105081,
0,0.0,0,0,0,0,128664,8190,492706,0.0,153880,552,0.09502848749426634,8798,217,11,0,228,17540,0.01938949306265632,-608,0,206,0,0.03053260111231315,0,345,0,14,33,0,392,331,0.09766843076027788,258961,105081,
11,0.0,0,12,-1,23,128664,8190,492706,0.032783882783882785,153880,552,0.09502848749426634,8798,16,139,4,159,17540,0.01938949306265632,-608,0,-123,0,0.13104641580476878,0,1184,0,1028,2220,0,4432,156,0.07474880808877458,258961,105081,
11,0.0,0,12,-1,23,128664,8190,492706,0.032783882783882785,153880,552,0.09502848749426634,8798,63,373,25,461,17540,0.01938949306265632,-608,0,-310,0,0.09199982842716521,0,1184,0,1028,2220,0,4432,156,0.07474880808877458,258961,105081,
11,0.0,0,12,-1,23,128664,8190,492706,0.032783882783882785,153880,552,0.09502848749426634,8798,63,373,25,461,17540,0.01938949306265632,-608,0,-310,0,0.09199982842716521,0,1184,0,1028,2220,0,4432,156,0.07474880808877458,258961,105081,
11,0.0,0,12,-1,23,128664,8190,492706,0.032783882783882785,153880,552,0.09502848749426634,8798,63,373,25,461,17540,0.01938949306265632,-608,0,-310,0,0.09199982842716521,0,1184,0,1028,2220,0,4432,156,0.07474880808877458,258961,105081,
11,0.0,0,12,-1,23,128664,8190,492706,0.032783882783882785,153880,552,0.09502848749426634,8798,63,373,25,461,17540,0.01938949306265632,-608,0,-310,0,0.09199982842716521,0,1184,0,1028,2220,0,4432,156,0.07474880808877458,258961,105081,
11,0.0,0,12,-1,23,128664,8190,492706,0.032783882783882785,153880,552,0.09502848749426634,8798,63,373,25,461,17540,0.01938949306265632,-608,0,-310,0,0.09199982842716521,0,1184,0,1028,2220,0,4432,156,0.07474880808877458,258961,105081,
11,0.0,0,12,-1,23,128664,8190,492706,0.032783882783882785,153880,552,0.09502848749426634,8798,63,373,25,461,17540,0.01938949306265632,-608,0,-310,0,0.09199982842716521,0,1184,0,1028,2220,0,4432,156,0.07474880808877458,258961,105081,
11,0.0,0,12,-1,23,128664,8190,492706,0.032783882783882785,153880,552,0.09502848749426634,8798,451,112,550,1113,17540,0.01938949306265632,-608,0,339,0,0.09936020786677931,0,1184,0,1028,2220,0,4432,156,0.07474880808877458,258961,105081,
11,0.0,0,12,-1,23,128664,8190,492706,0.032783882783882785,153880,552,0.09502848749426634,8798,451,112,550,1113,17540,0.01938949306265632,-608,0,339,0,0.09936020786677931,0,1184,0,1028,2220,0,4432,156,0.07474880808877458,258961,105081,
11,0.0,0,12,-1,23,128664,8190,492706,0.032783882783882785,153880,552,0.09502848749426634,8798,451,112,550,1113,17540,0.01938949306265632,-608,0,339,0,0.09936020786677931,0,1184,0,1028,2220,0,4432,156,0.07474880808877458,258961,105081,
11,0.0,0,12,-1,23,128664,8190,492706,0.032783882783882785,153880,552,0.09502848749426634,8798,451,112,550,1113,17540,0.01938949306265632,-608,0,339,0,0.09936020786677931,0,1184,0,1028,2220,0,4432,156,0.07474880808877458,258961,105081,
11,0.0,0,12,-1,23,128664,8190,492706,0.032783882783882785,153880,552,0.09502848749426634,8798,184,0,123,307,17540,0.01938949306265632,-608,0,184,0,0.009777354407956403,0,1184,0,1028,2220,0,4432,156,0.07474880808877458,258961,105081,
11,0.0,0,12,-1,23,128664,8190,492706,0.032783882783882785,153880,552,0.09502848749426634,8798,107,3,40,150,17540,0.01938949306265632,-608,0,104,0,0.007582441538885399,0,1184,0,1028,2220,0,4432,156,0.07474880808877458,258961,105081,
11,0.38461538461538464,0,12,-1,23,128664,8190,492706,0.032783882783882785,153880,552,0.09502848749426634,8798,138,291,899,1328,17540,0.01938949306265632,-608,8,-153,7,0.18975938001905007,15,1184,0,1028,2220,-1,4432,156,0.07474880808877458,258961,105081,
11,0.38461538461538464,0,12,-1,23,128664,8190,492706,0.032783882783882785,153880,552,0.09502848749426634,8798,138,291,899,1328,17540,0.01938949306265632,-608,8,-153,7,0.18975938001905007,15,1184,0,1028,2220,-1,4432,156,0.07474880808877458,258961,105081,
11,0.38461538461538464,0,12,-1,23,128664,8190,492706,0.032783882783882785,153880,552,0.09502848749426634,8798,138,291,899,1328,17540,0.01938949306265632,-608,8,-153,7,0.18975938001905007,15,1184,0,1028,2220,-1,4432,156,0.07474880808877458,258961,105081,
11,0.38461538461538464,0,12,-1,23,128664,8190,492706,0.032783882783882785,153880,552,0.09502848749426634,8798,138,291,899,1328,17540,0.01938949306265632,-608,8,-153,7,0.18975938001905007,15,1184,0,1028,2220,-1,4432,156,0.07474880808877458,258961,105081,
11,0.38461538461538464,0,12,-1,23,128664,8190,492706,0.032783882783882785,153880,552,0.09502848749426634,8798,138,291,899,1328,17540,0.01938949306265632,-608,8,-153,7,0.18975938001905007,15,1184,0,1028,2220,-1,4432,156,0.07474880808877458,258961,105081,
11,0.38461538461538464,0,12,-1,23,128664,8190,492706,0.032783882783882785,153880,552,0.09502848749426634,8798,138,291,899,1328,17540,0.01938949306265632,-608,8,-153,7,0.18975938001905007,15,1184,0,1028,2220,-1,4432,156,0.07474880808877458,258961,105081,
11,0.38461538461538464,0,12,-1,23,128664,8190,492706,0.032783882783882785,153880,552,0.09502848749426634,8798,138,291,899,1328,17540,0.01938949306265632,-608,8,-153,7,0.18975938001905007,15,1184,0,1028,2220,-1,4432,156,0.07474880808877458,258961,105081,
3,0.2222222222222222,3,2,1,8,128664,8190,492706,0.07407407407407407,153880,552,0.09502848749426634,8798,59,33,286,378,17540,0.01938949306265632,-608,2,26,3,0.11163057208973957,8,179,3,175,296,1,650,4,0.10431087762524521,258961,105081,
3,0.0,3,2,1,8,128664,8190,492706,0.07407407407407407,153880,552,0.09502848749426634,8798,51,86,0,137,17540,0.01938949306265632,-608,0,-35,0,0.07575605195871744,0,179,0,175,296,0,650,4,0.10431087762524521,258961,105081,
1259,0.1910984548858303,226,841,418,2326,128664,8190,492706,0.08853886633817586,153880,552,0.09502848749426634,8798,603,134,35,772,17540,0.01938949306265632,-608,3,469,20,0.16633452583013256,23,10372,0,6207,6886,17,23465,4165,0.1030345720538558,258961,105081,
1259,0.1910984548858303,226,841,418,2326,128664,8190,492706,0.08853886633817586,153880,552,0.09502848749426634,8798,603,134,35,772,17540,0.01938949306265632,-608,3,469,20,0.16633452583013256,23,10372,0,6207,6886,17,23465,4165,0.1030345720538558,258961,105081,
1259,0.17614572244342133,226,841,418,2326,128664,8190,492706,0.08853886633817586,153880,552,0.09502848749426634,8798,2043,1373,1856,5272,17540,0.01938949306265632,-608,156,670,245,0.18981966345407597,414,10372,13,6207,6886,89,23465,4165,0.1030345720538558,258961,105081,
1259,0.17614572244342133,226,841,418,2326,128664,8190,492706,0.08853886633817586,153880,552,0.09502848749426634,8798,2043,1373,1856,5272,17540,0.01938949306265632,-608,156,670,245,0.18981966345407597,414,10372,13,6207,6886,89,23465,4165,0.1030345720538558,258961,105081,
1259,0.17614572244342133,226,841,418,2326,128664,8190,492706,0.08853886633817586,153880,552,0.09502848749426634,8798,2043,1373,1856,5272,17540,0.01938949306265632,-608,156,670,245,0.18981966345407597,414,10372,13,6207,6886,89,23465,4165,0.1030345720538558,258961,105081,
1259,0.17614572244342133,226,841,418,2326,128664,8190,492706,0.08853886633817586,153880,552,0.09502848749426634,8798,2043,1373,1856,5272,17540,0.01938949306265632,-608,156,670,245,0.18981966345407597,414,10372,13,6207,6886,89,23465,4165,0.1030345720538558,258961,105081,
1259,0.17614572244342133,226,841,418,2326,128664,8190,492706,0.08853886633817586,153880,552,0.09502848749426634,8798,2043,1373,1856,5272,17540,0.01938949306265632,-608,156,670,245,0.18981966345407597,414,10372,13,6207,6886,89,23465,4165,0.1030345720538558,258961,105081,
1259,0.17614572244342133,226,841,418,2326,128664,8190,492706,0.08853886633817586,153880,552,0.09502848749426634,8798,2043,1373,1856,5272,17540,0.01938949306265632,-608,156,670,245,0.18981966345407597,414,10372,13,6207,6886,89,23465,4165,0.1030345720538558,258961,105081,
1259,0.17614572244342133,226,841,418,2326,128664,8190,492706,0.08853886633817586,153880,552,0.09502848749426634,8798,2043,1373,1856,5272,17540,0.01938949306265632,-608,156,670,245,0.18981966345407597,414,10372,13,6207,6886,89,23465,4165,0.1030345720538558,258961,105081,
1259,0.17614572244342133,226,841,418,2326,128664,8190,492706,0.08853886633817586,153880,552,0.09502848749426634,8798,2043,1373,1856,5272,17540,0.01938949306265632,-608,156,670,245,0.18981966345407597,414,10372,13,6207,6886,89,23465,4165,0.1030345720538558,258961,105081,
1259,0.17614572244342133,226,841,418,2326,128664,8190,492706,0.08853886633817586,153880,552,0.09502848749426634,8798,2043,1373,1856,5272,17540,0.01938949306265632,-608,156,670,245,0.18981966345407597,414,10372,13,6207,6886,89,23465,4165,0.1030345720538558,258961,105081,
1259,0.17614572244342133,226,841,418,2326,128664,8190,492706,0.08853886633817586,153880,552,0.09502848749426634,8798,2043,1373,1856,5272,17540,0.01938949306265632,-608,156,670,245,0.18981966345407597,414,10372,13,6207,6886,89,23465,4165,0.1030345720538558,258961,105081,
1259,0.17614572244342133,226,841,418,2326,128664,8190,492706,0.08853886633817586,153880,552,0.09502848749426634,8798,2043,1373,1856,5272,17540,0.01938949306265632,-608,156,670,245,0.18981966345407597,414,10372,13,6207,6886,89,23465,4165,0.1030345720538558,258961,105081,
1259,0.17614572244342133,226,841,418,2326,128664,8190,492706,0.08853886633817586,153880,552,0.09502848749426634,8798,2043,1373,1856,5272,17540,0.01938949306265632,-608,156,670,245,0.18981966345407597,414,10372,13,6207,6886,89,23465,4165,0.1030345720538558,258961,105081,
1259,0.17614572244342133,226,841,418,2326,128664,8190,492706,0.08853886633817586,153880,552,0.09502848749426634,8798,2043,1373,1856,5272,17540,0.01938949306265632,-608,156,670,245,0.18981966345407597,414,10372,13,6207,6886,89,23465,4165,0.1030345720538558,258961,105081,
1259,0.17614572244342133,226,841,418,2326,128664,8190,492706,0.08853886633817586,153880,552,0.09502848749426634,8798,2043,1373,1856,5272,17540,0.01938949306265632,-608,156,670,245,0.18981966345407597,414,10372,13,6207,6886,89,23465,4165,0.1030345720538558,258961,105081,
1259,0.17614572244342133,226,841,418,2326,128664,8190,492706,0.08853886633817586,153880,552,0.09502848749426634,8798,2043,1373,1856,5272,17540,0.01938949306265632,-608,156,670,245,0.18981966345407597,414,10372,13,6207,6886,89,23465,4165,0.1030345720538558,258961,105081,
1259,0.17614572244342133,226,841,418,2326,128664,8190,492706,0.08853886633817586,153880,552,0.09502848749426634,8798,2043,1373,1856,5272,17540,0.01938949306265632,-608,156,670,245,0.18981966345407597,414,10372,13,6207,6886,89,23465,4165,0.1030345720538558,258961,105081,
1259,0.17614572244342133,226,841,418,2326,128664,8190,492706,0.08853886633817586,153880,552,0.09502848749426634,8798,2043,1373,1856,5272,17540,0.01938949306265632,-608,156,670,245,0.18981966345407597,414,10372,13,6207,6886,89,23465,4165,0.1030345720538558,258961,105081,
1259,0.17614572244342133,226,841,418,2326,128664,8190,492706,0.08853886633817586,153880,552,0.09502848749426634,8798,2043,1373,1856,5272,17540,0.01938949306265632,-608,156,670,245,0.18981966345407597,414,10372,13,6207,6886,89,23465,4165,0.1030345720538558,258961,105081,
1259,0.17614572244342133,226,841,418,2326,128664,8190,492706,0.08853886633817586,153880,552,0.09502848749426634,8798,2043,1373,1856,5272,17540,0.01938949306265632,-608,156,670,245,0.18981966345407597,414,10372,13,6207,6886,89,23465,4165,0.1030345720538558,258961,105081,
1259,0.17614572244342133,226,841,418,2326,128664,8190,492706,0.08853886633817586,153880,552,0.09502848749426634,8798,2043,1373,1856,5272,17540,0.01938949306265632,-608,156,670,245,0.18981966345407597,414,10372,13,6207,6886,89,23465,4165,0.1030345720538558,258961,105081,
1259,0.17614572244342133,226,841,418,2326,128664,8190,492706,0.08853886633817586,153880,552,0.09502848749426634,8798,2043,1373,1856,5272,17540,0.01938949306265632,-608,156,670,245,0.18981966345407597,414,10372,13,6207,6886,89,23465,4165,0.1030345720538558,258961,105081,
1259,0.17614572244342133,226,841,418,2326,128664,8190,492706,0.08853886633817586,153880,552,0.09502848749426634,8798,2043,1373,1856,5272,17540,0.01938949306265632,-608,156,670,245,0.18981966345407597,414,10372,13,6207,6886,89,23465,4165,0.1030345720538558,258961,105081,
1259,0.17614572244342133,226,841,418,2326,128664,8190,492706,0.08853886633817586,153880,552,0.09502848749426634,8798,2043,1373,1856,5272,17540,0.01938949306265632,-608,156,670,245,0.18981966345407597,414,10372,13,6207,6886,89,23465,4165,0.1030345720538558,258961,105081,
1259,0.17614572244342133,226,841,418,2326,128664,8190,492706,0.08853886633817586,153880,552,0.09502848749426634,8798,2043,1373,1856,5272,17540,0.01938949306265632,-608,156,670,245,0.18981966345407597,414,10372,13,6207,6886,89,23465,4165,0.1030345720538558,258961,105081,
1259,0.17614572244342133,226,841,418,2326,128664,8190,492706,0.08853886633817586,153880,552,0.09502848749426634,8798,2043,1373,1856,5272,17540,0.01938949306265632,-608,156,670,245,0.18981966345407597,414,10372,13,6207,6886,89,23465,4165,0.1030345720538558,258961,105081,
1259,0.17614572244342133,226,841,418,2326,128664,8190,492706,0.08853886633817586,153880,552,0.09502848749426634,8798,2043,1373,1856,5272,17540,0.01938949306265632,-608,156,670,245,0.18981966345407597,414,10372,13,6207,6886,89,23465,4165,0.1030345720538558,258961,105081,
1259,0.14067181276655738,226,841,418,2326,128664,8190,492706,0.08853886633817586,153880,552,0.09502848749426634,8798,104,0,0,104,17540,0.01938949306265632,-608,0,104,104,0.14067181276655738,104,10372,0,6207,6886,104,23465,4165,0.1030345720538558,258961,105081,
1259,0.23255813953488372,226,841,418,2326,128664,8190,492706,0.08853886633817586,153880,552,0.09502848749426634,8798,175,16,0,191,17540,0.01938949306265632,-608,9,159,1,0.09591819385245778,10,10372,0,6207,6886,-8,23465,4165,0.1030345720538558,258961,105081,
1259,0.17224165861401902,226,841,418,2326,128664,8190,492706,0.08853886633817586,153880,552,0.09502848749426634,8798,1532,545,210,2287,17540,0.01938949306265632,-608,335,987,398,0.16646333409159192,918,10372,185,6207,6886,63,23465,4165,0.1030345720538558,258961,105081,
1259,0.17224165861401902,226,841,418,2326,128664,8190,492706,0.08853886633817586,153880,552,0.09502848749426634,8798,1532,545,210,2287,17540,0.01938949306265632,-608,335,987,398,0.16646333409159192,918,10372,185,6207,6886,63,23465,4165,0.1030345720538558,258961,105081,
1259,0.17224165861401902,226,841,418,2326,128664,8190,492706,0.08853886633817586,153880,552,0.09502848749426634,8798,1532,545,210,2287,17540,0.01938949306265632,-608,335,987,398,0.16646333409159192,918,10372,185,6207,6886,63,23465,4165,0.1030345720538558,258961,105081,
1259,0.17224165861401902,226,841,418,2326,128664,8190,492706,0.08853886633817586,153880,552,0.09502848749426634,8798,1532,545,210,2287,17540,0.01938949306265632,-608,335,987,398,0.16646333409159192,918,10372,185,6207,6886,63,23465,4165,0.1030345720538558,258961,105081,
1259,0.17224165861401902,226,841,418,2326,128664,8190,492706,0.08853886633817586,153880,552,0.09502848749426634,8798,1532,545,210,2287,17540,0.01938949306265632,-608,335,987,398,0.16646333409159192,918,10372,185,6207,6886,63,23465,4165,0.1030345720538558,258961,105081,
1259,0.17224165861401902,226,841,418,2326,128664,8190,492706,0.08853886633817586,153880,552,0.09502848749426634,8798,1532,545,210,2287,17540,0.01938949306265632,-608,335,987,398,0.16646333409159192,918,10372,185,6207,6886,63,23465,4165,0.1030345720538558,258961,105081,
1259,0.17224165861401902,226,841,418,2326,128664,8190,492706,0.08853886633817586,153880,552,0.09502848749426634,8798,1532,545,210,2287,17540,0.01938949306265632,-608,335,987,398,0.16646333409159192,918,10372,185,6207,6886,63,23465,4165,0.1030345720538558,258961,105081,
1259,0.17224165861401902,226,841,418,2326,128664,8190,492706,0.08853886633817586,153880,552,0.09502848749426634,8798,1532,545,210,2287,17540,0.01938949306265632,-608,335,987,398,0.16646333409159192,918,10372,185,6207,6886,63,23465,4165,0.1030345720538558,258961,105081,
1259,0.17224165861401902,226,841,418,2326,128664,8190,492706,0.08853886633817586,153880,552,0.09502848749426634,8798,1532,545,210,2287,17540,0.01938949306265632,-608,335,987,398,0.16646333409159192,918,10372,185,6207,6886,63,23465,4165,0.1030345720538558,258961,105081,
1259,0.17224165861401902,226,841,418,2326,128664,8190,492706,0.08853886633817586,153880,552,0.09502848749426634,8798,1532,545,210,2287,17540,0.01938949306265632,-608,335,987,398,0.16646333409159192,918,10372,185,6207,6886,63,23465,4165,0.1030345720538558,258961,105081,
1259,0.17224165861401902,226,841,418,2326,128664,8190,492706,0.08853886633817586,153880,552,0.09502848749426634,8798,1532,545,210,2287,17540,0.01938949306265632,-608,335,987,398,0.16646333409159192,918,10372,185,6207,6886,63,23465,4165,0.1030345720538558,258961,105081,
1259,0.17224165861401902,226,841,418,2326,128664,8190,492706,0.08853886633817586,153880,552,0.09502848749426634,8798,1532,545,210,2287,17540,0.01938949306265632,-608,335,987,398,0.16646333409159192,918,10372,185,6207,6886,63,23465,4165,0.1030345720538558,258961,105081,
1259,0.17224165861401902,226,841,418,2326,128664,8190,492706,0.08853886633817586,153880,552,0.09502848749426634,8798,1532,545,210,2287,17540,0.01938949306265632,-608,335,987,398,0.16646333409159192,918,10372,185,6207,6886,63,23465,4165,0.1030345720538558,258961,105081,
1259,0.17224165861401902,226,841,418,2326,128664,8190,492706,0.08853886633817586,153880,552,0.09502848749426634,8798,1532,545,210,2287,17540,0.01938949306265632,-608,335,987,398,0.16646333409159192,918,10372,185,6207,6886,63,23465,4165,0.1030345720538558,258961,105081,
1259,0.2631578947368421,226,841,418,2326,128664,8190,492706,0.08853886633817586,153880,552,0.09502848749426634,8798,243,82,153,478,17540,0.01938949306265632,-608,3,161,2,0.14865696353898206,5,10372,0,6207,6886,-1,23465,4165,0.1030345720538558,258961,105081,
1259,0.2631578947368421,226,841,418,2326,128664,8190,492706,0.08853886633817586,153880,552,0.09502848749426634,8798,243,82,153,478,17540,0.01938949306265632,-608,3,161,2,0.14865696353898206,5,10372,0,6207,6886,-1,23465,4165,0.1030345720538558,258961,105081,
1259,0.2631578947368421,226,841,418,2326,128664,8190,492706,0.08853886633817586,153880,552,0.09502848749426634,8798,243,82,153,478,17540,0.01938949306265632,-608,3,161,2,0.14865696353898206,5,10372,0,6207,6886,-1,23465,4165,0.1030345720538558,258961,105081,
1259,0.2631578947368421,226,841,418,2326,128664,8190,492706,0.08853886633817586,153880,552,0.09502848749426634,8798,243,82,153,478,17540,0.01938949306265632,-608,3,161,2,0.14865696353898206,5,10372,0,6207,6886,-1,23465,4165,0.1030345720538558,258961,105081,
1259,0.2631578947368421,226,841,418,2326,128664,8190,492706,0.08853886633817586,153880,552,0.09502848749426634,8798,243,82,153,478,17540,0.01938949306265632,-608,3,161,2,0.14865696353898206,5,10372,0,6207,6886,-1,23465,4165,0.1030345720538558,258961,105081,
1259,0.2631578947368421,226,841,418,2326,128664,8190,492706,0.08853886633817586,153880,552,0.09502848749426634,8798,243,82,153,478,17540,0.01938949306265632,-608,3,161,2,0.14865696353898206,5,10372,0,6207,6886,-1,23465,4165,0.1030345720538558,258961,105081,
1259,0.019444444444444445,226,841,418,2326,128664,8190,492706,0.08853886633817586,153880,552,0.09502848749426634,8798,193,66,7,266,17540,0.01938949306265632,-608,7,127,0,0.11175795643740516,7,10372,0,6207,6886,-7,23465,4165,0.1030345720538558,258961,105081,
1259,0.12730733377852213,226,841,418,2326,128664,8190,492706,0.08853886633817586,153880,552,0.09502848749426634,8798,1573,2045,2972,6590,17540,0.01938949306265632,-608,196,-472,114,0.16842392101221795,327,10372,17,6207,6886,-82,23465,4165,0.1030345720538558,258961,105081,
1259,0.12730733377852213,226,841,418,2326,128664,8190,492706,0.08853886633817586,153880,552,0.09502848749426634,8798,1573,2045,2972,6590,17540,0.01938949306265632,-608,196,-472,114,0.16842392101221795,327,10372,17,6207,6886,-82,23465,4165,0.1030345720538558,258961,105081,
1259,0.12730733377852213,226,841,418,2326,128664,8190,492706,0.08853886633817586,153880,552,0.09502848749426634,8798,1573,2045,2972,6590,17540,0.01938949306265632,-608,196,-472,114,0.16842392101221795,327,10372,17,6207,6886,-82,23465,4165,0.1030345720538558,258961,105081,
1259,0.12730733377852213,226,841,418,2326,128664,8190,492706,0.08853886633817586,153880,552,0.09502848749426634,8798,1573,2045,2972,6590,17540,0.01938949306265632,-608,196,-472,114,0.16842392101221795,327,10372,17,6207,6886,-82,23465,4165,0.1030345720538558,258961,105081,
1259,0.12730733377852213,226,841,418,2326,128664,8190,492706,0.08853886633817586,153880,552,0.09502848749426634,8798,1573,2045,2972,6590,17540,0.01938949306265632,-608,196,-472,114,0.16842392101221795,327,10372,17,6207,6886,-82,23465,4165,0.1030345720538558,258961,105081,
1259,0.12730733377852213,226,841,418,2326,128664,8190,492706,0.08853886633817586,153880,552,0.09502848749426634,8798,1573,2045,2972,6590,17540,0.01938949306265632,-608,196,-472,114,0.16842392101221795,327,10372,17,6207,6886,-82,23465,4165,0.1030345720538558,258961,105081,
1259,0.12730733377852213,226,841,418,2326,128664,8190,492706,0.08853886633817586,153880,552,0.09502848749426634,8798,1573,2045,2972,6590,17540,0.01938949306265632,-608,196,-472,114,0.16842392101221795,327,10372,17,6207,6886,-82,23465,4165,0.1030345720538558,258961,105081,
1259,0.12730733377852213,226,841,418,2326,128664,8190,492706,0.08853886633817586,153880,552,0.09502848749426634,8798,1573,2045,2972,6590,17540,0.01938949306265632,-608,196,-472,114,0.16842392101221795,327,10372,17,6207,6886,-82,23465,4165,0.1030345720538558,258961,105081,
1259,0.12730733377852213,226,841,418,2326,128664,8190,492706,0.08853886633817586,153880,552,0.09502848749426634,8798,1573,2045,2972,6590,17540,0.01938949306265632,-608,196,-472,114,0.16842392101221795,327,10372,17,6207,6886,-82,23465,4165,0.1030345720538558,258961,105081,
1259,0.12730733377852213,226,841,418,2326,128664,8190,492706,0.08853886633817586,153880,552,0.09502848749426634,8798,1573,2045,2972,6590,17540,0.01938949306265632,-608,196,-472,114,0.16842392101221795,327,10372,17,6207,6886,-82,23465,4165,0.1030345720538558,258961,105081,
1259,0.12730733377852213,226,841,418,2326,128664,8190,492706,0.08853886633817586,153880,552,0.09502848749426634,8798,1573,2045,2972,6590,17540,0.01938949306265632,-608,196,-472,114,0.16842392101221795,327,10372,17,6207,6886,-82,23465,4165,0.1030345720538558,258961,105081,
1259,0.12730733377852213,226,841,418,2326,128664,8190,492706,0.08853886633817586,153880,552,0.09502848749426634,8798,1573,2045,2972,6590,17540,0.01938949306265632,-608,196,-472,114,0.16842392101221795,327,10372,17,6207,6886,-82,23465,4165,0.1030345720538558,258961,105081,
1259,0.12730733377852213,226,841,418,2326,128664,8190,492706,0.08853886633817586,153880,552,0.09502848749426634,8798,1573,2045,2972,6590,17540,0.01938949306265632,-608,196,-472,114,0.16842392101221795,327,10372,17,6207,6886,-82,23465,4165,0.1030345720538558,258961,105081,
1259,0.12730733377852213,226,841,418,2326,128664,8190,492706,0.08853886633817586,153880,552,0.09502848749426634,8798,1573,2045,2972,6590,17540,0.01938949306265632,-608,196,-472,114,0.16842392101221795,327,10372,17,6207,6886,-82,23465,4165,0.1030345720538558,258961,105081,
1259,0.12730733377852213,226,841,418,2326,128664,8190,492706,0.08853886633817586,153880,552,0.09502848749426634,8798,1573,2045,2972,6590,17540,0.01938949306265632,-608,196,-472,114,0.16842392101221795,327,10372,17,6207,6886,-82,23465,4165,0.1030345720538558,258961,105081,
1259,0.12730733377852213,226,841,418,2326,128664,8190,492706,0.08853886633817586,153880,552,0.09502848749426634,8798,1573,2045,2972,6590,17540,0.01938949306265632,-608,196,-472,114,0.16842392101221795,327,10372,17,6207,6886,-82,23465,4165,0.1030345720538558,258961,105081,
1259,0.18591078138179587,226,841,418,2326,128664,8190,492706,0.08853886633817586,153880,552,0.09502848749426634,8798,932,117,89,1138,17540,0.01938949306265632,-608,19,815,4,0.1368064445823083,32,10372,9,6207,6886,-15,23465,4165,0.1030345720538558,258961,105081,
1259,0.18591078138179587,226,841,418,2326,128664,8190,492706,0.08853886633817586,153880,552,0.09502848749426634,8798,932,117,89,1138,17540,0.01938949306265632,-608,19,815,4,0.1368064445823083,32,10372,9,6207,6886,-15,23465,4165,0.1030345720538558,258961,105081,
1259,0.18591078138179587,226,841,418,2326,128664,8190,492706,0.08853886633817586,153880,552,0.09502848749426634,8798,932,117,89,1138,17540,0.01938949306265632,-608,19,815,4,0.1368064445823083,32,10372,9,6207,6886,-15,23465,4165,0.1030345720538558,258961,105081,
1259,0.18591078138179587,226,841,418,2326,128664,8190,492706,0.08853886633817586,153880,552,0.09502848749426634,8798,932,117,89,1138,17540,0.01938949306265632,-608,19,815,4,0.1368064445823083,32,10372,9,6207,6886,-15,23465,4165,0.1030345720538558,258961,105081,
1259,0.18591078138179587,226,841,418,2326,128664,8190,492706,0.08853886633817586,153880,552,0.09502848749426634,8798,932,117,89,1138,17540,0.01938949306265632,-608,19,815,4,0.1368064445823083,32,10372,9,6207,6886,-15,23465,4165,0.1030345720538558,258961,105081,
1259,0.18591078138179587,226,841,418,2326,128664,8190,492706,0.08853886633817586,153880,552,0.09502848749426634,8798,932,117,89,1138,17540,0.01938949306265632,-608,19,815,4,0.1368064445823083,32,10372,9,6207,6886,-15,23465,4165,0.1030345720538558,258961,105081,
1259,0.043474817865061764,226,841,418,2326,128664,8190,492706,0.08853886633817586,153880,552,0.09502848749426634,8798,492,128,2,622,17540,0.01938949306265632,-608,8,364,0,0.11388727792682213,8,10372,0,6207,6886,-8,23465,4165,0.1030345720538558,258961,105081,
1259,0.043474817865061764,226,841,418,2326,128664,8190,492706,0.08853886633817586,153880,552,0.09502848749426634,8798,492,128,2,622,17540,0.01938949306265632,-608,8,364,0,0.11388727792682213,8,10372,0,6207,6886,-8,23465,4165,0.1030345720538558,258961,105081,
1259,0.043474817865061764,226,841,418,2326,128664,8190,492706,0.08853886633817586,153880,552,0.09502848749426634,8798,492,128,2,622,17540,0.01938949306265632,-608,8,364,0,0.11388727792682213,8,10372,0,6207,6886,-8,23465,4165,0.1030345720538558,258961,105081,
1259,0.043474817865061764,226,841,418,2326,128664,8190,492706,0.08853886633817586,153880,552,0.09502848749426634,8798,492,128,2,622,17540,0.01938949306265632,-608,8,364,0,0.11388727792682213,8,10372,0,6207,6886,-8,23465,4165,0.1030345720538558,258961,105081,
1259,0.043474817865061764,226,841,418,2326,128664,8190,492706,0.08853886633817586,153880,552,0.09502848749426634,8798,492,128,2,622,17540,0.01938949306265632,-608,8,364,0,0.11388727792682213,8,10372,0,6207,6886,-8,23465,4165,0.1030345720538558,258961,105081,
1259,0.0,226,841,418,2326,128664,8190,492706,0.08853886633817586,153880,552,0.09502848749426634,8798,274,142,778,1194,17540,0.01938949306265632,-608,0,132,0,0.14920486678864722,0,10372,0,6207,6886,0,23465,4165,0.1030345720538558,258961,105081,
1259,0.020768431983385256,226,841,418,2326,128664,8190,492706,0.08853886633817586,153880,552,0.09502848749426634,8798,23,15,581,619,17540,0.01938949306265632,-608,10,8,10,0.044784861842215876,20,10372,0,6207,6886,0,23465,4165,0.1030345720538558,258961,105081,
20,0.33756038647342995,4,202,-182,226,128664,8190,492706,0.0709416906531326,153880,552,0.09502848749426634,8798,585,558,61,1204,17540,0.01938949306265632,-608,115,27,2,0.19062999615921114,117,758,0,713,197,-113,1668,45,0.0762472297060903,258961,105081,
20,0.33756038647342995,4,202,-182,226,128664,8190,492706,0.0709416906531326,153880,552,0.09502848749426634,8798,585,558,61,1204,17540,0.01938949306265632,-608,115,27,2,0.19062999615921114,117,758,0,713,197,-113,1668,45,0.0762472297060903,258961,105081,
20,0.33756038647342995,4,202,-182,226,128664,8190,492706,0.0709416906531326,153880,552,0.09502848749426634,8798,585,558,61,1204,17540,0.01938949306265632,-608,115,27,2,0.19062999615921114,117,758,0,713,197,-113,1668,45,0.0762472297060903,258961,105081,
20,0.14997313875163085,4,202,-182,226,128664,8190,492706,0.0709416906531326,153880,552,0.09502848749426634,8798,125,115,13,253,17540,0.01938949306265632,-608,87,10,12,0.08280814612911395,103,758,4,713,197,-75,1668,45,0.0762472297060903,258961,105081,
20,0.14997313875163085,4,202,-182,226,128664,8190,492706,0.0709416906531326,153880,552,0.09502848749426634,8798,125,115,13,253,17540,0.01938949306265632,-608,87,10,12,0.08280814612911395,103,758,4,713,197,-75,1668,45,0.0762472297060903,258961,105081,
2,0.0,0,2,0,4,128664,8190,492706,0.017777777777777778,153880,552,0.09502848749426634,8798,136,88,20,244,17540,0.01938949306265632,-608,0,48,0,0.16858993773722591,0,613,0,125,62,0,800,488,0.10925764376798437,258961,105081,
2,0.0,0,2,0,4,128664,8190,492706,0.017777777777777778,153880,552,0.09502848749426634,8798,136,88,20,244,17540,0.01938949306265632,-608,0,48,0,0.16858993773722591,0,613,0,125,62,0,800,488,0.10925764376798437,258961,105081,
2,0.0,0,2,0,4,128664,8190,492706,0.017777777777777778,153880,552,0.09502848749426634,8798,136,88,20,244,17540,0.01938949306265632,-608,0,48,0,0.16858993773722591,0,613,0,125,62,0,800,488,0.10925764376798437,258961,105081,
0,0.0,0,0,0,0,128664,8190,492706,0.0,153880,552,0.09502848749426634,8798,133,0,1,134,17540,0.01938949306265632,-608,0,133,0,0.1562815191681171,0,400,0,58,16,0,474,342,0.18236922210014228,258961,105081,
0,0.0,0,0,0,0,128664,8190,492706,0.0,153880,552,0.09502848749426634,8798,160,28,7,195,17540,0.01938949306265632,-608,0,132,0,0.1989422063354126,0,400,0,58,16,0,474,342,0.18236922210014228,258961,105081,
0,0.0,0,0,0,0,128664,8190,492706,0.0,153880,552,0.09502848749426634,8798,160,28,7,195,17540,0.01938949306265632,-608,0,132,0,0.1989422063354126,0,400,0,58,16,0,474,342,0.18236922210014228,258961,105081,
236,0.07142857142857142,14,126,110,376,128664,8190,492706,0.06648661883223204,153880,552,0.09502848749426634,8798,449,23,6,478,17540,0.01938949306265632,-608,1,426,1,0.33237456104073254,2,4875,0,1117,377,0,6369,3758,0.25297790114454805,258961,105081,
236,0.07142857142857142,14,126,110,376,128664,8190,492706,0.06648661883223204,153880,552,0.09502848749426634,8798,449,23,6,478,17540,0.01938949306265632,-608,1,426,1,0.33237456104073254,2,4875,0,1117,377,0,6369,3758,0.25297790114454805,258961,105081,
236,0.07142857142857142,14,126,110,376,128664,8190,492706,0.06648661883223204,153880,552,0.09502848749426634,8798,449,23,6,478,17540,0.01938949306265632,-608,1,426,1,0.33237456104073254,2,4875,0,1117,377,0,6369,3758,0.25297790114454805,258961,105081,
236,0.07142857142857142,14,126,110,376,128664,8190,492706,0.06648661883223204,153880,552,0.09502848749426634,8798,449,23,6,478,17540,0.01938949306265632,-608,1,426,1,0.33237456104073254,2,4875,0,1117,377,0,6369,3758,0.25297790114454805,258961,105081,
236,0.4566929133858268,14,126,110,376,128664,8190,492706,0.06648661883223204,153880,552,0.09502848749426634,8798,209,111,25,345,17540,0.01938949306265632,-608,58,98,58,0.3570924933293205,116,4875,0,1117,377,0,6369,3758,0.25297790114454805,258961,105081,
236,0.4566929133858268,14,126,110,376,128664,8190,492706,0.06648661883223204,153880,552,0.09502848749426634,8798,209,111,25,345,17540,0.01938949306265632,-608,58,98,58,0.3570924933293205,116,4875,0,1117,377,0,6369,3758,0.25297790114454805,258961,105081,
236,0.4566929133858268,14,126,110,376,128664,8190,492706,0.06648661883223204,153880,552,0.09502848749426634,8798,209,111,25,345,17540,0.01938949306265632,-608,58,98,58,0.3570924933293205,116,4875,0,1117,377,0,6369,3758,0.25297790114454805,258961,105081,
236,0.0196078431372549,14,126,110,376,128664,8190,492706,0.06648661883223204,153880,552,0.09502848749426634,8798,426,91,46,563,17540,0.01938949306265632,-608,2,335,1,0.25900647701089297,3,4875,0,1117,377,-1,6369,3758,0.25297790114454805,258961,105081,
236,0.0196078431372549,14,126,110,376,128664,8190,492706,0.06648661883223204,153880,552,0.09502848749426634,8798,426,91,46,563,17540,0.01938949306265632,-608,2,335,1,0.25900647701089297,3,4875,0,1117,377,-1,6369,3758,0.25297790114454805,258961,105081,
236,0.012048192771084338,14,126,110,376,128664,8190,492706,0.06648661883223204,153880,552,0.09502848749426634,8798,250,119,132,501,17540,0.01938949306265632,-608,1,131,1,0.2129197965583855,2,4875,0,1117,377,0,6369,3758,0.25297790114454805,258961,105081,
236,0.012048192771084338,14,126,110,376,128664,8190,492706,0.06648661883223204,153880,552,0.09502848749426634,8798,250,119,132,501,17540,0.01938949306265632,-608,1,131,1,0.2129197965583855,2,4875,0,1117,377,0,6369,3758,0.25297790114454805,258961,105081,
236,0.2579862112718632,14,126,110,376,128664,8190,492706,0.06648661883223204,153880,552,0.09502848749426634,8798,977,155,24,1156,17540,0.01938949306265632,-608,30,822,59,0.2252914341450846,90,4875,1,1117,377,29,6369,3758,0.25297790114454805,258961,105081,
236,0.1099739673698331,14,126,110,376,128664,8190,492706,0.06648661883223204,153880,552,0.09502848749426634,8798,546,213,55,814,17540,0.01938949306265632,-608,3,333,10,0.1682784716048711,14,4875,1,1117,377,7,6369,3758,0.25297790114454805,258961,105081,
236,0.1099739673698331,14,126,110,376,128664,8190,492706,0.06648661883223204,153880,552,0.09502848749426634,8798,546,213,55,814,17540,0.01938949306265632,-608,3,333,10,0.1682784716048711,14,4875,1,1117,377,7,6369,3758,0.25297790114454805,258961,105081,
236,0.2212475633528265,14,126,110,376,128664,8190,492706,0.06648661883223204,153880,552,0.09502848749426634,8798,698,165,25,888,17540,0.01938949306265632,-608,9,533,12,0.1581760765180674,21,4875,0,1117,377,3,6369,3758,0.25297790114454805,258961,105081,
11,0.14925373134328357,0,14,-3,25,128664,8190,492706,0.04142170645393153,153880,552,0.09502848749426634,8798,4,8,0,12,17540,0.01938949306265632,-608,7,-4,3,0.08796019900497512,10,683,0,249,67,-4,999,434,0.15898843475911234,258961,105081,
11,0.0,0,14,-3,25,128664,8190,492706,0.04142170645393153,153880,552,0.09502848749426634,8798,88,5,0,93,17540,0.01938949306265632,-608,0,83,0,0.14549187755961432,0,683,0,249,67,0,999,434,0.15898843475911234,258961,105081,
11,0.0,0,14,-3,25,128664,8190,492706,0.04142170645393153,153880,552,0.09502848749426634,8798,88,5,0,93,17540,0.01938949306265632,-608,0,83,0,0.14549187755961432,0,683,0,249,67,0,999,434,0.15898843475911234,258961,105081,
11,0.0,0,14,-3,25,128664,8190,492706,0.04142170645393153,153880,552,0.09502848749426634,8798,88,5,0,93,17540,0.01938949306265632,-608,0,83,0,0.14549187755961432,0,683,0,249,67,0,999,434,0.15898843475911234,258961,105081,
11,0.018867924528301886,0,14,-3,25,128664,8190,492706,0.04142170645393153,153880,552,0.09502848749426634,8798,222,127,38,387,17540,0.01938949306265632,-608,1,95,1,0.18339252657349348,2,683,0,249,67,0,999,434,0.15898843475911234,258961,105081,
11,0.018867924528301886,0,14,-3,25,128664,8190,492706,0.04142170645393153,153880,552,0.09502848749426634,8798,222,127,38,387,17540,0.01938949306265632,-608,1,95,1,0.18339252657349348,2,683,0,249,67,0,999,434,0.15898843475911234,258961,105081,
11,0.018867924528301886,0,14,-3,25,128664,8190,492706,0.04142170645393153,153880,552,0.09502848749426634,8798,222,127,38,387,17540,0.01938949306265632,-608,1,95,1,0.18339252657349348,2,683,0,249,67,0,999,434,0.15898843475911234,258961,105081,
11,0.018867924528301886,0,14,-3,25,128664,8190,492706,0.04142170645393153,153880,552,0.09502848749426634,8798,222,127,38,387,17540,0.01938949306265632,-608,1,95,1,0.18339252657349348,2,683,0,249,67,0,999,434,0.15898843475911234,258961,105081,
42,0.0,77,54,-12,173,128664,8190,492706,0.03820134570779715,153880,552,0.09502848749426634,8798,207,10,17,234,17540,0.01938949306265632,-608,0,197,0,0.19600391592721564,0,1455,0,343,270,0,2068,1112,0.14348717354900653,258961,105081,
42,0.0,77,54,-12,173,128664,8190,492706,0.03820134570779715,153880,552,0.09502848749426634,8798,207,10,17,234,17540,0.01938949306265632,-608,0,197,0,0.19600391592721564,0,1455,0,343,270,0,2068,1112,0.14348717354900653,258961,105081,
42,0.0,77,54,-12,173,128664,8190,492706,0.03820134570779715,153880,552,0.09502848749426634,8798,33,22,16,71,17540,0.01938949306265632,-608,0,11,0,0.19383238154653357,0,1455,0,343,270,0,2068,1112,0.14348717354900653,258961,105081,
42,0.13560445387062567,77,54,-12,173,128664,8190,492706,0.03820134570779715,153880,552,0.09502848749426634,8798,411,115,126,652,17540,0.01938949306265632,-608,6,296,9,0.2467152391047599,15,1455,0,343,270,3,2068,1112,0.14348717354900653,258961,105081,
42,0.0,77,54,-12,173,128664,8190,492706,0.03820134570779715,153880,552,0.09502848749426634,8798,100,1,0,101,17540,0.01938949306265632,-608,0,99,0,0.06744746554191458,0,1455,0,343,270,0,2068,1112,0.14348717354900653,258961,105081,
