F41,F40,F43,F42,F45,F44,F140,F47,F141,F46,F142,F49,F143,F48,F126,F127,F128,F129,F50,F52,F51,F36,F130,F35,F131,F38,F132,F37,F133,F134,F39,F135,F136,F137,F138,F139,
31,0.010582010582010581,0,27,4,58,6123,1511,169515,0.02560970842764102,55624,116,0.08776028802574044,637,250,22,3,275,2264,0.01950859680346687,874,1,228,1,0.0832744113662188,2,3467,0,1577,454,0,5498,1890,0.1572215012963819,109508,53884,
31,0.010582010582010581,0,27,4,58,6123,1511,169515,0.02560970842764102,55624,116,0.08776028802574044,637,250,22,3,275,2264,0.01950859680346687,874,1,228,1,0.0832744113662188,2,3467,0,1577,454,0,5498,1890,0.1572215012963819,109508,53884,
31,0.010582010582010581,0,27,4,58,6123,1511,169515,0.02560970842764102,55624,116,0.08776028802574044,637,250,22,3,275,2264,0.01950859680346687,874,1,228,1,0.0832744113662188,2,3467,0,1577,454,0,5498,1890,0.1572215012963819,109508,53884,
31,0.010582010582010581,0,27,4,58,6123,1511,169515,0.02560970842764102,55624,116,0.08776028802574044,637,250,22,3,275,2264,0.01950859680346687,874,1,228,1,0.0832744113662188,2,3467,0,1577,454,0,5498,1890,0.1572215012963819,109508,53884,
31,0.010582010582010581,0,27,4,58,6123,1511,169515,0.02560970842764102,55624,116,0.08776028802574044,637,250,22,3,275,2264,0.01950859680346687,874,1,228,1,0.0832744113662188,2,3467,0,1577,454,0,5498,1890,0.1572215012963819,109508,53884,
31,0.010582010582010581,0,27,4,58,6123,1511,169515,0.02560970842764102,55624,116,0.08776028802574044,637,250,22,3,275,2264,0.01950859680346687,874,1,228,1,0.0832744113662188,2,3467,0,1577,454,0,5498,1890,0.1572215012963819,109508,53884,
31,0.07177033492822966,0,27,4,58,6123,1511,169515,0.02560970842764102,55624,116,0.08776028802574044,637,1850,1269,421,3540,2264,0.01950859680346687,874,18,581,3,0.17964486096765284,21,3467,0,1577,454,-15,5498,1890,0.1572215012963819,109508,53884,
31,0.07177033492822966,0,27,4,58,6123,1511,169515,0.02560970842764102,55624,116,0.08776028802574044,637,1850,1269,421,3540,2264,0.01950859680346687,874,18,581,3,0.17964486096765284,21,3467,0,1577,454,-15,5498,1890,0.1572215012963819,109508,53884,
31,0.07177033492822966,0,27,4,58,6123,1511,169515,0.02560970842764102,55624,116,0.08776028802574044,637,1850,1269,421,3540,2264,0.01950859680346687,874,18,581,3,0.17964486096765284,21,3467,0,1577,454,-15,5498,1890,0.1572215012963819,109508,53884,
31,0.0,0,27,4,58,6123,1511,169515,0.02560970842764102,55624,116,0.08776028802574044,637,7,35,0,42,2264,0.01950859680346687,874,0,-28,0,0.015684863779699396,0,3467,0,1577,454,0,5498,1890,0.1572215012963819,109508,53884,
31,0.0,0,27,4,58,6123,1511,169515,0.02560970842764102,55624,116,0.08776028802574044,637,7,35,0,42,2264,0.01950859680346687,874,0,-28,0,0.015684863779699396,0,3467,0,1577,454,0,5498,1890,0.1572215012963819,109508,53884,
31,0.1118421052631579,0,27,4,58,6123,1511,169515,0.02560970842764102,55624,116,0.08776028802574044,637,50,0,0,50,2264,0.01950859680346687,874,0,50,17,0.10213954002653694,17,3467,0,1577,454,17,5498,1890,0.1572215012963819,109508,53884,
31,0.018518518518518517,0,27,4,58,6123,1511,169515,0.02560970842764102,55624,116,0.08776028802574044,637,88,15,0,103,2264,0.01950859680346687,874,0,73,1,0.05903740295329924,1,3467,0,1577,454,1,5498,1890,0.1572215012963819,109508,53884,
31,0.018518518518518517,0,27,4,58,6123,1511,169515,0.02560970842764102,55624,116,0.08776028802574044,637,88,15,0,103,2264,0.01950859680346687,874,0,73,1,0.05903740295329924,1,3467,0,1577,454,1,5498,1890,0.1572215012963819,109508,53884,
31,0.03389830508474576,0,27,4,58,6123,1511,169515,0.02560970842764102,55624,116,0.08776028802574044,637,270,29,1,300,2264,0.01950859680346687,874,3,241,3,0.1970652564402504,6,3467,0,1577,454,0,5498,1890,0.1572215012963819,109508,53884,
2,0.078125,1,3,-1,6,6123,1511,169515,0.007267992424242424,55624,116,0.08776028802574044,637,9,401,0,410,2264,0.01950859680346687,874,3,-392,2,0.021807451653826533,5,1864,0,1563,40,-1,3467,301,0.16953068995004264,109508,53884,
2,0.078125,1,3,-1,6,6123,1511,169515,0.007267992424242424,55624,116,0.08776028802574044,637,9,401,0,410,2264,0.01950859680346687,874,3,-392,2,0.021807451653826533,5,1864,0,1563,40,-1,3467,301,0.16953068995004264,109508,53884,
2,0.078125,1,3,-1,6,6123,1511,169515,0.007267992424242424,55624,116,0.08776028802574044,637,9,401,0,410,2264,0.01950859680346687,874,3,-392,2,0.021807451653826533,5,1864,0,1563,40,-1,3467,301,0.16953068995004264,109508,53884,
2,0.078125,1,3,-1,6,6123,1511,169515,0.007267992424242424,55624,116,0.08776028802574044,637,9,401,0,410,2264,0.01950859680346687,874,3,-392,2,0.021807451653826533,5,1864,0,1563,40,-1,3467,301,0.16953068995004264,109508,53884,
2,0.0,1,3,-1,6,6123,1511,169515,0.007267992424242424,55624,116,0.08776028802574044,637,1,181,0,182,2264,0.01950859680346687,874,0,-180,0,0.2653442284676654,0,1864,0,1563,40,0,3467,301,0.16953068995004264,109508,53884,
2,0.0,1,3,-1,6,6123,1511,169515,0.007267992424242424,55624,116,0.08776028802574044,637,118,6,0,124,2264,0.01950859680346687,874,0,112,0,0.08473959275653681,0,1864,0,1563,40,0,3467,301,0.16953068995004264,109508,53884,
0,0.0,0,0,0,0,6123,1511,169515,0.0,55624,116,0.08776028802574044,637,158,55,0,213,2264,0.01950859680346687,874,0,103,0,0.007943331276139198,0,457,0,303,10,0,770,154,0.054238691994776725,109508,53884,
0,0.0,0,0,0,0,6123,1511,169515,0.0,55624,116,0.08776028802574044,637,115,98,0,213,2264,0.01950859680346687,874,0,17,0,0.08065655796630578,0,275,0,159,0,0,434,116,0.17275000610433783,109508,53884,
0,0.0,0,0,0,0,6123,1511,169515,0.0,55624,116,0.08776028802574044,637,130,54,0,184,2264,0.01950859680346687,874,0,76,0,0.008212482307987054,0,332,0,291,9,0,632,41,0.03787914469591124,109508,53884,
0,0.0,0,0,0,0,6123,1511,169515,0.0,55624,116,0.08776028802574044,637,2990,2212,332,5534,2264,0.01950859680346687,874,0,778,0,0.22618635275935878,0,3293,0,2530,344,0,6167,763,0.20957266484723683,109508,53884,
0,0.0,0,0,0,0,6123,1511,169515,0.0,55624,116,0.08776028802574044,637,137,41,0,178,2264,0.01950859680346687,874,0,96,0,0.3488301845571901,0,3293,0,2530,344,0,6167,763,0.20957266484723683,109508,53884,
0,0.0,0,0,0,0,6123,1511,169515,0.0,55624,116,0.08776028802574044,637,39,121,5,165,2264,0.01950859680346687,874,0,-82,0,0.06555272187857629,0,365,0,511,12,0,888,-146,0.08107343154565338,109508,53884,
0,0.0,0,0,0,0,6123,1511,169515,0.0,55624,116,0.08776028802574044,637,76,23,0,99,2264,0.01950859680346687,874,0,53,0,0.14208659988548406,0,365,0,511,12,0,888,-146,0.08107343154565338,109508,53884,
0,0.0,0,0,0,0,6123,1511,169515,0.0,55624,116,0.08776028802574044,637,50,73,2,125,2264,0.01950859680346687,874,0,-23,0,0.07102611886366837,0,365,0,511,12,0,888,-146,0.08107343154565338,109508,53884,
46,0.0,0,44,2,90,6123,1511,169515,0.0803164055370969,55624,116,0.08776028802574044,637,392,13,0,405,2264,0.01950859680346687,874,0,379,0,0.2006289444314065,0,2174,0,1482,24,0,3680,692,0.21290070547583864,109508,53884,
46,0.0,0,44,2,90,6123,1511,169515,0.0803164055370969,55624,116,0.08776028802574044,637,392,13,0,405,2264,0.01950859680346687,874,0,379,0,0.2006289444314065,0,2174,0,1482,24,0,3680,692,0.21290070547583864,109508,53884,
46,0.0,0,44,2,90,6123,1511,169515,0.0803164055370969,55624,116,0.08776028802574044,637,171,0,0,171,2264,0.01950859680346687,874,0,171,0,0.3895466627014368,0,2174,0,1482,24,0,3680,692,0.21290070547583864,109508,53884,
46,0.0,0,44,2,90,6123,1511,169515,0.0803164055370969,55624,116,0.08776028802574044,637,171,0,0,171,2264,0.01950859680346687,874,0,171,0,0.3895466627014368,0,2174,0,1482,24,0,3680,692,0.21290070547583864,109508,53884,
46,0.13043478260869565,0,44,2,90,6123,1511,169515,0.0803164055370969,55624,116,0.08776028802574044,637,336,321,0,657,2264,0.01950859680346687,874,2,15,1,0.1717485014871094,3,2174,0,1482,24,-1,3680,692,0.21290070547583864,109508,53884,
14,0.0,2,10,4,26,6123,1511,169515,0.00866089273817455,55624,116,0.08776028802574044,637,291,342,1,634,2264,0.01950859680346687,874,0,-51,0,0.1143056178790373,0,2295,0,2308,132,0,4735,-13,0.07598672708974488,109508,53884,
14,0.0,2,10,4,26,6123,1511,169515,0.00866089273817455,55624,116,0.08776028802574044,637,291,342,1,634,2264,0.01950859680346687,874,0,-51,0,0.1143056178790373,0,2295,0,2308,132,0,4735,-13,0.07598672708974488,109508,53884,
14,0.0,2,10,4,26,6123,1511,169515,0.00866089273817455,55624,116,0.08776028802574044,637,291,342,1,634,2264,0.01950859680346687,874,0,-51,0,0.1143056178790373,0,2295,0,2308,132,0,4735,-13,0.07598672708974488,109508,53884,
14,0.0,2,10,4,26,6123,1511,169515,0.00866089273817455,55624,116,0.08776028802574044,637,291,342,1,634,2264,0.01950859680346687,874,0,-51,0,0.1143056178790373,0,2295,0,2308,132,0,4735,-13,0.07598672708974488,109508,53884,
14,0.0,2,10,4,26,6123,1511,169515,0.00866089273817455,55624,116,0.08776028802574044,637,291,342,1,634,2264,0.01950859680346687,874,0,-51,0,0.1143056178790373,0,2295,0,2308,132,0,4735,-13,0.07598672708974488,109508,53884,
14,0.16455696202531644,2,10,4,26,6123,1511,169515,0.00866089273817455,55624,116,0.08776028802574044,637,1123,723,111,1957,2264,0.01950859680346687,874,10,400,14,0.2115529621613964,26,2295,2,2308,132,4,4735,-13,0.07598672708974488,109508,53884,
14,0.16455696202531644,2,10,4,26,6123,1511,169515,0.00866089273817455,55624,116,0.08776028802574044,637,1123,723,111,1957,2264,0.01950859680346687,874,10,400,14,0.2115529621613964,26,2295,2,2308,132,4,4735,-13,0.07598672708974488,109508,53884,
14,0.16455696202531644,2,10,4,26,6123,1511,169515,0.00866089273817455,55624,116,0.08776028802574044,637,1123,723,111,1957,2264,0.01950859680346687,874,10,400,14,0.2115529621613964,26,2295,2,2308,132,4,4735,-13,0.07598672708974488,109508,53884,
14,0.16455696202531644,2,10,4,26,6123,1511,169515,0.00866089273817455,55624,116,0.08776028802574044,637,1123,723,111,1957,2264,0.01950859680346687,874,10,400,14,0.2115529621613964,26,2295,2,2308,132,4,4735,-13,0.07598672708974488,109508,53884,
14,0.0,2,10,4,26,6123,1511,169515,0.00866089273817455,55624,116,0.08776028802574044,637,0,0,0,0,2264,0.01950859680346687,874,0,0,0,0.0,0,2295,0,2308,132,0,4735,-13,0.07598672708974488,109508,53884,
14,0.0,2,10,4,26,6123,1511,169515,0.00866089273817455,55624,116,0.08776028802574044,637,0,0,0,0,2264,0.01950859680346687,874,0,0,0,0.0,0,2295,0,2308,132,0,4735,-13,0.07598672708974488,109508,53884,
14,0.0,2,10,4,26,6123,1511,169515,0.00866089273817455,55624,116,0.08776028802574044,637,28,64,0,92,2264,0.01950859680346687,874,0,-36,0,0.014425594200176393,0,2295,0,2308,132,0,4735,-13,0.07598672708974488,109508,53884,
14,0.0,2,10,4,26,6123,1511,169515,0.00866089273817455,55624,116,0.08776028802574044,637,28,64,0,92,2264,0.01950859680346687,874,0,-36,0,0.013862259551244255,0,2295,0,2308,132,0,4735,-13,0.07598672708974488,109508,53884,
14,0.0,2,10,4,26,6123,1511,169515,0.00866089273817455,55624,116,0.08776028802574044,637,0,0,0,0,2264,0.01950859680346687,874,0,0,0,0.0,0,2295,0,2308,132,0,4735,-13,0.07598672708974488,109508,53884,
14,0.0,2,10,4,26,6123,1511,169515,0.00866089273817455,55624,116,0.08776028802574044,637,0,0,0,0,2264,0.01950859680346687,874,0,0,0,0.0,0,2295,0,2308,132,0,4735,-13,0.07598672708974488,109508,53884,
14,0.0,2,10,4,26,6123,1511,169515,0.00866089273817455,55624,116,0.08776028802574044,637,0,0,0,0,2264,0.01950859680346687,874,0,0,0,0.0,0,2295,0,2308,132,0,4735,-13,0.07598672708974488,109508,53884,
0,0.0,0,0,0,0,6123,1511,169515,0.0,55624,116,0.08776028802574044,637,0,0,0,0,2264,0.01950859680346687,874,0,0,0,0.0,0,0,0,0,0,0,0,0,0.0,109508,53884,
0,0.0,0,0,0,0,6123,1511,169515,0.0,55624,116,0.08776028802574044,637,0,0,0,0,2264,0.01950859680346687,874,0,0,0,0.0,0,0,0,0,0,0,0,0,0.0,109508,53884,
0,0.0,0,0,0,0,6123,1511,169515,0.0,55624,116,0.08776028802574044,637,0,0,0,0,2264,0.01950859680346687,874,0,0,0,0.0,0,0,0,0,0,0,0,0,0.0,109508,53884,
0,0.0,0,0,0,0,6123,1511,169515,0.0,55624,116,0.08776028802574044,637,0,0,0,0,2264,0.01950859680346687,874,0,0,0,0.0,0,0,0,0,0,0,0,0,0.0,109508,53884,
0,0.0,0,0,0,0,6123,1511,169515,0.0,55624,116,0.08776028802574044,637,0,0,0,0,2264,0.01950859680346687,874,0,0,0,0.0,0,0,0,0,0,0,0,0,0.0,109508,53884,
0,0.0,0,0,0,0,6123,1511,169515,0.0,55624,116,0.08776028802574044,637,0,0,0,0,2264,0.01950859680346687,874,0,0,0,0.0,0,0,0,0,0,0,0,0,0.0,109508,53884,
0,0.0,0,0,0,0,6123,1511,169515,0.0,55624,116,0.08776028802574044,637,0,0,0,0,2264,0.01950859680346687,874,0,0,0,0.0,0,0,0,0,0,0,0,0,0.0,109508,53884,
0,0.0,0,0,0,0,6123,1511,169515,0.0,55624,116,0.08776028802574044,637,0,0,0,0,2264,0.01950859680346687,874,0,0,0,0.0,0,0,0,0,0,0,0,0,0.0,109508,53884,
0,0.0,0,0,0,0,6123,1511,169515,0.0,55624,116,0.08776028802574044,637,0,0,0,0,2264,0.01950859680346687,874,0,0,0,0.0,0,0,0,0,0,0,0,0,0.0,109508,53884,
0,0.0,0,0,0,0,6123,1511,169515,0.0,55624,116,0.08776028802574044,637,0,0,0,0,2264,0.01950859680346687,874,0,0,0,0.0,0,0,0,0,0,0,0,0,0.0,109508,53884,
0,0.0,0,0,0,0,6123,1511,169515,0.0,55624,116,0.08776028802574044,637,0,0,0,0,2264,0.01950859680346687,874,0,0,0,0.0,0,0,0,0,0,0,0,0,0.0,109508,53884,
0,0.0,0,0,0,0,6123,1511,169515,0.0,55624,116,0.08776028802574044,637,0,0,0,0,2264,0.01950859680346687,874,0,0,0,0.0,0,0,0,0,0,0,0,0,0.0,109508,53884,
0,0.0,0,0,0,0,6123,1511,169515,0.0,55624,116,0.08776028802574044,637,0,0,0,0,2264,0.01950859680346687,874,0,0,0,0.0,0,0,0,0,0,0,0,0,0.0,109508,53884,
0,0.0,0,0,0,0,6123,1511,169515,0.0,55624,116,0.08776028802574044,637,0,0,0,0,2264,0.01950859680346687,874,0,0,0,0.0,0,0,0,0,0,0,0,0,0.0,109508,53884,
0,0.0,0,0,0,0,6123,1511,169515,0.0,55624,116,0.08776028802574044,637,0,0,0,0,2264,0.01950859680346687,874,0,0,0,0.0,0,0,0,0,0,0,0,0,0.0,109508,53884,
0,0.0,0,0,0,0,6123,1511,169515,0.0,55624,116,0.08776028802574044,637,0,0,0,0,2264,0.01950859680346687,874,0,0,0,0.0,0,0,0,0,0,0,0,0,0.0,109508,53884,
0,0.0,0,0,0,0,6123,1511,169515,0.0,55624,116,0.08776028802574044,637,0,0,0,0,2264,0.01950859680346687,874,0,0,0,0.0,0,0,0,0,0,0,0,0,0.0,109508,53884,
0,0.0,0,0,0,0,6123,1511,169515,0.0,55624,116,0.08776028802574044,637,0,0,0,0,2264,0.01950859680346687,874,0,0,0,0.0,0,0,0,0,0,0,0,0,0.0,109508,53884,
16,0.0,0,8,8,24,6123,1511,169515,0.012744200244200246,55624,116,0.08776028802574044,637,273,312,7,592,2264,0.01950859680346687,874,0,-39,0,0.09315508231351231,0,4926,0,3565,301,0,8792,1361,0.09477547286105155,109508,53884,
16,0.0,0,8,8,24,6123,1511,169515,0.012744200244200246,55624,116,0.08776028802574044,637,273,312,7,592,2264,0.01950859680346687,874,0,-39,0,0.09315508231351231,0,4926,0,3565,301,0,8792,1361,0.09477547286105155,109508,53884,
16,0.0,0,8,8,24,6123,1511,169515,0.012744200244200246,55624,116,0.08776028802574044,637,273,312,7,592,2264,0.01950859680346687,874,0,-39,0,0.09315508231351231,0,4926,0,3565,301,0,8792,1361,0.09477547286105155,109508,53884,
16,0.0,0,8,8,24,6123,1511,169515,0.012744200244200246,55624,116,0.08776028802574044,637,466,222,3,691,2264,0.01950859680346687,874,0,244,0,0.07022924769281688,0,4926,0,3565,301,0,8792,1361,0.09477547286105155,109508,53884,
16,0.16190476190476188,0,8,8,24,6123,1511,169515,0.012744200244200246,55624,116,0.08776028802574044,637,1167,651,148,1966,2264,0.01950859680346687,874,5,516,5,0.1423143306988607,10,4926,0,3565,301,0,8792,1361,0.09477547286105155,109508,53884,
16,0.16190476190476188,0,8,8,24,6123,1511,169515,0.012744200244200246,55624,116,0.08776028802574044,637,1167,651,148,1966,2264,0.01950859680346687,874,5,516,5,0.1423143306988607,10,4926,0,3565,301,0,8792,1361,0.09477547286105155,109508,53884,
16,0.0,0,8,8,24,6123,1511,169515,0.012744200244200246,55624,116,0.08776028802574044,637,23,0,0,23,2264,0.01950859680346687,874,0,23,0,0.18288116901020124,0,4926,0,3565,301,0,8792,1361,0.09477547286105155,109508,53884,
16,0.0,0,8,8,24,6123,1511,169515,0.012744200244200246,55624,116,0.08776028802574044,637,23,0,0,23,2264,0.01950859680346687,874,0,23,0,0.18288116901020124,0,4926,0,3565,301,0,8792,1361,0.09477547286105155,109508,53884,
16,0.0,0,8,8,24,6123,1511,169515,0.012744200244200246,55624,116,0.08776028802574044,637,130,72,0,202,2264,0.01950859680346687,874,0,58,0,0.09890652034618763,0,4926,0,3565,301,0,8792,1361,0.09477547286105155,109508,53884,
0,0.0,0,0,0,0,6123,1511,169515,0.0,55624,116,0.08776028802574044,637,42,0,0,42,2264,0.01950859680346687,874,0,42,0,0.2978723404255319,0,841,0,853,3,0,1697,-12,0.1755589864456512,109508,53884,
0,0.0,0,0,0,0,6123,1511,169515,0.0,55624,116,0.08776028802574044,637,43,111,0,154,2264,0.01950859680346687,874,0,-68,0,0.08328430659958604,0,841,0,853,3,0,1697,-12,0.1755589864456512,109508,53884,
0,0.0,0,0,0,0,6123,1511,169515,0.0,55624,116,0.08776028802574044,637,42,0,0,42,2264,0.01950859680346687,874,0,42,0,0.20095693779904306,0,841,0,853,3,0,1697,-12,0.1755589864456512,109508,53884,
0,0.0,0,0,0,0,6123,1511,169515,0.0,55624,116,0.08776028802574044,637,0,386,0,386,2264,0.01950859680346687,874,0,-386,0,0.012229269072708956,0,21,0,462,0,0,483,-441,0.018129516389291615,109508,53884,
0,0.0,0,0,0,0,6123,1511,169515,0.0,55624,116,0.08776028802574044,637,0,386,0,386,2264,0.01950859680346687,874,0,-386,0,0.012229269072708956,0,21,0,462,0,0,483,-441,0.018129516389291615,109508,53884,
0,0.0,0,0,0,0,6123,1511,169515,0.0,55624,116,0.08776028802574044,637,0,386,0,386,2264,0.01950859680346687,874,0,-386,0,0.012229269072708956,0,21,0,462,0,0,483,-441,0.018129516389291615,109508,53884,
0,0.0,0,0,0,0,6123,1511,169515,0.0,55624,116,0.08776028802574044,637,0,386,0,386,2264,0.01950859680346687,874,0,-386,0,0.012229269072708956,0,21,0,462,0,0,483,-441,0.018129516389291615,109508,53884,
2,0.06666666666666667,1,1,1,4,6123,1511,169515,0.014428526799660819,55624,116,0.08776028802574044,637,758,3,2,763,2264,0.01950859680346687,874,0,755,0,0.1030464548794355,1,4284,1,1681,19,0,5984,2603,0.13093710822439075,109508,53884,
2,0.06666666666666667,1,1,1,4,6123,1511,169515,0.014428526799660819,55624,116,0.08776028802574044,637,758,3,2,763,2264,0.01950859680346687,874,0,755,0,0.1030464548794355,1,4284,1,1681,19,0,5984,2603,0.13093710822439075,109508,53884,
2,0.06666666666666667,1,1,1,4,6123,1511,169515,0.014428526799660819,55624,116,0.08776028802574044,637,758,3,2,763,2264,0.01950859680346687,874,0,755,0,0.1030464548794355,1,4284,1,1681,19,0,5984,2603,0.13093710822439075,109508,53884,
2,0.0,1,1,1,4,6123,1511,169515,0.014428526799660819,55624,116,0.08776028802574044,637,82,1,0,83,2264,0.01950859680346687,874,0,81,0,0.09699166548106748,0,4284,0,1681,19,0,5984,2603,0.13093710822439075,109508,53884,
2,0.0,1,1,1,4,6123,1511,169515,0.014428526799660819,55624,116,0.08776028802574044,637,82,1,0,83,2264,0.01950859680346687,874,0,81,0,0.09699166548106748,0,4284,0,1681,19,0,5984,2603,0.13093710822439075,109508,53884,
43,0.0,6,41,2,90,6123,1511,169515,0.08665572298940785,55624,116,0.08776028802574044,637,307,130,2,439,2264,0.01950859680346687,874,0,177,0,0.12278541783853555,0,3414,0,1100,279,0,4793,2314,0.19562642647323625,109508,53884,
43,0.17391304347826086,6,41,2,90,6123,1511,169515,0.08665572298940785,55624,116,0.08776028802574044,637,84,4,0,88,2264,0.01950859680346687,874,2,80,2,0.3542038912050824,4,3414,0,1100,279,0,4793,2314,0.19562642647323625,109508,53884,
43,0.012968515742128935,6,41,2,90,6123,1511,169515,0.08665572298940785,55624,116,0.08776028802574044,637,979,389,36,1404,2264,0.01950859680346687,874,2,590,2,0.1751793456400951,4,3414,0,1100,279,0,4793,2314,0.19562642647323625,109508,53884,
43,0.15974133273724161,6,41,2,90,6123,1511,169515,0.08665572298940785,55624,116,0.08776028802574044,637,2044,577,241,2862,2264,0.01950859680346687,874,37,1467,39,0.130337051209232,82,3414,6,1100,279,2,4793,2314,0.19562642647323625,109508,53884,
29,0.1320754716981132,0,1,28,30,6123,1511,169515,0.07114884696016771,55624,116,0.08776028802574044,637,6,1,0,7,2264,0.01950859680346687,874,1,5,6,0.1320754716981132,7,29,0,1,0,5,30,28,0.07114884696016771,109508,53884,
0,0.0,0,0,0,0,6123,1511,169515,0.0,55624,116,0.08776028802574044,637,10,0,0,10,2264,0.01950859680346687,874,0,10,0,0.0847457627118644,0,223,0,0,0,0,223,223,0.24820277195655086,109508,53884,
0,0.0,0,0,0,0,6123,1511,169515,0.0,55624,116,0.08776028802574044,637,10,0,0,10,2264,0.01950859680346687,874,0,10,0,0.0847457627118644,0,223,0,0,0,0,223,223,0.24820277195655086,109508,53884,
0,0.0,0,0,0,0,6123,1511,169515,0.0,55624,116,0.08776028802574044,637,10,0,0,10,2264,0.01950859680346687,874,0,10,0,0.0847457627118644,0,223,0,0,0,0,223,223,0.24820277195655086,109508,53884,
0,0.0,0,0,0,0,6123,1511,169515,0.0,55624,116,0.08776028802574044,637,10,0,0,10,2264,0.01950859680346687,874,0,10,0,0.0847457627118644,0,223,0,0,0,0,223,223,0.24820277195655086,109508,53884,
0,0.0,0,0,0,0,6123,1511,169515,0.0,55624,116,0.08776028802574044,637,10,0,0,10,2264,0.01950859680346687,874,0,10,0,0.0847457627118644,0,223,0,0,0,0,223,223,0.24820277195655086,109508,53884,
0,0.0,0,0,0,0,6123,1511,169515,0.0,55624,116,0.08776028802574044,637,10,0,0,10,2264,0.01950859680346687,874,0,10,0,0.0847457627118644,0,223,0,0,0,0,223,223,0.24820277195655086,109508,53884,
24,0.0,0,19,5,43,6123,1511,169515,0.015904364202079753,55624,116,0.08776028802574044,637,887,378,81,1346,2264,0.01950859680346687,874,0,509,0,0.14709065631245363,0,2667,0,1472,143,0,4282,1195,0.15561487500078464,109508,53884,
24,0.0,0,19,5,43,6123,1511,169515,0.015904364202079753,55624,116,0.08776028802574044,637,887,378,81,1346,2264,0.01950859680346687,874,0,509,0,0.14709065631245363,0,2667,0,1472,143,0,4282,1195,0.15561487500078464,109508,53884,
1,0.0,0,1,0,2,6123,1511,169515,3.9872408293460925E-4,55624,116,0.08776028802574044,637,314,52,1,367,2264,0.01950859680346687,874,0,262,0,0.1504390512930149,0,1652,0,562,59,0,2273,1090,0.0337059715005736,109508,53884,
24,0.0,0,19,5,43,6123,1511,169515,0.015904364202079753,55624,116,0.08776028802574044,637,7,2,0,9,2264,0.01950859680346687,874,0,5,0,0.13246268656716417,0,2667,0,1472,143,0,4282,1195,0.15561487500078464,109508,53884,
23,0.0,0,2,21,25,6123,1511,169515,0.021934710991314766,55624,116,0.08776028802574044,637,47,32,19,98,2264,0.01950859680346687,874,0,15,0,0.13514079737466833,0,5400,0,5758,1855,0,13013,-358,0.09872449615463465,109508,53884,
23,0.0,0,2,21,25,6123,1511,169515,0.021934710991314766,55624,116,0.08776028802574044,637,47,32,19,98,2264,0.01950859680346687,874,0,15,0,0.13514079737466833,0,5400,0,5758,1855,0,13013,-358,0.09872449615463465,109508,53884,
23,0.0,0,2,21,25,6123,1511,169515,0.021934710991314766,55624,116,0.08776028802574044,637,0,15,0,15,2264,0.01950859680346687,874,0,-15,0,0.03355704697986577,0,5400,0,5758,1855,0,13013,-358,0.09872449615463465,109508,53884,
23,0.0,0,2,21,25,6123,1511,169515,0.021934710991314766,55624,116,0.08776028802574044,637,17,0,0,17,2264,0.01950859680346687,874,0,17,0,0.20481927710843373,0,5400,0,5758,1855,0,13013,-358,0.09872449615463465,109508,53884,
77,0.04185351270553064,5,37,40,119,6123,1511,169515,0.01239415524303707,55624,116,0.08776028802574044,637,4002,2117,207,6326,2264,0.01950859680346687,874,11,1885,15,0.1568150977671448,28,21807,2,8643,1091,4,31541,13164,0.0822281554749713,109508,53884,
23,0.0,0,2,21,25,6123,1511,169515,0.021934710991314766,55624,116,0.08776028802574044,637,477,314,61,852,2264,0.01950859680346687,874,0,163,0,0.11141988852003262,0,5400,0,5758,1855,0,13013,-358,0.09872449615463465,109508,53884,
23,0.0,0,2,21,25,6123,1511,169515,0.021934710991314766,55624,116,0.08776028802574044,637,477,314,61,852,2264,0.01950859680346687,874,0,163,0,0.11141988852003262,0,5400,0,5758,1855,0,13013,-358,0.09872449615463465,109508,53884,
23,0.0,0,2,21,25,6123,1511,169515,0.021934710991314766,55624,116,0.08776028802574044,637,477,314,61,852,2264,0.01950859680346687,874,0,163,0,0.11141988852003262,0,5400,0,5758,1855,0,13013,-358,0.09872449615463465,109508,53884,
23,0.0,0,2,21,25,6123,1511,169515,0.021934710991314766,55624,116,0.08776028802574044,637,477,314,61,852,2264,0.01950859680346687,874,0,163,0,0.11141988852003262,0,5400,0,5758,1855,0,13013,-358,0.09872449615463465,109508,53884,
23,0.0,0,2,21,25,6123,1511,169515,0.021934710991314766,55624,116,0.08776028802574044,637,477,314,61,852,2264,0.01950859680346687,874,0,163,0,0.11141988852003262,0,5400,0,5758,1855,0,13013,-358,0.09872449615463465,109508,53884,
23,0.0,0,2,21,25,6123,1511,169515,0.021934710991314766,55624,116,0.08776028802574044,637,477,314,61,852,2264,0.01950859680346687,874,0,163,0,0.11141988852003262,0,5400,0,5758,1855,0,13013,-358,0.09872449615463465,109508,53884,
23,0.0,0,2,21,25,6123,1511,169515,0.021934710991314766,55624,116,0.08776028802574044,637,477,314,61,852,2264,0.01950859680346687,874,0,163,0,0.11141988852003262,0,5400,0,5758,1855,0,13013,-358,0.09872449615463465,109508,53884,
23,0.0,0,2,21,25,6123,1511,169515,0.021934710991314766,55624,116,0.08776028802574044,637,477,314,61,852,2264,0.01950859680346687,874,0,163,0,0.11141988852003262,0,5400,0,5758,1855,0,13013,-358,0.09872449615463465,109508,53884,
73,0.0,3,54,19,130,6123,1511,169515,0.01919060039252721,55624,116,0.08776028802574044,637,15,11,0,26,2264,0.01950859680346687,874,0,4,0,0.012196557742491815,0,2569,0,650,60,0,3279,1919,0.042657028285136435,109508,53884,
73,0.0,3,54,19,130,6123,1511,169515,0.01919060039252721,55624,116,0.08776028802574044,637,44,15,0,59,2264,0.01950859680346687,874,0,29,0,0.025125338369296018,0,2569,0,650,60,0,3279,1919,0.042657028285136435,109508,53884,
73,0.011494252873563218,3,54,19,130,6123,1511,169515,0.01919060039252721,55624,116,0.08776028802574044,637,1,0,0,1,2264,0.01950859680346687,874,0,1,1,0.011494252873563218,1,2569,0,650,60,1,3279,1919,0.042657028285136435,109508,53884,
73,0.011494252873563218,3,54,19,130,6123,1511,169515,0.01919060039252721,55624,116,0.08776028802574044,637,1,0,0,1,2264,0.01950859680346687,874,0,1,1,0.011494252873563218,1,2569,0,650,60,1,3279,1919,0.042657028285136435,109508,53884,
73,0.011494252873563218,3,54,19,130,6123,1511,169515,0.01919060039252721,55624,116,0.08776028802574044,637,1,0,0,1,2264,0.01950859680346687,874,0,1,1,0.011494252873563218,1,2569,0,650,60,1,3279,1919,0.042657028285136435,109508,53884,
73,0.013793103448275862,3,54,19,130,6123,1511,169515,0.01919060039252721,55624,116,0.08776028802574044,637,3,3,0,6,2264,0.01950859680346687,874,2,0,2,0.0127445049405122,4,2569,0,650,60,0,3279,1919,0.042657028285136435,109508,53884,
73,0.0,3,54,19,130,6123,1511,169515,0.01919060039252721,55624,116,0.08776028802574044,637,47,0,0,47,2264,0.01950859680346687,874,0,47,0,0.002504796418674057,0,2569,0,650,60,0,3279,1919,0.042657028285136435,109508,53884,
73,0.044444444444444446,3,54,19,130,6123,1511,169515,0.01919060039252721,55624,116,0.08776028802574044,637,69,6,1,76,2264,0.01950859680346687,874,1,63,1,0.01544543188187493,2,2569,0,650,60,0,3279,1919,0.042657028285136435,109508,53884,
73,0.0,3,54,19,130,6123,1511,169515,0.01919060039252721,55624,116,0.08776028802574044,637,163,21,2,186,2264,0.01950859680346687,874,0,142,0,0.07784071769292017,0,2569,0,650,60,0,3279,1919,0.042657028285136435,109508,53884,
73,0.02,3,54,19,130,6123,1511,169515,0.01919060039252721,55624,116,0.08776028802574044,637,2,6,1,9,2264,0.01950859680346687,874,1,-4,0,0.056252282623964034,1,2569,0,650,60,-1,3279,1919,0.042657028285136435,109508,53884,
73,0.029702194357366773,3,54,19,130,6123,1511,169515,0.01919060039252721,55624,116,0.08776028802574044,637,168,96,4,268,2264,0.01950859680346687,874,3,72,4,0.07562229744398005,7,2569,0,650,60,1,3279,1919,0.042657028285136435,109508,53884,
73,0.029702194357366773,3,54,19,130,6123,1511,169515,0.01919060039252721,55624,116,0.08776028802574044,637,168,96,4,268,2264,0.01950859680346687,874,3,72,4,0.07562229744398005,7,2569,0,650,60,1,3279,1919,0.042657028285136435,109508,53884,
73,0.018691588785046728,3,54,19,130,6123,1511,169515,0.01919060039252721,55624,116,0.08776028802574044,637,97,8,0,105,2264,0.01950859680346687,874,0,89,2,0.008745602447700495,2,2569,0,650,60,2,3279,1919,0.042657028285136435,109508,53884,
73,0.018691588785046728,3,54,19,130,6123,1511,169515,0.01919060039252721,55624,116,0.08776028802574044,637,97,8,0,105,2264,0.01950859680346687,874,0,89,2,0.008745602447700495,2,2569,0,650,60,2,3279,1919,0.042657028285136435,109508,53884,
73,0.012195121951219513,3,54,19,130,6123,1511,169515,0.01919060039252721,55624,116,0.08776028802574044,637,26,21,0,47,2264,0.01950859680346687,874,1,5,0,0.005683530789476692,1,2569,0,650,60,-1,3279,1919,0.042657028285136435,109508,53884,
73,0.012195121951219513,3,54,19,130,6123,1511,169515,0.01919060039252721,55624,116,0.08776028802574044,637,26,21,0,47,2264,0.01950859680346687,874,1,5,0,0.005683530789476692,1,2569,0,650,60,-1,3279,1919,0.042657028285136435,109508,53884,
73,0.012195121951219513,3,54,19,130,6123,1511,169515,0.01919060039252721,55624,116,0.08776028802574044,637,26,21,0,47,2264,0.01950859680346687,874,1,5,0,0.005683530789476692,1,2569,0,650,60,-1,3279,1919,0.042657028285136435,109508,53884,
73,0.06711409395973154,3,54,19,130,6123,1511,169515,0.01919060039252721,55624,116,0.08776028802574044,637,251,5,0,256,2264,0.01950859680346687,874,5,246,5,0.21324655552843472,10,2569,0,650,60,0,3279,1919,0.042657028285136435,109508,53884,
73,0.0,3,54,19,130,6123,1511,169515,0.01919060039252721,55624,116,0.08776028802574044,637,17,12,0,29,2264,0.01950859680346687,874,0,5,0,0.003358611132496728,0,2569,0,650,60,0,3279,1919,0.042657028285136435,109508,53884,
73,0.0,3,54,19,130,6123,1511,169515,0.01919060039252721,55624,116,0.08776028802574044,637,17,12,0,29,2264,0.01950859680346687,874,0,5,0,0.003358611132496728,0,2569,0,650,60,0,3279,1919,0.042657028285136435,109508,53884,
73,0.0,3,54,19,130,6123,1511,169515,0.01919060039252721,55624,116,0.08776028802574044,637,17,12,0,29,2264,0.01950859680346687,874,0,5,0,0.003358611132496728,0,2569,0,650,60,0,3279,1919,0.042657028285136435,109508,53884,
73,0.0,3,54,19,130,6123,1511,169515,0.01919060039252721,55624,116,0.08776028802574044,637,17,12,0,29,2264,0.01950859680346687,874,0,5,0,0.003358611132496728,0,2569,0,650,60,0,3279,1919,0.042657028285136435,109508,53884,
73,0.0,3,54,19,130,6123,1511,169515,0.01919060039252721,55624,116,0.08776028802574044,637,17,12,0,29,2264,0.01950859680346687,874,0,5,0,0.003358611132496728,0,2569,0,650,60,0,3279,1919,0.042657028285136435,109508,53884,
73,0.0,3,54,19,130,6123,1511,169515,0.01919060039252721,55624,116,0.08776028802574044,637,0,1,0,1,2264,0.01950859680346687,874,0,-1,0,0.005376344086021506,0,2569,0,650,60,0,3279,1919,0.042657028285136435,109508,53884,
73,0.0,3,54,19,130,6123,1511,169515,0.01919060039252721,55624,116,0.08776028802574044,637,0,1,0,1,2264,0.01950859680346687,874,0,-1,0,0.005376344086021506,0,2569,0,650,60,0,3279,1919,0.042657028285136435,109508,53884,
73,0.0,3,54,19,130,6123,1511,169515,0.01919060039252721,55624,116,0.08776028802574044,637,0,1,0,1,2264,0.01950859680346687,874,0,-1,0,0.005376344086021506,0,2569,0,650,60,0,3279,1919,0.042657028285136435,109508,53884,
73,0.0,3,54,19,130,6123,1511,169515,0.01919060039252721,55624,116,0.08776028802574044,637,0,1,0,1,2264,0.01950859680346687,874,0,-1,0,0.005376344086021506,0,2569,0,650,60,0,3279,1919,0.042657028285136435,109508,53884,
73,0.0,3,54,19,130,6123,1511,169515,0.01919060039252721,55624,116,0.08776028802574044,637,0,1,0,1,2264,0.01950859680346687,874,0,-1,0,0.005376344086021506,0,2569,0,650,60,0,3279,1919,0.042657028285136435,109508,53884,
73,0.0,3,54,19,130,6123,1511,169515,0.01919060039252721,55624,116,0.08776028802574044,637,0,1,0,1,2264,0.01950859680346687,874,0,-1,0,0.005376344086021506,0,2569,0,650,60,0,3279,1919,0.042657028285136435,109508,53884,
73,0.0,3,54,19,130,6123,1511,169515,0.01919060039252721,55624,116,0.08776028802574044,637,0,1,0,1,2264,0.01950859680346687,874,0,-1,0,0.005376344086021506,0,2569,0,650,60,0,3279,1919,0.042657028285136435,109508,53884,
1,0.0,0,0,1,1,6123,1511,169515,5.602240896358543E-4,55624,116,0.08776028802574044,637,35,0,0,35,2264,0.01950859680346687,874,0,35,0,0.0016315495058735782,0,795,0,14,1,0,810,781,0.008140965532572226,109508,53884,
1,0.0,0,0,1,1,6123,1511,169515,5.602240896358543E-4,55624,116,0.08776028802574044,637,31,0,0,31,2264,0.01950859680346687,874,0,31,0,0.001437847866419295,0,795,0,14,1,0,810,781,0.008140965532572226,109508,53884,
1,0.0,0,0,1,1,6123,1511,169515,5.602240896358543E-4,55624,116,0.08776028802574044,637,65,1,0,66,2264,0.01950859680346687,874,0,64,0,0.0017728057681651863,0,795,0,14,1,0,810,781,0.008140965532572226,109508,53884,
1,0.0,0,0,1,1,6123,1511,169515,5.602240896358543E-4,55624,116,0.08776028802574044,637,167,1,0,168,2264,0.01950859680346687,874,0,166,0,0.0075652388392821604,0,795,0,14,1,0,810,781,0.008140965532572226,109508,53884,
0,0.0,0,0,0,0,6123,1511,169515,0.0,55624,116,0.08776028802574044,637,103,23,5,131,2264,0.01950859680346687,874,0,80,0,0.07741504676142742,0,272,0,51,7,0,330,221,0.04604760736015886,109508,53884,
0,0.0,0,0,0,0,6123,1511,169515,0.0,55624,116,0.08776028802574044,637,103,23,5,131,2264,0.01950859680346687,874,0,80,0,0.07741504676142742,0,272,0,51,7,0,330,221,0.04604760736015886,109508,53884,
0,0.0,0,0,0,0,6123,1511,169515,0.0,55624,116,0.08776028802574044,637,0,0,0,0,2264,0.01950859680346687,874,0,0,0,0.0,0,1480,0,37,0,0,1517,1443,0.015068377378745402,109508,53884,
0,0.0,0,0,0,0,6123,1511,169515,0.0,55624,116,0.08776028802574044,637,0,0,0,0,2264,0.01950859680346687,874,0,0,0,0.0,0,1480,0,37,0,0,1517,1443,0.015068377378745402,109508,53884,
0,0.0,0,0,0,0,6123,1511,169515,0.0,55624,116,0.08776028802574044,637,40,1,0,41,2264,0.01950859680346687,874,0,39,0,0.25025125628140704,0,1480,0,37,0,0,1517,1443,0.015068377378745402,109508,53884,
0,0.0,0,0,0,0,6123,1511,169515,0.0,55624,116,0.08776028802574044,637,0,0,0,0,2264,0.01950859680346687,874,0,0,0,0.0,0,1480,0,37,0,0,1517,1443,0.015068377378745402,109508,53884,
0,0.0,0,0,0,0,6123,1511,169515,0.0,55624,116,0.08776028802574044,637,40,1,0,41,2264,0.01950859680346687,874,0,39,0,0.14209372188095593,0,1480,0,37,0,0,1517,1443,0.015068377378745402,109508,53884,
0,0.0,0,0,0,0,6123,1511,169515,0.0,55624,116,0.08776028802574044,637,0,0,0,0,2264,0.01950859680346687,874,0,0,0,0.0,0,1480,0,37,0,0,1517,1443,0.015068377378745402,109508,53884,
0,0.0,0,0,0,0,6123,1511,169515,0.0,55624,116,0.08776028802574044,637,40,1,0,41,2264,0.01950859680346687,874,0,39,0,0.0992581631549451,0,1480,0,37,0,0,1517,1443,0.015068377378745402,109508,53884,
0,0.0,0,0,0,0,6123,1511,169515,0.0,55624,116,0.08776028802574044,637,40,1,0,41,2264,0.01950859680346687,874,0,39,0,0.07629241908422447,0,1480,0,37,0,0,1517,1443,0.015068377378745402,109508,53884,
0,0.0,0,0,0,0,6123,1511,169515,0.0,55624,116,0.08776028802574044,637,0,0,0,0,2264,0.01950859680346687,874,0,0,0,0.0,0,1480,0,37,0,0,1517,1443,0.015068377378745402,109508,53884,
0,0.0,0,0,0,0,6123,1511,169515,0.0,55624,116,0.08776028802574044,637,0,0,0,0,2264,0.01950859680346687,874,0,0,0,0.0,0,1480,0,37,0,0,1517,1443,0.015068377378745402,109508,53884,
0,0.0,0,0,0,0,6123,1511,169515,0.0,55624,116,0.08776028802574044,637,0,0,0,0,2264,0.01950859680346687,874,0,0,0,0.0,0,1480,0,37,0,0,1517,1443,0.015068377378745402,109508,53884,
0,0.0,0,0,0,0,6123,1511,169515,0.0,55624,116,0.08776028802574044,637,0,0,0,0,2264,0.01950859680346687,874,0,0,0,0.0,0,1480,0,37,0,0,1517,1443,0.015068377378745402,109508,53884,
0,0.0,0,0,0,0,6123,1511,169515,0.0,55624,116,0.08776028802574044,637,40,1,0,41,2264,0.01950859680346687,874,0,39,0,0.06197373362895116,0,1480,0,37,0,0,1517,1443,0.015068377378745402,109508,53884,
0,0.0,0,0,0,0,6123,1511,169515,0.0,55624,116,0.08776028802574044,637,0,0,0,0,2264,0.01950859680346687,874,0,0,0,0.0,0,1480,0,37,0,0,1517,1443,0.015068377378745402,109508,53884,
0,0.0,0,0,0,0,6123,1511,169515,0.0,55624,116,0.08776028802574044,637,40,1,0,41,2264,0.01950859680346687,874,0,39,0,0.05219195438707634,0,1480,0,37,0,0,1517,1443,0.015068377378745402,109508,53884,
0,0.0,0,0,0,0,6123,1511,169515,0.0,55624,116,0.08776028802574044,637,0,0,0,0,2264,0.01950859680346687,874,0,0,0,0.0,0,1480,0,37,0,0,1517,1443,0.015068377378745402,109508,53884,
0,0.0,0,0,0,0,6123,1511,169515,0.0,55624,116,0.08776028802574044,637,0,0,0,0,2264,0.01950859680346687,874,0,0,0,0.0,0,1480,0,37,0,0,1517,1443,0.015068377378745402,109508,53884,
0,0.0,0,0,0,0,6123,1511,169515,0.0,55624,116,0.08776028802574044,637,40,1,0,41,2264,0.01950859680346687,874,0,39,0,0.04508553235354242,0,1480,0,37,0,0,1517,1443,0.015068377378745402,109508,53884,
0,0.0,0,0,0,0,6123,1511,169515,0.0,55624,116,0.08776028802574044,637,0,0,0,0,2264,0.01950859680346687,874,0,0,0,0.0,0,1480,0,37,0,0,1517,1443,0.015068377378745402,109508,53884,
0,0.0,0,0,0,0,6123,1511,169515,0.0,55624,116,0.08776028802574044,637,0,0,0,0,2264,0.01950859680346687,874,0,0,0,0.0,0,1480,0,37,0,0,1517,1443,0.015068377378745402,109508,53884,
0,0.0,0,0,0,0,6123,1511,169515,0.0,55624,116,0.08776028802574044,637,40,1,0,41,2264,0.01950859680346687,874,0,39,0,0.03968881179399687,0,1480,0,37,0,0,1517,1443,0.015068377378745402,109508,53884,
0,0.0,0,0,0,0,6123,1511,169515,0.0,55624,116,0.08776028802574044,637,40,1,0,41,2264,0.01950859680346687,874,0,39,0,0.03545096079834713,0,1480,0,37,0,0,1517,1443,0.015068377378745402,109508,53884,
0,0.0,0,0,0,0,6123,1511,169515,0.0,55624,116,0.08776028802574044,637,0,0,0,0,2264,0.01950859680346687,874,0,0,0,0.0,0,1480,0,37,0,0,1517,1443,0.015068377378745402,109508,53884,
0,0.0,0,0,0,0,6123,1511,169515,0.0,55624,116,0.08776028802574044,637,0,0,0,0,2264,0.01950859680346687,874,0,0,0,0.0,0,1480,0,37,0,0,1517,1443,0.015068377378745402,109508,53884,
0,0.0,0,0,0,0,6123,1511,169515,0.0,55624,116,0.08776028802574044,637,0,0,0,0,2264,0.01950859680346687,874,0,0,0,0.0,0,1480,0,37,0,0,1517,1443,0.015068377378745402,109508,53884,
0,0.0,0,0,0,0,6123,1511,169515,0.0,55624,116,0.08776028802574044,637,40,1,0,41,2264,0.01950859680346687,874,0,39,0,0.0320348245963678,0,1480,0,37,0,0,1517,1443,0.015068377378745402,109508,53884,
0,0.0,0,0,0,0,6123,1511,169515,0.0,55624,116,0.08776028802574044,637,40,1,0,41,2264,0.01950859680346687,874,0,39,0,0.0320348245963678,0,1480,0,37,0,0,1517,1443,0.015068377378745402,109508,53884,
0,0.0,0,0,0,0,6123,1511,169515,0.0,55624,116,0.08776028802574044,637,0,0,0,0,2264,0.01950859680346687,874,0,0,0,0.0,0,1480,0,37,0,0,1517,1443,0.015068377378745402,109508,53884,
0,0.0,0,0,0,0,6123,1511,169515,0.0,55624,116,0.08776028802574044,637,0,0,0,0,2264,0.01950859680346687,874,0,0,0,0.0,0,1480,0,37,0,0,1517,1443,0.015068377378745402,109508,53884,
0,0.0,0,0,0,0,6123,1511,169515,0.0,55624,116,0.08776028802574044,637,40,1,0,41,2264,0.01950859680346687,874,0,39,0,0.02922247407102136,0,1480,0,37,0,0,1517,1443,0.015068377378745402,109508,53884,
0,0.0,0,0,0,0,6123,1511,169515,0.0,55624,116,0.08776028802574044,637,0,0,0,0,2264,0.01950859680346687,874,0,0,0,0.0,0,1480,0,37,0,0,1517,1443,0.015068377378745402,109508,53884,
0,0.0,0,0,0,0,6123,1511,169515,0.0,55624,116,0.08776028802574044,637,40,1,0,41,2264,0.01950859680346687,874,0,39,0,0.026866785222593562,0,1480,0,37,0,0,1517,1443,0.015068377378745402,109508,53884,
0,0.0,0,0,0,0,6123,1511,169515,0.0,55624,116,0.08776028802574044,637,0,0,0,0,2264,0.01950859680346687,874,0,0,0,0.0,0,1480,0,37,0,0,1517,1443,0.015068377378745402,109508,53884,
0,0.0,0,0,0,0,6123,1511,169515,0.0,55624,116,0.08776028802574044,637,40,1,0,41,2264,0.01950859680346687,874,0,39,0,0.024864843652614717,0,1480,0,37,0,0,1517,1443,0.015068377378745402,109508,53884,
0,0.0,0,0,0,0,6123,1511,169515,0.0,55624,116,0.08776028802574044,637,0,0,0,0,2264,0.01950859680346687,874,0,0,0,0.0,0,1480,0,37,0,0,1517,1443,0.015068377378745402,109508,53884,
0,0.0,0,0,0,0,6123,1511,169515,0.0,55624,116,0.08776028802574044,637,40,1,0,41,2264,0.01950859680346687,874,0,39,0,0.023142499057891876,0,1480,0,37,0,0,1517,1443,0.015068377378745402,109508,53884,
0,0.0,0,0,0,0,6123,1511,169515,0.0,55624,116,0.08776028802574044,637,40,1,0,41,2264,0.01950859680346687,874,0,39,0,0.023142499057891876,0,1480,0,37,0,0,1517,1443,0.015068377378745402,109508,53884,
0,0.0,0,0,0,0,6123,1511,169515,0.0,55624,116,0.08776028802574044,637,0,0,0,0,2264,0.01950859680346687,874,0,0,0,0.0,0,1480,0,37,0,0,1517,1443,0.015068377378745402,109508,53884,
0,0.0,0,0,0,0,6123,1511,169515,0.0,55624,116,0.08776028802574044,637,0,0,0,0,2264,0.01950859680346687,874,0,0,0,0.0,0,1480,0,37,0,0,1517,1443,0.015068377378745402,109508,53884,
0,0.0,0,0,0,0,6123,1511,169515,0.0,55624,116,0.08776028802574044,637,0,0,0,0,2264,0.01950859680346687,874,0,0,0,0.0,0,1480,0,37,0,0,1517,1443,0.015068377378745402,109508,53884,
0,0.0,0,0,0,0,6123,1511,169515,0.0,55624,116,0.08776028802574044,637,0,0,0,0,2264,0.01950859680346687,874,0,0,0,0.0,0,1480,0,37,0,0,1517,1443,0.015068377378745402,109508,53884,
0,0.0,0,0,0,0,6123,1511,169515,0.0,55624,116,0.08776028802574044,637,0,0,0,0,2264,0.01950859680346687,874,0,0,0,0.0,0,1480,0,37,0,0,1517,1443,0.015068377378745402,109508,53884,
0,0.0,0,0,0,0,6123,1511,169515,0.0,55624,116,0.08776028802574044,637,40,1,0,41,2264,0.01950859680346687,874,0,39,0,0.021644972246091927,0,1480,0,37,0,0,1517,1443,0.015068377378745402,109508,53884,
0,0.0,0,0,0,0,6123,1511,169515,0.0,55624,116,0.08776028802574044,637,0,0,0,0,2264,0.01950859680346687,874,0,0,0,0.0,0,1480,0,37,0,0,1517,1443,0.015068377378745402,109508,53884,
0,0.0,0,0,0,0,6123,1511,169515,0.0,55624,116,0.08776028802574044,637,40,1,0,41,2264,0.01950859680346687,874,0,39,0,0.020330917259106594,0,1480,0,37,0,0,1517,1443,0.015068377378745402,109508,53884,
0,0.0,0,0,0,0,6123,1511,169515,0.0,55624,116,0.08776028802574044,637,0,0,0,0,2264,0.01950859680346687,874,0,0,0,0.0,0,1480,0,37,0,0,1517,1443,0.015068377378745402,109508,53884,
0,0.0,0,0,0,0,6123,1511,169515,0.0,55624,116,0.08776028802574044,637,40,1,0,41,2264,0.01950859680346687,874,0,39,0,0.019168541510429685,0,1480,0,37,0,0,1517,1443,0.015068377378745402,109508,53884,
0,0.0,0,0,0,0,6123,1511,169515,0.0,55624,116,0.08776028802574044,637,0,0,0,0,2264,0.01950859680346687,874,0,0,0,0.0,0,1480,0,37,0,0,1517,1443,0.015068377378745402,109508,53884,
0,0.0,0,0,0,0,6123,1511,169515,0.0,55624,116,0.08776028802574044,637,0,0,0,0,2264,0.01950859680346687,874,0,0,0,0.0,0,1480,0,37,0,0,1517,1443,0.015068377378745402,109508,53884,
0,0.0,0,0,0,0,6123,1511,169515,0.0,55624,116,0.08776028802574044,637,0,0,0,0,2264,0.01950859680346687,874,0,0,0,0.0,0,1480,0,37,0,0,1517,1443,0.015068377378745402,109508,53884,
0,0.0,0,0,0,0,6123,1511,169515,0.0,55624,116,0.08776028802574044,637,0,0,0,0,2264,0.01950859680346687,874,0,0,0,0.0,0,1480,0,37,0,0,1517,1443,0.015068377378745402,109508,53884,
0,0.0,0,0,0,0,6123,1511,169515,0.0,55624,116,0.08776028802574044,637,0,0,0,0,2264,0.01950859680346687,874,0,0,0,0.0,0,1480,0,37,0,0,1517,1443,0.015068377378745402,109508,53884,
0,0.0,0,0,0,0,6123,1511,169515,0.0,55624,116,0.08776028802574044,637,40,1,0,41,2264,0.01950859680346687,874,0,39,0,0.01813299721140671,0,1480,0,37,0,0,1517,1443,0.015068377378745402,109508,53884,
0,0.0,0,0,0,0,6123,1511,169515,0.0,55624,116,0.08776028802574044,637,0,0,0,0,2264,0.01950859680346687,874,0,0,0,0.0,0,1480,0,37,0,0,1517,1443,0.015068377378745402,109508,53884,
0,0.0,0,0,0,0,6123,1511,169515,0.0,55624,116,0.08776028802574044,637,40,1,0,41,2264,0.01950859680346687,874,0,39,0,0.017204583271121975,0,1480,0,37,0,0,1517,1443,0.015068377378745402,109508,53884,
0,0.0,0,0,0,0,6123,1511,169515,0.0,55624,116,0.08776028802574044,637,0,0,0,0,2264,0.01950859680346687,874,0,0,0,0.0,0,1480,0,37,0,0,1517,1443,0.015068377378745402,109508,53884,
0,0.0,0,0,0,0,6123,1511,169515,0.0,55624,116,0.08776028802574044,637,40,1,0,41,2264,0.01950859680346687,874,0,39,0,0.016367478354151338,0,1480,0,37,0,0,1517,1443,0.015068377378745402,109508,53884,
0,0.0,0,0,0,0,6123,1511,169515,0.0,55624,116,0.08776028802574044,637,0,0,0,0,2264,0.01950859680346687,874,0,0,0,0.0,0,1480,0,37,0,0,1517,1443,0.015068377378745402,109508,53884,
0,0.0,0,0,0,0,6123,1511,169515,0.0,55624,116,0.08776028802574044,637,40,1,0,41,2264,0.01950859680346687,874,0,39,0,0.015608830631252157,0,1480,0,37,0,0,1517,1443,0.015068377378745402,109508,53884,
0,0.0,0,0,0,0,6123,1511,169515,0.0,55624,116,0.08776028802574044,637,0,0,0,0,2264,0.01950859680346687,874,0,0,0,0.0,0,1480,0,37,0,0,1517,1443,0.015068377378745402,109508,53884,
0,0.0,0,0,0,0,6123,1511,169515,0.0,55624,116,0.08776028802574044,637,0,0,0,0,2264,0.01950859680346687,874,0,0,0,0.0,0,1480,0,37,0,0,1517,1443,0.015068377378745402,109508,53884,
0,0.0,0,0,0,0,6123,1511,169515,0.0,55624,116,0.08776028802574044,637,0,0,0,0,2264,0.01950859680346687,874,0,0,0,0.0,0,1480,0,37,0,0,1517,1443,0.015068377378745402,109508,53884,
0,0.0,0,0,0,0,6123,1511,169515,0.0,55624,116,0.08776028802574044,637,0,0,0,0,2264,0.01950859680346687,874,0,0,0,0.0,0,1480,0,37,0,0,1517,1443,0.015068377378745402,109508,53884,
0,0.0,0,0,0,0,6123,1511,169515,0.0,55624,116,0.08776028802574044,637,0,0,0,0,2264,0.01950859680346687,874,0,0,0,0.0,0,1480,0,37,0,0,1517,1443,0.015068377378745402,109508,53884,
0,0.0,0,0,0,0,6123,1511,169515,0.0,55624,116,0.08776028802574044,637,0,0,0,0,2264,0.01950859680346687,874,0,0,0,0.0,0,1480,0,37,0,0,1517,1443,0.015068377378745402,109508,53884,
0,0.0,0,0,0,0,6123,1511,169515,0.0,55624,116,0.08776028802574044,637,40,1,0,41,2264,0.01950859680346687,874,0,39,0,0.014918092314186254,0,1480,0,37,0,0,1517,1443,0.015068377378745402,109508,53884,
0,0.0,0,0,0,0,6123,1511,169515,0.0,55624,116,0.08776028802574044,637,0,0,0,0,2264,0.01950859680346687,874,0,0,0,0.0,0,1480,0,37,0,0,1517,1443,0.015068377378745402,109508,53884,
0,0.0,0,0,0,0,6123,1511,169515,0.0,55624,116,0.08776028802574044,637,40,1,0,41,2264,0.01950859680346687,874,0,39,0,0.01428652547058082,0,1480,0,37,0,0,1517,1443,0.015068377378745402,109508,53884,
0,0.0,0,0,0,0,6123,1511,169515,0.0,55624,116,0.08776028802574044,637,0,0,0,0,2264,0.01950859680346687,874,0,0,0,0.0,0,1480,0,37,0,0,1517,1443,0.015068377378745402,109508,53884,
0,0.0,0,0,0,0,6123,1511,169515,0.0,55624,116,0.08776028802574044,637,0,0,0,0,2264,0.01950859680346687,874,0,0,0,0.0,0,1480,0,37,0,0,1517,1443,0.015068377378745402,109508,53884,
0,0.0,0,0,0,0,6123,1511,169515,0.0,55624,116,0.08776028802574044,637,40,1,0,41,2264,0.01950859680346687,874,0,39,0,0.013706829802188856,0,1480,0,37,0,0,1517,1443,0.015068377378745402,109508,53884,
0,0.0,0,0,0,0,6123,1511,169515,0.0,55624,116,0.08776028802574044,637,0,0,0,0,2264,0.01950859680346687,874,0,0,0,0.0,0,1480,0,37,0,0,1517,1443,0.015068377378745402,109508,53884,
0,0.0,0,0,0,0,6123,1511,169515,0.0,55624,116,0.08776028802574044,637,0,0,0,0,2264,0.01950859680346687,874,0,0,0,0.0,0,1480,0,37,0,0,1517,1443,0.015068377378745402,109508,53884,
0,0.0,0,0,0,0,6123,1511,169515,0.0,55624,116,0.08776028802574044,637,40,1,0,41,2264,0.01950859680346687,874,0,39,0,0.01317285865703485,0,1480,0,37,0,0,1517,1443,0.015068377378745402,109508,53884,
0,0.0,0,0,0,0,6123,1511,169515,0.0,55624,116,0.08776028802574044,637,40,1,0,41,2264,0.01950859680346687,874,0,39,0,0.012679399801384864,0,1480,0,37,0,0,1517,1443,0.015068377378745402,109508,53884,
0,0.0,0,0,0,0,6123,1511,169515,0.0,55624,116,0.08776028802574044,637,40,1,0,41,2264,0.01950859680346687,874,0,39,0,0.012679399801384864,0,1480,0,37,0,0,1517,1443,0.015068377378745402,109508,53884,
0,0.0,0,0,0,0,6123,1511,169515,0.0,55624,116,0.08776028802574044,637,40,1,0,41,2264,0.01950859680346687,874,0,39,0,0.012679399801384864,0,1480,0,37,0,0,1517,1443,0.015068377378745402,109508,53884,
0,0.0,0,0,0,0,6123,1511,169515,0.0,55624,116,0.08776028802574044,637,0,0,0,0,2264,0.01950859680346687,874,0,0,0,0.0,0,1480,0,37,0,0,1517,1443,0.015068377378745402,109508,53884,
0,0.0,0,0,0,0,6123,1511,169515,0.0,55624,116,0.08776028802574044,637,40,1,0,41,2264,0.01950859680346687,874,0,39,0,0.012222004353435553,0,1480,0,37,0,0,1517,1443,0.015068377378745402,109508,53884,
0,0.0,0,0,0,0,6123,1511,169515,0.0,55624,116,0.08776028802574044,637,0,0,0,0,2264,0.01950859680346687,874,0,0,0,0.0,0,1480,0,37,0,0,1517,1443,0.015068377378745402,109508,53884,
0,0.0,0,0,0,0,6123,1511,169515,0.0,55624,116,0.08776028802574044,637,0,0,0,0,2264,0.01950859680346687,874,0,0,0,0.0,0,1480,0,37,0,0,1517,1443,0.015068377378745402,109508,53884,
0,0.0,0,0,0,0,6123,1511,169515,0.0,55624,116,0.08776028802574044,637,40,1,0,41,2264,0.01950859680346687,874,0,39,0,0.01179685197075879,0,1480,0,37,0,0,1517,1443,0.015068377378745402,109508,53884,
0,0.0,0,0,0,0,6123,1511,169515,0.0,55624,116,0.08776028802574044,637,0,0,0,0,2264,0.01950859680346687,874,0,0,0,0.0,0,1480,0,37,0,0,1517,1443,0.015068377378745402,109508,53884,
0,0.0,0,0,0,0,6123,1511,169515,0.0,55624,116,0.08776028802574044,637,40,1,0,41,2264,0.01950859680346687,874,0,39,0,0.011400643633586671,0,1480,0,37,0,0,1517,1443,0.015068377378745402,109508,53884,
0,0.0,0,0,0,0,6123,1511,169515,0.0,55624,116,0.08776028802574044,637,0,0,0,0,2264,0.01950859680346687,874,0,0,0,0.0,0,1480,0,37,0,0,1517,1443,0.015068377378745402,109508,53884,
0,0.0,0,0,0,0,6123,1511,169515,0.0,55624,116,0.08776028802574044,637,0,0,0,0,2264,0.01950859680346687,874,0,0,0,0.0,0,1480,0,37,0,0,1517,1443,0.015068377378745402,109508,53884,
0,0.0,0,0,0,0,6123,1511,169515,0.0,55624,116,0.08776028802574044,637,0,0,0,0,2264,0.01950859680346687,874,0,0,0,0.0,0,1480,0,37,0,0,1517,1443,0.015068377378745402,109508,53884,
0,0.0,0,0,0,0,6123,1511,169515,0.0,55624,116,0.08776028802574044,637,40,1,0,41,2264,0.01950859680346687,874,0,39,0,0.011030515651074426,0,1480,0,37,0,0,1517,1443,0.015068377378745402,109508,53884,
0,0.0,0,0,0,0,6123,1511,169515,0.0,55624,116,0.08776028802574044,637,0,0,0,0,2264,0.01950859680346687,874,0,0,0,0.0,0,1480,0,37,0,0,1517,1443,0.015068377378745402,109508,53884,
0,0.0,0,0,0,0,6123,1511,169515,0.0,55624,116,0.08776028802574044,637,0,0,0,0,2264,0.01950859680346687,874,0,0,0,0.0,0,1480,0,37,0,0,1517,1443,0.015068377378745402,109508,53884,
0,0.0,0,0,0,0,6123,1511,169515,0.0,55624,116,0.08776028802574044,637,40,1,0,41,2264,0.01950859680346687,874,0,39,0,0.010683970145928484,0,1480,0,37,0,0,1517,1443,0.015068377378745402,109508,53884,
0,0.0,0,0,0,0,6123,1511,169515,0.0,55624,116,0.08776028802574044,637,0,0,0,0,2264,0.01950859680346687,874,0,0,0,0.0,0,1480,0,37,0,0,1517,1443,0.015068377378745402,109508,53884,
0,0.0,0,0,0,0,6123,1511,169515,0.0,55624,116,0.08776028802574044,637,0,0,0,0,2264,0.01950859680346687,874,0,0,0,0.0,0,1480,0,37,0,0,1517,1443,0.015068377378745402,109508,53884,
0,0.0,0,0,0,0,6123,1511,169515,0.0,55624,116,0.08776028802574044,637,40,1,0,41,2264,0.01950859680346687,874,0,39,0,0.010358818447505767,0,1480,0,37,0,0,1517,1443,0.015068377378745402,109508,53884,
0,0.0,0,0,0,0,6123,1511,169515,0.0,55624,116,0.08776028802574044,637,0,0,0,0,2264,0.01950859680346687,874,0,0,0,0.0,0,1480,0,37,0,0,1517,1443,0.015068377378745402,109508,53884,
0,0.0,0,0,0,0,6123,1511,169515,0.0,55624,116,0.08776028802574044,637,0,0,0,0,2264,0.01950859680346687,874,0,0,0,0.0,0,1480,0,37,0,0,1517,1443,0.015068377378745402,109508,53884,
0,0.0,0,0,0,0,6123,1511,169515,0.0,55624,116,0.08776028802574044,637,0,0,0,0,2264,0.01950859680346687,874,0,0,0,0.0,0,1480,0,37,0,0,1517,1443,0.015068377378745402,109508,53884,
0,0.0,0,0,0,0,6123,1511,169515,0.0,55624,116,0.08776028802574044,637,0,0,0,0,2264,0.01950859680346687,874,0,0,0,0.0,0,1480,0,37,0,0,1517,1443,0.015068377378745402,109508,53884,
0,0.0,0,0,0,0,6123,1511,169515,0.0,55624,116,0.08776028802574044,637,0,0,0,0,2264,0.01950859680346687,874,0,0,0,0.0,0,1480,0,37,0,0,1517,1443,0.015068377378745402,109508,53884,
0,0.0,0,0,0,0,6123,1511,169515,0.0,55624,116,0.08776028802574044,637,40,1,0,41,2264,0.01950859680346687,874,0,39,0,0.01005313468082707,0,1480,0,37,0,0,1517,1443,0.015068377378745402,109508,53884,
0,0.0,0,0,0,0,6123,1511,169515,0.0,55624,116,0.08776028802574044,637,40,1,0,41,2264,0.01950859680346687,874,0,39,0,0.0097652174714021,0,1480,0,37,0,0,1517,1443,0.015068377378745402,109508,53884,
0,0.0,0,0,0,0,6123,1511,169515,0.0,55624,116,0.08776028802574044,637,40,1,0,41,2264,0.01950859680346687,874,0,39,0,0.0097652174714021,0,1480,0,37,0,0,1517,1443,0.015068377378745402,109508,53884,
0,0.0,0,0,0,0,6123,1511,169515,0.0,55624,116,0.08776028802574044,637,0,0,0,0,2264,0.01950859680346687,874,0,0,0,0.0,0,1480,0,37,0,0,1517,1443,0.015068377378745402,109508,53884,
0,0.0,0,0,0,0,6123,1511,169515,0.0,55624,116,0.08776028802574044,637,0,0,0,0,2264,0.01950859680346687,874,0,0,0,0.0,0,1480,0,37,0,0,1517,1443,0.015068377378745402,109508,53884,
0,0.0,0,0,0,0,6123,1511,169515,0.0,55624,116,0.08776028802574044,637,0,0,0,0,2264,0.01950859680346687,874,0,0,0,0.0,0,1480,0,37,0,0,1517,1443,0.015068377378745402,109508,53884,
0,0.0,0,0,0,0,6123,1511,169515,0.0,55624,116,0.08776028802574044,637,40,1,0,41,2264,0.01950859680346687,874,0,39,0,0.009493558157021907,0,1480,0,37,0,0,1517,1443,0.015068377378745402,109508,53884,
0,0.0,0,0,0,0,6123,1511,169515,0.0,55624,116,0.08776028802574044,637,0,0,0,0,2264,0.01950859680346687,874,0,0,0,0.0,0,1480,0,37,0,0,1517,1443,0.015068377378745402,109508,53884,
0,0.0,0,0,0,0,6123,1511,169515,0.0,55624,116,0.08776028802574044,637,40,1,0,41,2264,0.01950859680346687,874,0,39,0,0.009236814252128545,0,1480,0,37,0,0,1517,1443,0.015068377378745402,109508,53884,
0,0.0,0,0,0,0,6123,1511,169515,0.0,55624,116,0.08776028802574044,637,0,0,0,0,2264,0.01950859680346687,874,0,0,0,0.0,0,1480,0,37,0,0,1517,1443,0.015068377378745402,109508,53884,
0,0.0,0,0,0,0,6123,1511,169515,0.0,55624,116,0.08776028802574044,637,40,1,0,41,2264,0.01950859680346687,874,0,39,0,0.00899378717932717,0,1480,0,37,0,0,1517,1443,0.015068377378745402,109508,53884,
99,0.19248826291079812,2,78,21,179,6123,1511,169515,0.011605710553057359,55624,116,0.08776028802574044,637,502,369,32,903,2264,0.01950859680346687,874,55,133,66,0.21991468324744887,123,1925,2,578,60,11,2563,1347,0.09260093435628738,109508,53884,
99,0.19248826291079812,2,78,21,179,6123,1511,169515,0.011605710553057359,55624,116,0.08776028802574044,637,502,369,32,903,2264,0.01950859680346687,874,55,133,66,0.21991468324744887,123,1925,2,578,60,11,2563,1347,0.09260093435628738,109508,53884,
99,0.19248826291079812,2,78,21,179,6123,1511,169515,0.011605710553057359,55624,116,0.08776028802574044,637,502,369,32,903,2264,0.01950859680346687,874,55,133,66,0.21991468324744887,123,1925,2,578,60,11,2563,1347,0.09260093435628738,109508,53884,
99,0.19248826291079812,2,78,21,179,6123,1511,169515,0.011605710553057359,55624,116,0.08776028802574044,637,502,369,32,903,2264,0.01950859680346687,874,55,133,66,0.21991468324744887,123,1925,2,578,60,11,2563,1347,0.09260093435628738,109508,53884,
99,0.19248826291079812,2,78,21,179,6123,1511,169515,0.011605710553057359,55624,116,0.08776028802574044,637,502,369,32,903,2264,0.01950859680346687,874,55,133,66,0.21991468324744887,123,1925,2,578,60,11,2563,1347,0.09260093435628738,109508,53884,
99,0.0,2,78,21,179,6123,1511,169515,0.011605710553057359,55624,116,0.08776028802574044,637,74,11,0,85,2264,0.01950859680346687,874,0,63,0,0.1027924944812362,0,1925,0,578,60,0,2563,1347,0.09260093435628738,109508,53884,
99,0.0,2,78,21,179,6123,1511,169515,0.011605710553057359,55624,116,0.08776028802574044,637,74,11,0,85,2264,0.01950859680346687,874,0,63,0,0.1027924944812362,0,1925,0,578,60,0,2563,1347,0.09260093435628738,109508,53884,
99,0.005891016200294551,2,78,21,179,6123,1511,169515,0.011605710553057359,55624,116,0.08776028802574044,637,90,62,11,163,2264,0.01950859680346687,874,1,28,3,0.060963553272874074,4,1925,0,578,60,2,2563,1347,0.09260093435628738,109508,53884,
99,0.0,2,78,21,179,6123,1511,169515,0.011605710553057359,55624,116,0.08776028802574044,637,73,0,0,73,2264,0.01950859680346687,874,0,73,0,0.3507142857142857,0,1925,0,578,60,0,2563,1347,0.09260093435628738,109508,53884,
99,0.0,2,78,21,179,6123,1511,169515,0.011605710553057359,55624,116,0.08776028802574044,637,73,0,0,73,2264,0.01950859680346687,874,0,73,0,0.3507142857142857,0,1925,0,578,60,0,2563,1347,0.09260093435628738,109508,53884,
99,0.0,2,78,21,179,6123,1511,169515,0.011605710553057359,55624,116,0.08776028802574044,637,73,0,0,73,2264,0.01950859680346687,874,0,73,0,0.3507142857142857,0,1925,0,578,60,0,2563,1347,0.09260093435628738,109508,53884,
99,0.0,2,78,21,179,6123,1511,169515,0.011605710553057359,55624,116,0.08776028802574044,637,73,0,0,73,2264,0.01950859680346687,874,0,73,0,0.3507142857142857,0,1925,0,578,60,0,2563,1347,0.09260093435628738,109508,53884,
99,0.0,2,78,21,179,6123,1511,169515,0.011605710553057359,55624,116,0.08776028802574044,637,133,15,0,148,2264,0.01950859680346687,874,0,118,0,0.04365996876777198,0,1925,0,578,60,0,2563,1347,0.09260093435628738,109508,53884,
1,0.0,0,1,0,2,6123,1511,169515,0.023809523809523808,55624,116,0.08776028802574044,637,68,0,0,68,2264,0.01950859680346687,874,0,68,0,0.4892086330935252,0,218,0,20,5,0,243,198,0.2473461256963725,109508,53884,
1,0.0,0,1,0,2,6123,1511,169515,0.023809523809523808,55624,116,0.08776028802574044,637,68,0,0,68,2264,0.01950859680346687,874,0,68,0,0.4892086330935252,0,218,0,20,5,0,243,198,0.2473461256963725,109508,53884,
1,0.0,0,1,0,2,6123,1511,169515,0.023809523809523808,55624,116,0.08776028802574044,637,68,0,0,68,2264,0.01950859680346687,874,0,68,0,0.4892086330935252,0,218,0,20,5,0,243,198,0.2473461256963725,109508,53884,
8,0.0,0,7,1,15,6123,1511,169515,0.0019270434524671812,55624,116,0.08776028802574044,637,18,15,0,33,2264,0.01950859680346687,874,0,3,0,0.2088766129017492,0,452,0,143,17,0,612,309,0.11460076759606269,109508,53884,
8,0.0,0,7,1,15,6123,1511,169515,0.0019270434524671812,55624,116,0.08776028802574044,637,18,15,0,33,2264,0.01950859680346687,874,0,3,0,0.2088766129017492,0,452,0,143,17,0,612,309,0.11460076759606269,109508,53884,
8,0.003663003663003663,0,7,1,15,6123,1511,169515,0.0019270434524671812,55624,116,0.08776028802574044,637,204,17,3,224,2264,0.01950859680346687,874,1,187,2,0.09789430546794066,3,452,0,143,17,1,612,309,0.11460076759606269,109508,53884,
8,0.003663003663003663,0,7,1,15,6123,1511,169515,0.0019270434524671812,55624,116,0.08776028802574044,637,204,17,3,224,2264,0.01950859680346687,874,1,187,2,0.09789430546794066,3,452,0,143,17,1,612,309,0.11460076759606269,109508,53884,
8,0.003663003663003663,0,7,1,15,6123,1511,169515,0.0019270434524671812,55624,116,0.08776028802574044,637,204,17,3,224,2264,0.01950859680346687,874,1,187,2,0.09789430546794066,3,452,0,143,17,1,612,309,0.11460076759606269,109508,53884,
8,0.003663003663003663,0,7,1,15,6123,1511,169515,0.0019270434524671812,55624,116,0.08776028802574044,637,204,17,3,224,2264,0.01950859680346687,874,1,187,2,0.09789430546794066,3,452,0,143,17,1,612,309,0.11460076759606269,109508,53884,
8,0.011299435028248588,0,7,1,15,6123,1511,169515,0.0019270434524671812,55624,116,0.08776028802574044,637,66,82,2,150,2264,0.01950859680346687,874,5,-16,5,0.13403344231904776,10,452,0,143,17,0,612,309,0.11460076759606269,109508,53884,
8,0.0,0,7,1,15,6123,1511,169515,0.0019270434524671812,55624,116,0.08776028802574044,637,90,19,10,119,2264,0.01950859680346687,874,0,71,0,0.2327094117463456,0,452,0,143,17,0,612,309,0.11460076759606269,109508,53884,
8,0.0,0,7,1,15,6123,1511,169515,0.0019270434524671812,55624,116,0.08776028802574044,637,90,19,10,119,2264,0.01950859680346687,874,0,71,0,0.2327094117463456,0,452,0,143,17,0,612,309,0.11460076759606269,109508,53884,
8,0.0,0,7,1,15,6123,1511,169515,0.0019270434524671812,55624,116,0.08776028802574044,637,90,19,10,119,2264,0.01950859680346687,874,0,71,0,0.2327094117463456,0,452,0,143,17,0,612,309,0.11460076759606269,109508,53884,
8,0.0,0,7,1,15,6123,1511,169515,0.0019270434524671812,55624,116,0.08776028802574044,637,90,19,10,119,2264,0.01950859680346687,874,0,71,0,0.2327094117463456,0,452,0,143,17,0,612,309,0.11460076759606269,109508,53884,
0,0.0,0,0,0,0,6123,1511,169515,0.0,55624,116,0.08776028802574044,637,100,11,0,111,2264,0.01950859680346687,874,0,89,0,0.2547111141893276,0,333,0,19,4,0,356,314,0.22250000752217264,109508,53884,
0,0.0,0,0,0,0,6123,1511,169515,0.0,55624,116,0.08776028802574044,637,82,0,0,82,2264,0.01950859680346687,874,0,82,0,0.3459915611814346,0,333,0,19,4,0,356,314,0.22250000752217264,109508,53884,
0,0.0,0,0,0,0,6123,1511,169515,0.0,55624,116,0.08776028802574044,637,0,0,0,0,2264,0.01950859680346687,874,0,0,0,0.0,0,0,0,0,0,0,0,0,0.0,109508,53884,
0,0.0,0,0,0,0,6123,1511,169515,0.0,55624,116,0.08776028802574044,637,0,0,0,0,2264,0.01950859680346687,874,0,0,0,0.0,0,0,0,0,0,0,0,0,0.0,109508,53884,
0,0.0,0,0,0,0,6123,1511,169515,0.0,55624,116,0.08776028802574044,637,0,0,0,0,2264,0.01950859680346687,874,0,0,0,0.0,0,0,0,0,0,0,0,0,0.0,109508,53884,
0,0.0,0,0,0,0,6123,1511,169515,0.0,55624,116,0.08776028802574044,637,0,0,0,0,2264,0.01950859680346687,874,0,0,0,0.0,0,0,0,0,0,0,0,0,0.0,109508,53884,
0,0.0,0,0,0,0,6123,1511,169515,0.0,55624,116,0.08776028802574044,637,0,0,0,0,2264,0.01950859680346687,874,0,0,0,0.0,0,0,0,0,0,0,0,0,0.0,109508,53884,
0,0.0,0,0,0,0,6123,1511,169515,0.0,55624,116,0.08776028802574044,637,0,0,0,0,2264,0.01950859680346687,874,0,0,0,0.0,0,0,0,0,0,0,0,0,0.0,109508,53884,
0,0.0,0,0,0,0,6123,1511,169515,0.0,55624,116,0.08776028802574044,637,0,0,0,0,2264,0.01950859680346687,874,0,0,0,0.0,0,0,0,0,0,0,0,0,0.0,109508,53884,
0,0.0,0,0,0,0,6123,1511,169515,0.0,55624,116,0.08776028802574044,637,0,0,0,0,2264,0.01950859680346687,874,0,0,0,0.0,0,0,0,0,0,0,0,0,0.0,109508,53884,
0,0.0,0,0,0,0,6123,1511,169515,0.0,55624,116,0.08776028802574044,637,0,0,0,0,2264,0.01950859680346687,874,0,0,0,0.0,0,0,0,0,0,0,0,0,0.0,109508,53884,
0,0.0,0,0,0,0,6123,1511,169515,0.0,55624,116,0.08776028802574044,637,0,0,0,0,2264,0.01950859680346687,874,0,0,0,0.0,0,0,0,0,0,0,0,0,0.0,109508,53884,
0,0.0,0,0,0,0,6123,1511,169515,0.0,55624,116,0.08776028802574044,637,0,0,0,0,2264,0.01950859680346687,874,0,0,0,0.0,0,0,0,0,0,0,0,0,0.0,109508,53884,
0,0.0,0,0,0,0,6123,1511,169515,0.0,55624,116,0.08776028802574044,637,0,0,0,0,2264,0.01950859680346687,874,0,0,0,0.0,0,0,0,0,0,0,0,0,0.0,109508,53884,
0,0.0,0,0,0,0,6123,1511,169515,0.0,55624,116,0.08776028802574044,637,0,0,0,0,2264,0.01950859680346687,874,0,0,0,0.0,0,0,0,0,0,0,0,0,0.0,109508,53884,
0,0.0,0,0,0,0,6123,1511,169515,0.0,55624,116,0.08776028802574044,637,0,0,0,0,2264,0.01950859680346687,874,0,0,0,0.0,0,0,0,0,0,0,0,0,0.0,109508,53884,
0,0.0,0,0,0,0,6123,1511,169515,0.0,55624,116,0.08776028802574044,637,0,0,0,0,2264,0.01950859680346687,874,0,0,0,0.0,0,0,0,0,0,0,0,0,0.0,109508,53884,
0,0.0,0,0,0,0,6123,1511,169515,0.0,55624,116,0.08776028802574044,637,0,0,0,0,2264,0.01950859680346687,874,0,0,0,0.0,0,0,0,0,0,0,0,0,0.0,109508,53884,
0,0.0,0,0,0,0,6123,1511,169515,0.0,55624,116,0.08776028802574044,637,0,0,0,0,2264,0.01950859680346687,874,0,0,0,0.0,0,0,0,0,0,0,0,0,0.0,109508,53884,
0,0.0,0,0,0,0,6123,1511,169515,0.0,55624,116,0.08776028802574044,637,0,0,0,0,2264,0.01950859680346687,874,0,0,0,0.0,0,0,0,0,0,0,0,0,0.0,109508,53884,
0,0.0,0,0,0,0,6123,1511,169515,0.0,55624,116,0.08776028802574044,637,0,0,0,0,2264,0.01950859680346687,874,0,0,0,0.0,0,0,0,0,0,0,0,0,0.0,109508,53884,
0,0.0,0,0,0,0,6123,1511,169515,0.0,55624,116,0.08776028802574044,637,0,0,0,0,2264,0.01950859680346687,874,0,0,0,0.0,0,0,0,0,0,0,0,0,0.0,109508,53884,
0,0.0,0,0,0,0,6123,1511,169515,0.0,55624,116,0.08776028802574044,637,0,0,0,0,2264,0.01950859680346687,874,0,0,0,0.0,0,0,0,0,0,0,0,0,0.0,109508,53884,
0,0.0,0,0,0,0,6123,1511,169515,0.0,55624,116,0.08776028802574044,637,0,0,0,0,2264,0.01950859680346687,874,0,0,0,0.0,0,0,0,0,0,0,0,0,0.0,109508,53884,
0,0.0,0,0,0,0,6123,1511,169515,0.0,55624,116,0.08776028802574044,637,0,0,0,0,2264,0.01950859680346687,874,0,0,0,0.0,0,0,0,0,0,0,0,0,0.0,109508,53884,
0,0.0,0,0,0,0,6123,1511,169515,0.0,55624,116,0.08776028802574044,637,0,0,0,0,2264,0.01950859680346687,874,0,0,0,0.0,0,0,0,0,0,0,0,0,0.0,109508,53884,
0,0.0,0,0,0,0,6123,1511,169515,0.0,55624,116,0.08776028802574044,637,0,0,0,0,2264,0.01950859680346687,874,0,0,0,0.0,0,0,0,0,0,0,0,0,0.0,109508,53884,
0,0.0,0,0,0,0,6123,1511,169515,0.0,55624,116,0.08776028802574044,637,0,0,0,0,2264,0.01950859680346687,874,0,0,0,0.0,0,0,0,0,0,0,0,0,0.0,109508,53884,
0,0.0,0,0,0,0,6123,1511,169515,0.0,55624,116,0.08776028802574044,637,0,0,0,0,2264,0.01950859680346687,874,0,0,0,0.0,0,0,0,0,0,0,0,0,0.0,109508,53884,
0,0.0,0,0,0,0,6123,1511,169515,0.0,55624,116,0.08776028802574044,637,0,0,0,0,2264,0.01950859680346687,874,0,0,0,0.0,0,0,0,0,0,0,0,0,0.0,109508,53884,
0,0.0,0,0,0,0,6123,1511,169515,0.0,55624,116,0.08776028802574044,637,0,0,0,0,2264,0.01950859680346687,874,0,0,0,0.0,0,0,0,0,0,0,0,0,0.0,109508,53884,
0,0.0,0,0,0,0,6123,1511,169515,0.0,55624,116,0.08776028802574044,637,0,0,0,0,2264,0.01950859680346687,874,0,0,0,0.0,0,0,0,0,0,0,0,0,0.0,109508,53884,
0,0.0,0,0,0,0,6123,1511,169515,0.0,55624,116,0.08776028802574044,637,0,0,0,0,2264,0.01950859680346687,874,0,0,0,0.0,0,0,0,0,0,0,0,0,0.0,109508,53884,
0,0.0,0,0,0,0,6123,1511,169515,0.0,55624,116,0.08776028802574044,637,0,0,0,0,2264,0.01950859680346687,874,0,0,0,0.0,0,0,0,0,0,0,0,0,0.0,109508,53884,
0,0.0,0,0,0,0,6123,1511,169515,0.0,55624,116,0.08776028802574044,637,0,0,0,0,2264,0.01950859680346687,874,0,0,0,0.0,0,0,0,0,0,0,0,0,0.0,109508,53884,
0,0.0,0,0,0,0,6123,1511,169515,0.0,55624,116,0.08776028802574044,637,0,0,0,0,2264,0.01950859680346687,874,0,0,0,0.0,0,0,0,0,0,0,0,0,0.0,109508,53884,
0,0.0,0,0,0,0,6123,1511,169515,0.0,55624,116,0.08776028802574044,637,0,0,0,0,2264,0.01950859680346687,874,0,0,0,0.0,0,0,0,0,0,0,0,0,0.0,109508,53884,
0,0.0,0,0,0,0,6123,1511,169515,0.0,55624,116,0.08776028802574044,637,0,0,0,0,2264,0.01950859680346687,874,0,0,0,0.0,0,0,0,0,0,0,0,0,0.0,109508,53884,
0,0.0,0,0,0,0,6123,1511,169515,0.0,55624,116,0.08776028802574044,637,0,0,0,0,2264,0.01950859680346687,874,0,0,0,0.0,0,0,0,0,0,0,0,0,0.0,109508,53884,
0,0.0,0,0,0,0,6123,1511,169515,0.0,55624,116,0.08776028802574044,637,0,0,0,0,2264,0.01950859680346687,874,0,0,0,0.0,0,0,0,0,0,0,0,0,0.0,109508,53884,
0,0.0,0,0,0,0,6123,1511,169515,0.0,55624,116,0.08776028802574044,637,0,0,0,0,2264,0.01950859680346687,874,0,0,0,0.0,0,0,0,0,0,0,0,0,0.0,109508,53884,
0,0.0,0,0,0,0,6123,1511,169515,0.0,55624,116,0.08776028802574044,637,0,0,0,0,2264,0.01950859680346687,874,0,0,0,0.0,0,0,0,0,0,0,0,0,0.0,109508,53884,
0,0.0,0,0,0,0,6123,1511,169515,0.0,55624,116,0.08776028802574044,637,0,0,0,0,2264,0.01950859680346687,874,0,0,0,0.0,0,0,0,0,0,0,0,0,0.0,109508,53884,
0,0.0,0,0,0,0,6123,1511,169515,0.0,55624,116,0.08776028802574044,637,0,0,0,0,2264,0.01950859680346687,874,0,0,0,0.0,0,0,0,0,0,0,0,0,0.0,109508,53884,
0,0.0,0,0,0,0,6123,1511,169515,0.0,55624,116,0.08776028802574044,637,0,0,0,0,2264,0.01950859680346687,874,0,0,0,0.0,0,0,0,0,0,0,0,0,0.0,109508,53884,
0,0.0,0,0,0,0,6123,1511,169515,0.0,55624,116,0.08776028802574044,637,0,0,0,0,2264,0.01950859680346687,874,0,0,0,0.0,0,0,0,0,0,0,0,0,0.0,109508,53884,
0,0.0,0,0,0,0,6123,1511,169515,0.0,55624,116,0.08776028802574044,637,0,0,0,0,2264,0.01950859680346687,874,0,0,0,0.0,0,0,0,0,0,0,0,0,0.0,109508,53884,
0,0.0,0,0,0,0,6123,1511,169515,0.0,55624,116,0.08776028802574044,637,0,0,0,0,2264,0.01950859680346687,874,0,0,0,0.0,0,0,0,0,0,0,0,0,0.0,109508,53884,
0,0.0,0,0,0,0,6123,1511,169515,0.0,55624,116,0.08776028802574044,637,0,0,0,0,2264,0.01950859680346687,874,0,0,0,0.0,0,0,0,0,0,0,0,0,0.0,109508,53884,
0,0.0,0,0,0,0,6123,1511,169515,0.0,55624,116,0.08776028802574044,637,0,0,0,0,2264,0.01950859680346687,874,0,0,0,0.0,0,0,0,0,0,0,0,0,0.0,109508,53884,
0,0.0,0,0,0,0,6123,1511,169515,0.0,55624,116,0.08776028802574044,637,0,0,0,0,2264,0.01950859680346687,874,0,0,0,0.0,0,0,0,0,0,0,0,0,0.0,109508,53884,
0,0.0,0,0,0,0,6123,1511,169515,0.0,55624,116,0.08776028802574044,637,0,0,0,0,2264,0.01950859680346687,874,0,0,0,0.0,0,0,0,0,0,0,0,0,0.0,109508,53884,
0,0.0,0,0,0,0,6123,1511,169515,0.0,55624,116,0.08776028802574044,637,0,0,0,0,2264,0.01950859680346687,874,0,0,0,0.0,0,0,0,0,0,0,0,0,0.0,109508,53884,
0,0.0,0,0,0,0,6123,1511,169515,0.0,55624,116,0.08776028802574044,637,0,0,0,0,2264,0.01950859680346687,874,0,0,0,0.0,0,0,0,0,0,0,0,0,0.0,109508,53884,
0,0.0,0,0,0,0,6123,1511,169515,0.0,55624,116,0.08776028802574044,637,0,0,0,0,2264,0.01950859680346687,874,0,0,0,0.0,0,0,0,0,0,0,0,0,0.0,109508,53884,
0,0.0,0,0,0,0,6123,1511,169515,0.0,55624,116,0.08776028802574044,637,0,0,0,0,2264,0.01950859680346687,874,0,0,0,0.0,0,0,0,0,0,0,0,0,0.0,109508,53884,
0,0.0,0,0,0,0,6123,1511,169515,0.0,55624,116,0.08776028802574044,637,0,0,0,0,2264,0.01950859680346687,874,0,0,0,0.0,0,0,0,0,0,0,0,0,0.0,109508,53884,
0,0.0,0,0,0,0,6123,1511,169515,0.0,55624,116,0.08776028802574044,637,0,0,0,0,2264,0.01950859680346687,874,0,0,0,0.0,0,0,0,0,0,0,0,0,0.0,109508,53884,
0,0.0,0,0,0,0,6123,1511,169515,0.0,55624,116,0.08776028802574044,637,0,0,0,0,2264,0.01950859680346687,874,0,0,0,0.0,0,0,0,0,0,0,0,0,0.0,109508,53884,
0,0.0,0,0,0,0,6123,1511,169515,0.0,55624,116,0.08776028802574044,637,0,0,0,0,2264,0.01950859680346687,874,0,0,0,0.0,0,0,0,0,0,0,0,0,0.0,109508,53884,
0,0.0,0,0,0,0,6123,1511,169515,0.0,55624,116,0.08776028802574044,637,0,0,0,0,2264,0.01950859680346687,874,0,0,0,0.0,0,0,0,0,0,0,0,0,0.0,109508,53884,
0,0.0,0,0,0,0,6123,1511,169515,0.0,55624,116,0.08776028802574044,637,0,0,0,0,2264,0.01950859680346687,874,0,0,0,0.0,0,0,0,0,0,0,0,0,0.0,109508,53884,
0,0.0,0,0,0,0,6123,1511,169515,0.0,55624,116,0.08776028802574044,637,0,0,0,0,2264,0.01950859680346687,874,0,0,0,0.0,0,0,0,0,0,0,0,0,0.0,109508,53884,
0,0.0,0,0,0,0,6123,1511,169515,0.0,55624,116,0.08776028802574044,637,0,0,0,0,2264,0.01950859680346687,874,0,0,0,0.0,0,0,0,0,0,0,0,0,0.0,109508,53884,
0,0.0,0,0,0,0,6123,1511,169515,0.0,55624,116,0.08776028802574044,637,0,0,0,0,2264,0.01950859680346687,874,0,0,0,0.0,0,0,0,0,0,0,0,0,0.0,109508,53884,
0,0.0,0,0,0,0,6123,1511,169515,0.0,55624,116,0.08776028802574044,637,0,0,0,0,2264,0.01950859680346687,874,0,0,0,0.0,0,0,0,0,0,0,0,0,0.0,109508,53884,
0,0.0,0,0,0,0,6123,1511,169515,0.0,55624,116,0.08776028802574044,637,0,0,0,0,2264,0.01950859680346687,874,0,0,0,0.0,0,0,0,0,0,0,0,0,0.0,109508,53884,
0,0.0,0,0,0,0,6123,1511,169515,0.0,55624,116,0.08776028802574044,637,0,0,0,0,2264,0.01950859680346687,874,0,0,0,0.0,0,0,0,0,0,0,0,0,0.0,109508,53884,
0,0.0,0,0,0,0,6123,1511,169515,0.0,55624,116,0.08776028802574044,637,0,0,0,0,2264,0.01950859680346687,874,0,0,0,0.0,0,0,0,0,0,0,0,0,0.0,109508,53884,
0,0.0,0,0,0,0,6123,1511,169515,0.0,55624,116,0.08776028802574044,637,0,0,0,0,2264,0.01950859680346687,874,0,0,0,0.0,0,0,0,0,0,0,0,0,0.0,109508,53884,
0,0.0,0,0,0,0,6123,1511,169515,0.0,55624,116,0.08776028802574044,637,0,0,0,0,2264,0.01950859680346687,874,0,0,0,0.0,0,0,0,0,0,0,0,0,0.0,109508,53884,
0,0.0,0,0,0,0,6123,1511,169515,0.0,55624,116,0.08776028802574044,637,0,0,0,0,2264,0.01950859680346687,874,0,0,0,0.0,0,0,0,0,0,0,0,0,0.0,109508,53884,
0,0.0,0,0,0,0,6123,1511,169515,0.0,55624,116,0.08776028802574044,637,0,0,0,0,2264,0.01950859680346687,874,0,0,0,0.0,0,0,0,0,0,0,0,0,0.0,109508,53884,
0,0.0,0,0,0,0,6123,1511,169515,0.0,55624,116,0.08776028802574044,637,0,0,0,0,2264,0.01950859680346687,874,0,0,0,0.0,0,0,0,0,0,0,0,0,0.0,109508,53884,
0,0.0,0,0,0,0,6123,1511,169515,0.0,55624,116,0.08776028802574044,637,0,0,0,0,2264,0.01950859680346687,874,0,0,0,0.0,0,0,0,0,0,0,0,0,0.0,109508,53884,
0,0.0,0,0,0,0,6123,1511,169515,0.0,55624,116,0.08776028802574044,637,0,0,0,0,2264,0.01950859680346687,874,0,0,0,0.0,0,0,0,0,0,0,0,0,0.0,109508,53884,
0,0.0,0,0,0,0,6123,1511,169515,0.0,55624,116,0.08776028802574044,637,0,0,0,0,2264,0.01950859680346687,874,0,0,0,0.0,0,0,0,0,0,0,0,0,0.0,109508,53884,
0,0.0,0,0,0,0,6123,1511,169515,0.0,55624,116,0.08776028802574044,637,0,0,0,0,2264,0.01950859680346687,874,0,0,0,0.0,0,0,0,0,0,0,0,0,0.0,109508,53884,
0,0.0,0,0,0,0,6123,1511,169515,0.0,55624,116,0.08776028802574044,637,0,0,0,0,2264,0.01950859680346687,874,0,0,0,0.0,0,0,0,0,0,0,0,0,0.0,109508,53884,
0,0.0,0,0,0,0,6123,1511,169515,0.0,55624,116,0.08776028802574044,637,0,0,0,0,2264,0.01950859680346687,874,0,0,0,0.0,0,0,0,0,0,0,0,0,0.0,109508,53884,
0,0.0,0,0,0,0,6123,1511,169515,0.0,55624,116,0.08776028802574044,637,0,0,0,0,2264,0.01950859680346687,874,0,0,0,0.0,0,0,0,0,0,0,0,0,0.0,109508,53884,
0,0.0,0,0,0,0,6123,1511,169515,0.0,55624,116,0.08776028802574044,637,0,0,0,0,2264,0.01950859680346687,874,0,0,0,0.0,0,0,0,0,0,0,0,0,0.0,109508,53884,
0,0.0,0,0,0,0,6123,1511,169515,0.0,55624,116,0.08776028802574044,637,0,0,0,0,2264,0.01950859680346687,874,0,0,0,0.0,0,0,0,0,0,0,0,0,0.0,109508,53884,
0,0.0,0,0,0,0,6123,1511,169515,0.0,55624,116,0.08776028802574044,637,0,0,0,0,2264,0.01950859680346687,874,0,0,0,0.0,0,0,0,0,0,0,0,0,0.0,109508,53884,
0,0.0,0,0,0,0,6123,1511,169515,0.0,55624,116,0.08776028802574044,637,0,0,0,0,2264,0.01950859680346687,874,0,0,0,0.0,0,0,0,0,0,0,0,0,0.0,109508,53884,
0,0.0,0,0,0,0,6123,1511,169515,0.0,55624,116,0.08776028802574044,637,0,0,0,0,2264,0.01950859680346687,874,0,0,0,0.0,0,0,0,0,0,0,0,0,0.0,109508,53884,
0,0.0,0,0,0,0,6123,1511,169515,0.0,55624,116,0.08776028802574044,637,0,0,0,0,2264,0.01950859680346687,874,0,0,0,0.0,0,0,0,0,0,0,0,0,0.0,109508,53884,
0,0.0,0,0,0,0,6123,1511,169515,0.0,55624,116,0.08776028802574044,637,0,0,0,0,2264,0.01950859680346687,874,0,0,0,0.0,0,0,0,0,0,0,0,0,0.0,109508,53884,
0,0.0,0,0,0,0,6123,1511,169515,0.0,55624,116,0.08776028802574044,637,0,0,0,0,2264,0.01950859680346687,874,0,0,0,0.0,0,0,0,0,0,0,0,0,0.0,109508,53884,
0,0.0,0,0,0,0,6123,1511,169515,0.0,55624,116,0.08776028802574044,637,0,0,0,0,2264,0.01950859680346687,874,0,0,0,0.0,0,0,0,0,0,0,0,0,0.0,109508,53884,
0,0.0,0,0,0,0,6123,1511,169515,0.0,55624,116,0.08776028802574044,637,0,0,0,0,2264,0.01950859680346687,874,0,0,0,0.0,0,0,0,0,0,0,0,0,0.0,109508,53884,
0,0.0,0,0,0,0,6123,1511,169515,0.0,55624,116,0.08776028802574044,637,0,0,0,0,2264,0.01950859680346687,874,0,0,0,0.0,0,0,0,0,0,0,0,0,0.0,109508,53884,
0,0.0,0,0,0,0,6123,1511,169515,0.0,55624,116,0.08776028802574044,637,0,0,0,0,2264,0.01950859680346687,874,0,0,0,0.0,0,0,0,0,0,0,0,0,0.0,109508,53884,
0,0.0,0,0,0,0,6123,1511,169515,0.0,55624,116,0.08776028802574044,637,0,0,0,0,2264,0.01950859680346687,874,0,0,0,0.0,0,0,0,0,0,0,0,0,0.0,109508,53884,
0,0.0,0,0,0,0,6123,1511,169515,0.0,55624,116,0.08776028802574044,637,0,0,0,0,2264,0.01950859680346687,874,0,0,0,0.0,0,0,0,0,0,0,0,0,0.0,109508,53884,
0,0.0,0,0,0,0,6123,1511,169515,0.0,55624,116,0.08776028802574044,637,0,0,0,0,2264,0.01950859680346687,874,0,0,0,0.0,0,0,0,0,0,0,0,0,0.0,109508,53884,
0,0.0,0,0,0,0,6123,1511,169515,0.0,55624,116,0.08776028802574044,637,0,0,0,0,2264,0.01950859680346687,874,0,0,0,0.0,0,0,0,0,0,0,0,0,0.0,109508,53884,
0,0.0,0,0,0,0,6123,1511,169515,0.0,55624,116,0.08776028802574044,637,0,0,0,0,2264,0.01950859680346687,874,0,0,0,0.0,0,0,0,0,0,0,0,0,0.0,109508,53884,
0,0.0,0,0,0,0,6123,1511,169515,0.0,55624,116,0.08776028802574044,637,0,0,0,0,2264,0.01950859680346687,874,0,0,0,0.0,0,0,0,0,0,0,0,0,0.0,109508,53884,
0,0.0,0,0,0,0,6123,1511,169515,0.0,55624,116,0.08776028802574044,637,0,0,0,0,2264,0.01950859680346687,874,0,0,0,0.0,0,0,0,0,0,0,0,0,0.0,109508,53884,
0,0.0,0,0,0,0,6123,1511,169515,0.0,55624,116,0.08776028802574044,637,0,0,0,0,2264,0.01950859680346687,874,0,0,0,0.0,0,0,0,0,0,0,0,0,0.0,109508,53884,
0,0.0,0,0,0,0,6123,1511,169515,0.0,55624,116,0.08776028802574044,637,0,0,0,0,2264,0.01950859680346687,874,0,0,0,0.0,0,0,0,0,0,0,0,0,0.0,109508,53884,
0,0.0,0,0,0,0,6123,1511,169515,0.0,55624,116,0.08776028802574044,637,0,0,0,0,2264,0.01950859680346687,874,0,0,0,0.0,0,0,0,0,0,0,0,0,0.0,109508,53884,
0,0.0,0,0,0,0,6123,1511,169515,0.0,55624,116,0.08776028802574044,637,0,0,0,0,2264,0.01950859680346687,874,0,0,0,0.0,0,0,0,0,0,0,0,0,0.0,109508,53884,
0,0.0,0,0,0,0,6123,1511,169515,0.0,55624,116,0.08776028802574044,637,0,0,0,0,2264,0.01950859680346687,874,0,0,0,0.0,0,0,0,0,0,0,0,0,0.0,109508,53884,
0,0.0,0,0,0,0,6123,1511,169515,0.0,55624,116,0.08776028802574044,637,0,0,0,0,2264,0.01950859680346687,874,0,0,0,0.0,0,0,0,0,0,0,0,0,0.0,109508,53884,
0,0.0,0,0,0,0,6123,1511,169515,0.0,55624,116,0.08776028802574044,637,0,0,0,0,2264,0.01950859680346687,874,0,0,0,0.0,0,0,0,0,0,0,0,0,0.0,109508,53884,
0,0.0,0,0,0,0,6123,1511,169515,0.0,55624,116,0.08776028802574044,637,0,0,0,0,2264,0.01950859680346687,874,0,0,0,0.0,0,0,0,0,0,0,0,0,0.0,109508,53884,
0,0.0,0,0,0,0,6123,1511,169515,0.0,55624,116,0.08776028802574044,637,0,0,0,0,2264,0.01950859680346687,874,0,0,0,0.0,0,0,0,0,0,0,0,0,0.0,109508,53884,
0,0.0,0,0,0,0,6123,1511,169515,0.0,55624,116,0.08776028802574044,637,0,0,0,0,2264,0.01950859680346687,874,0,0,0,0.0,0,0,0,0,0,0,0,0,0.0,109508,53884,
0,0.0,0,0,0,0,6123,1511,169515,0.0,55624,116,0.08776028802574044,637,0,0,0,0,2264,0.01950859680346687,874,0,0,0,0.0,0,0,0,0,0,0,0,0,0.0,109508,53884,
0,0.0,0,0,0,0,6123,1511,169515,0.0,55624,116,0.08776028802574044,637,0,0,0,0,2264,0.01950859680346687,874,0,0,0,0.0,0,0,0,0,0,0,0,0,0.0,109508,53884,
0,0.0,0,0,0,0,6123,1511,169515,0.0,55624,116,0.08776028802574044,637,0,0,0,0,2264,0.01950859680346687,874,0,0,0,0.0,0,0,0,0,0,0,0,0,0.0,109508,53884,
0,0.0,0,0,0,0,6123,1511,169515,0.0,55624,116,0.08776028802574044,637,0,0,0,0,2264,0.01950859680346687,874,0,0,0,0.0,0,0,0,0,0,0,0,0,0.0,109508,53884,
0,0.0,0,0,0,0,6123,1511,169515,0.0,55624,116,0.08776028802574044,637,0,0,0,0,2264,0.01950859680346687,874,0,0,0,0.0,0,0,0,0,0,0,0,0,0.0,109508,53884,
0,0.0,0,0,0,0,6123,1511,169515,0.0,55624,116,0.08776028802574044,637,0,0,0,0,2264,0.01950859680346687,874,0,0,0,0.0,0,0,0,0,0,0,0,0,0.0,109508,53884,
0,0.0,0,0,0,0,6123,1511,169515,0.0,55624,116,0.08776028802574044,637,0,0,0,0,2264,0.01950859680346687,874,0,0,0,0.0,0,0,0,0,0,0,0,0,0.0,109508,53884,
0,0.0,0,0,0,0,6123,1511,169515,0.0,55624,116,0.08776028802574044,637,0,0,0,0,2264,0.01950859680346687,874,0,0,0,0.0,0,0,0,0,0,0,0,0,0.0,109508,53884,
0,0.0,0,0,0,0,6123,1511,169515,0.0,55624,116,0.08776028802574044,637,0,0,0,0,2264,0.01950859680346687,874,0,0,0,0.0,0,0,0,0,0,0,0,0,0.0,109508,53884,
0,0.0,0,0,0,0,6123,1511,169515,0.0,55624,116,0.08776028802574044,637,0,0,0,0,2264,0.01950859680346687,874,0,0,0,0.0,0,0,0,0,0,0,0,0,0.0,109508,53884,
0,0.0,0,0,0,0,6123,1511,169515,0.0,55624,116,0.08776028802574044,637,0,0,0,0,2264,0.01950859680346687,874,0,0,0,0.0,0,0,0,0,0,0,0,0,0.0,109508,53884,
0,0.0,0,0,0,0,6123,1511,169515,0.0,55624,116,0.08776028802574044,637,0,0,0,0,2264,0.01950859680346687,874,0,0,0,0.0,0,0,0,0,0,0,0,0,0.0,109508,53884,
0,0.0,0,0,0,0,6123,1511,169515,0.0,55624,116,0.08776028802574044,637,0,0,0,0,2264,0.01950859680346687,874,0,0,0,0.0,0,0,0,0,0,0,0,0,0.0,109508,53884,
0,0.0,0,0,0,0,6123,1511,169515,0.0,55624,116,0.08776028802574044,637,0,0,0,0,2264,0.01950859680346687,874,0,0,0,0.0,0,0,0,0,0,0,0,0,0.0,109508,53884,
0,0.0,0,0,0,0,6123,1511,169515,0.0,55624,116,0.08776028802574044,637,0,0,0,0,2264,0.01950859680346687,874,0,0,0,0.0,0,0,0,0,0,0,0,0,0.0,109508,53884,
0,0.0,0,0,0,0,6123,1511,169515,0.0,55624,116,0.08776028802574044,637,0,0,0,0,2264,0.01950859680346687,874,0,0,0,0.0,0,0,0,0,0,0,0,0,0.0,109508,53884,
0,0.0,0,0,0,0,6123,1511,169515,0.0,55624,116,0.08776028802574044,637,0,0,0,0,2264,0.01950859680346687,874,0,0,0,0.0,0,0,0,0,0,0,0,0,0.0,109508,53884,
0,0.0,0,0,0,0,6123,1511,169515,0.0,55624,116,0.08776028802574044,637,0,0,0,0,2264,0.01950859680346687,874,0,0,0,0.0,0,0,0,0,0,0,0,0,0.0,109508,53884,
0,0.0,0,0,0,0,6123,1511,169515,0.0,55624,116,0.08776028802574044,637,0,0,0,0,2264,0.01950859680346687,874,0,0,0,0.0,0,0,0,0,0,0,0,0,0.0,109508,53884,
0,0.0,0,0,0,0,6123,1511,169515,0.0,55624,116,0.08776028802574044,637,0,0,0,0,2264,0.01950859680346687,874,0,0,0,0.0,0,0,0,0,0,0,0,0,0.0,109508,53884,
0,0.0,0,0,0,0,6123,1511,169515,0.0,55624,116,0.08776028802574044,637,0,0,0,0,2264,0.01950859680346687,874,0,0,0,0.0,0,0,0,0,0,0,0,0,0.0,109508,53884,
0,0.0,0,0,0,0,6123,1511,169515,0.0,55624,116,0.08776028802574044,637,0,0,0,0,2264,0.01950859680346687,874,0,0,0,0.0,0,0,0,0,0,0,0,0,0.0,109508,53884,
0,0.0,0,0,0,0,6123,1511,169515,0.0,55624,116,0.08776028802574044,637,0,0,0,0,2264,0.01950859680346687,874,0,0,0,0.0,0,0,0,0,0,0,0,0,0.0,109508,53884,
0,0.0,0,0,0,0,6123,1511,169515,0.0,55624,116,0.08776028802574044,637,0,0,0,0,2264,0.01950859680346687,874,0,0,0,0.0,0,0,0,0,0,0,0,0,0.0,109508,53884,
0,0.0,0,0,0,0,6123,1511,169515,0.0,55624,116,0.08776028802574044,637,0,0,0,0,2264,0.01950859680346687,874,0,0,0,0.0,0,0,0,0,0,0,0,0,0.0,109508,53884,
0,0.0,0,0,0,0,6123,1511,169515,0.0,55624,116,0.08776028802574044,637,0,0,0,0,2264,0.01950859680346687,874,0,0,0,0.0,0,0,0,0,0,0,0,0,0.0,109508,53884,
0,0.0,0,0,0,0,6123,1511,169515,0.0,55624,116,0.08776028802574044,637,0,0,0,0,2264,0.01950859680346687,874,0,0,0,0.0,0,0,0,0,0,0,0,0,0.0,109508,53884,
0,0.0,0,0,0,0,6123,1511,169515,0.0,55624,116,0.08776028802574044,637,0,0,0,0,2264,0.01950859680346687,874,0,0,0,0.0,0,0,0,0,0,0,0,0,0.0,109508,53884,
0,0.0,0,0,0,0,6123,1511,169515,0.0,55624,116,0.08776028802574044,637,0,0,0,0,2264,0.01950859680346687,874,0,0,0,0.0,0,0,0,0,0,0,0,0,0.0,109508,53884,
0,0.0,0,0,0,0,6123,1511,169515,0.0,55624,116,0.08776028802574044,637,0,0,0,0,2264,0.01950859680346687,874,0,0,0,0.0,0,0,0,0,0,0,0,0,0.0,109508,53884,
0,0.0,0,0,0,0,6123,1511,169515,0.0,55624,116,0.08776028802574044,637,0,0,0,0,2264,0.01950859680346687,874,0,0,0,0.0,0,0,0,0,0,0,0,0,0.0,109508,53884,
0,0.0,0,0,0,0,6123,1511,169515,0.0,55624,116,0.08776028802574044,637,0,0,0,0,2264,0.01950859680346687,874,0,0,0,0.0,0,0,0,0,0,0,0,0,0.0,109508,53884,
0,0.0,0,0,0,0,6123,1511,169515,0.0,55624,116,0.08776028802574044,637,0,0,0,0,2264,0.01950859680346687,874,0,0,0,0.0,0,0,0,0,0,0,0,0,0.0,109508,53884,
0,0.0,0,0,0,0,6123,1511,169515,0.0,55624,116,0.08776028802574044,637,0,0,0,0,2264,0.01950859680346687,874,0,0,0,0.0,0,0,0,0,0,0,0,0,0.0,109508,53884,
0,0.0,0,0,0,0,6123,1511,169515,0.0,55624,116,0.08776028802574044,637,0,0,0,0,2264,0.01950859680346687,874,0,0,0,0.0,0,0,0,0,0,0,0,0,0.0,109508,53884,
0,0.0,0,0,0,0,6123,1511,169515,0.0,55624,116,0.08776028802574044,637,0,0,0,0,2264,0.01950859680346687,874,0,0,0,0.0,0,0,0,0,0,0,0,0,0.0,109508,53884,
0,0.0,0,0,0,0,6123,1511,169515,0.0,55624,116,0.08776028802574044,637,0,0,0,0,2264,0.01950859680346687,874,0,0,0,0.0,0,0,0,0,0,0,0,0,0.0,109508,53884,
0,0.0,0,0,0,0,6123,1511,169515,0.0,55624,116,0.08776028802574044,637,0,0,0,0,2264,0.01950859680346687,874,0,0,0,0.0,0,0,0,0,0,0,0,0,0.0,109508,53884,
0,0.0,0,0,0,0,6123,1511,169515,0.0,55624,116,0.08776028802574044,637,0,0,0,0,2264,0.01950859680346687,874,0,0,0,0.0,0,0,0,0,0,0,0,0,0.0,109508,53884,
0,0.0,0,0,0,0,6123,1511,169515,0.0,55624,116,0.08776028802574044,637,0,0,0,0,2264,0.01950859680346687,874,0,0,0,0.0,0,0,0,0,0,0,0,0,0.0,109508,53884,
0,0.0,0,0,0,0,6123,1511,169515,0.0,55624,116,0.08776028802574044,637,0,0,0,0,2264,0.01950859680346687,874,0,0,0,0.0,0,0,0,0,0,0,0,0,0.0,109508,53884,
0,0.0,0,0,0,0,6123,1511,169515,0.0,55624,116,0.08776028802574044,637,0,0,0,0,2264,0.01950859680346687,874,0,0,0,0.0,0,0,0,0,0,0,0,0,0.0,109508,53884,
0,0.0,0,0,0,0,6123,1511,169515,0.0,55624,116,0.08776028802574044,637,0,0,0,0,2264,0.01950859680346687,874,0,0,0,0.0,0,0,0,0,0,0,0,0,0.0,109508,53884,
0,0.0,0,0,0,0,6123,1511,169515,0.0,55624,116,0.08776028802574044,637,0,0,0,0,2264,0.01950859680346687,874,0,0,0,0.0,0,0,0,0,0,0,0,0,0.0,109508,53884,
0,0.0,0,0,0,0,6123,1511,169515,0.0,55624,116,0.08776028802574044,637,0,0,0,0,2264,0.01950859680346687,874,0,0,0,0.0,0,0,0,0,0,0,0,0,0.0,109508,53884,
0,0.0,0,0,0,0,6123,1511,169515,0.0,55624,116,0.08776028802574044,637,0,0,0,0,2264,0.01950859680346687,874,0,0,0,0.0,0,0,0,0,0,0,0,0,0.0,109508,53884,
0,0.0,0,0,0,0,6123,1511,169515,0.0,55624,116,0.08776028802574044,637,0,0,0,0,2264,0.01950859680346687,874,0,0,0,0.0,0,0,0,0,0,0,0,0,0.0,109508,53884,
0,0.0,0,0,0,0,6123,1511,169515,0.0,55624,116,0.08776028802574044,637,0,0,0,0,2264,0.01950859680346687,874,0,0,0,0.0,0,0,0,0,0,0,0,0,0.0,109508,53884,
0,0.0,0,0,0,0,6123,1511,169515,0.0,55624,116,0.08776028802574044,637,0,0,0,0,2264,0.01950859680346687,874,0,0,0,0.0,0,0,0,0,0,0,0,0,0.0,109508,53884,
0,0.0,0,0,0,0,6123,1511,169515,0.0,55624,116,0.08776028802574044,637,0,0,0,0,2264,0.01950859680346687,874,0,0,0,0.0,0,0,0,0,0,0,0,0,0.0,109508,53884,
0,0.0,0,0,0,0,6123,1511,169515,0.0,55624,116,0.08776028802574044,637,0,0,0,0,2264,0.01950859680346687,874,0,0,0,0.0,0,0,0,0,0,0,0,0,0.0,109508,53884,
0,0.0,0,0,0,0,6123,1511,169515,0.0,55624,116,0.08776028802574044,637,0,0,0,0,2264,0.01950859680346687,874,0,0,0,0.0,0,0,0,0,0,0,0,0,0.0,109508,53884,
0,0.0,0,0,0,0,6123,1511,169515,0.0,55624,116,0.08776028802574044,637,0,0,0,0,2264,0.01950859680346687,874,0,0,0,0.0,0,0,0,0,0,0,0,0,0.0,109508,53884,
0,0.0,0,0,0,0,6123,1511,169515,0.0,55624,116,0.08776028802574044,637,0,0,0,0,2264,0.01950859680346687,874,0,0,0,0.0,0,0,0,0,0,0,0,0,0.0,109508,53884,
0,0.0,0,0,0,0,6123,1511,169515,0.0,55624,116,0.08776028802574044,637,0,0,0,0,2264,0.01950859680346687,874,0,0,0,0.0,0,0,0,0,0,0,0,0,0.0,109508,53884,
0,0.0,0,0,0,0,6123,1511,169515,0.0,55624,116,0.08776028802574044,637,0,0,0,0,2264,0.01950859680346687,874,0,0,0,0.0,0,0,0,0,0,0,0,0,0.0,109508,53884,
0,0.0,0,0,0,0,6123,1511,169515,0.0,55624,116,0.08776028802574044,637,0,0,0,0,2264,0.01950859680346687,874,0,0,0,0.0,0,0,0,0,0,0,0,0,0.0,109508,53884,
0,0.0,0,0,0,0,6123,1511,169515,0.0,55624,116,0.08776028802574044,637,0,0,0,0,2264,0.01950859680346687,874,0,0,0,0.0,0,0,0,0,0,0,0,0,0.0,109508,53884,
0,0.0,0,0,0,0,6123,1511,169515,0.0,55624,116,0.08776028802574044,637,0,0,0,0,2264,0.01950859680346687,874,0,0,0,0.0,0,0,0,0,0,0,0,0,0.0,109508,53884,
0,0.0,0,0,0,0,6123,1511,169515,0.0,55624,116,0.08776028802574044,637,0,0,0,0,2264,0.01950859680346687,874,0,0,0,0.0,0,0,0,0,0,0,0,0,0.0,109508,53884,
0,0.0,0,0,0,0,6123,1511,169515,0.0,55624,116,0.08776028802574044,637,0,0,0,0,2264,0.01950859680346687,874,0,0,0,0.0,0,0,0,0,0,0,0,0,0.0,109508,53884,
0,0.0,0,0,0,0,6123,1511,169515,0.0,55624,116,0.08776028802574044,637,0,0,0,0,2264,0.01950859680346687,874,0,0,0,0.0,0,0,0,0,0,0,0,0,0.0,109508,53884,
0,0.0,0,0,0,0,6123,1511,169515,0.0,55624,116,0.08776028802574044,637,0,0,0,0,2264,0.01950859680346687,874,0,0,0,0.0,0,0,0,0,0,0,0,0,0.0,109508,53884,
0,0.0,0,0,0,0,6123,1511,169515,0.0,55624,116,0.08776028802574044,637,0,0,0,0,2264,0.01950859680346687,874,0,0,0,0.0,0,0,0,0,0,0,0,0,0.0,109508,53884,
0,0.0,0,0,0,0,6123,1511,169515,0.0,55624,116,0.08776028802574044,637,0,0,0,0,2264,0.01950859680346687,874,0,0,0,0.0,0,0,0,0,0,0,0,0,0.0,109508,53884,
0,0.0,0,0,0,0,6123,1511,169515,0.0,55624,116,0.08776028802574044,637,0,0,0,0,2264,0.01950859680346687,874,0,0,0,0.0,0,0,0,0,0,0,0,0,0.0,109508,53884,
0,0.0,0,0,0,0,6123,1511,169515,0.0,55624,116,0.08776028802574044,637,0,0,0,0,2264,0.01950859680346687,874,0,0,0,0.0,0,0,0,0,0,0,0,0,0.0,109508,53884,
0,0.0,0,0,0,0,6123,1511,169515,0.0,55624,116,0.08776028802574044,637,0,0,0,0,2264,0.01950859680346687,874,0,0,0,0.0,0,0,0,0,0,0,0,0,0.0,109508,53884,
0,0.0,0,0,0,0,6123,1511,169515,0.0,55624,116,0.08776028802574044,637,0,0,0,0,2264,0.01950859680346687,874,0,0,0,0.0,0,0,0,0,0,0,0,0,0.0,109508,53884,
0,0.0,0,0,0,0,6123,1511,169515,0.0,55624,116,0.08776028802574044,637,0,0,0,0,2264,0.01950859680346687,874,0,0,0,0.0,0,0,0,0,0,0,0,0,0.0,109508,53884,
0,0.0,0,0,0,0,6123,1511,169515,0.0,55624,116,0.08776028802574044,637,0,0,0,0,2264,0.01950859680346687,874,0,0,0,0.0,0,0,0,0,0,0,0,0,0.0,109508,53884,
0,0.0,0,0,0,0,6123,1511,169515,0.0,55624,116,0.08776028802574044,637,0,0,0,0,2264,0.01950859680346687,874,0,0,0,0.0,0,0,0,0,0,0,0,0,0.0,109508,53884,
0,0.0,0,0,0,0,6123,1511,169515,0.0,55624,116,0.08776028802574044,637,0,0,0,0,2264,0.01950859680346687,874,0,0,0,0.0,0,0,0,0,0,0,0,0,0.0,109508,53884,
0,0.0,0,0,0,0,6123,1511,169515,0.0,55624,116,0.08776028802574044,637,0,0,0,0,2264,0.01950859680346687,874,0,0,0,0.0,0,0,0,0,0,0,0,0,0.0,109508,53884,
0,0.0,0,0,0,0,6123,1511,169515,0.0,55624,116,0.08776028802574044,637,0,0,0,0,2264,0.01950859680346687,874,0,0,0,0.0,0,0,0,0,0,0,0,0,0.0,109508,53884,
0,0.0,0,0,0,0,6123,1511,169515,0.0,55624,116,0.08776028802574044,637,0,0,0,0,2264,0.01950859680346687,874,0,0,0,0.0,0,0,0,0,0,0,0,0,0.0,109508,53884,
0,0.0,0,0,0,0,6123,1511,169515,0.0,55624,116,0.08776028802574044,637,6,1,0,7,2264,0.01950859680346687,874,0,5,0,0.01816239316239316,0,141,0,7,0,0,148,134,0.07829633615602898,109508,53884,
0,0.0,0,0,0,0,6123,1511,169515,0.0,55624,116,0.08776028802574044,637,6,1,0,7,2264,0.01950859680346687,874,0,5,0,0.01816239316239316,0,141,0,7,0,0,148,134,0.07829633615602898,109508,53884,
0,0.0,0,0,0,0,6123,1511,169515,0.0,55624,116,0.08776028802574044,637,5,0,0,5,2264,0.01950859680346687,874,0,5,0,0.025380710659898477,0,141,0,7,0,0,148,134,0.07829633615602898,109508,53884,
0,0.0,0,0,0,0,6123,1511,169515,0.0,55624,116,0.08776028802574044,637,4,3,0,7,2264,0.01950859680346687,874,0,1,0,0.1346153846153846,0,141,0,7,0,0,148,134,0.07829633615602898,109508,53884,
14,0.0,20,11,3,45,6123,1511,169515,0.04731879408462436,55624,116,0.08776028802574044,637,59,0,0,59,2264,0.01950859680346687,874,0,59,0,0.022883122459296808,0,518,0,116,36,0,670,402,0.07303605850805749,109508,53884,
14,0.07142857142857142,20,11,3,45,6123,1511,169515,0.04731879408462436,55624,116,0.08776028802574044,637,124,25,15,164,2264,0.01950859680346687,874,0,99,1,0.12542415620644787,1,518,0,116,36,1,670,402,0.07303605850805749,109508,53884,
14,0.07142857142857142,20,11,3,45,6123,1511,169515,0.04731879408462436,55624,116,0.08776028802574044,637,124,25,15,164,2264,0.01950859680346687,874,0,99,1,0.12542415620644787,1,518,0,116,36,1,670,402,0.07303605850805749,109508,53884,
0,0.0,0,0,0,0,6123,1511,169515,0.0,55624,116,0.08776028802574044,637,52,1,1,54,2264,0.01950859680346687,874,0,51,0,0.11651364603036761,0,82,0,1,1,0,84,81,0.1355764106440498,109508,53884,
0,0.0,0,0,0,0,6123,1511,169515,0.0,55624,116,0.08776028802574044,637,52,1,1,54,2264,0.01950859680346687,874,0,51,0,0.11651364603036761,0,82,0,1,1,0,84,81,0.1355764106440498,109508,53884,
0,0.0,0,0,0,0,6123,1511,169515,0.0,55624,116,0.08776028802574044,637,52,1,1,54,2264,0.01950859680346687,874,0,51,0,0.11651364603036761,0,82,0,1,1,0,84,81,0.1355764106440498,109508,53884,
6,0.0,0,4,2,10,6123,1511,169515,0.0034399724802201583,55624,116,0.08776028802574044,637,445,148,8,601,2264,0.01950859680346687,874,0,297,0,0.11149651334488424,0,1089,0,501,32,0,1622,588,0.11709228147159169,109508,53884,
6,0.0,0,4,2,10,6123,1511,169515,0.0034399724802201583,55624,116,0.08776028802574044,637,445,148,8,601,2264,0.01950859680346687,874,0,297,0,0.11149651334488424,0,1089,0,501,32,0,1622,588,0.11709228147159169,109508,53884,
6,0.0,0,4,2,10,6123,1511,169515,0.0034399724802201583,55624,116,0.08776028802574044,637,445,148,8,601,2264,0.01950859680346687,874,0,297,0,0.11149651334488424,0,1089,0,501,32,0,1622,588,0.11709228147159169,109508,53884,
6,0.0,0,4,2,10,6123,1511,169515,0.0034399724802201583,55624,116,0.08776028802574044,637,445,148,8,601,2264,0.01950859680346687,874,0,297,0,0.11149651334488424,0,1089,0,501,32,0,1622,588,0.11709228147159169,109508,53884,
47,0.10317460317460317,4,22,25,73,6123,1511,169515,0.01761216237094358,55624,116,0.08776028802574044,637,52,55,11,118,2264,0.01950859680346687,874,10,-3,14,0.12479839294264491,26,2753,2,1425,82,4,4260,1328,0.075080652789839,109508,53884,
47,0.10317460317460317,4,22,25,73,6123,1511,169515,0.01761216237094358,55624,116,0.08776028802574044,637,52,55,11,118,2264,0.01950859680346687,874,10,-3,14,0.12479839294264491,26,2753,2,1425,82,4,4260,1328,0.075080652789839,109508,53884,
47,0.0,4,22,25,73,6123,1511,169515,0.01761216237094358,55624,116,0.08776028802574044,637,127,60,0,187,2264,0.01950859680346687,874,0,67,0,0.08637624601092123,0,2753,0,1425,82,0,4260,1328,0.075080652789839,109508,53884,
77,0.04185351270553064,5,37,40,119,6123,1511,169515,0.01239415524303707,55624,116,0.08776028802574044,637,4002,2117,207,6326,2264,0.01950859680346687,874,11,1885,15,0.1568150977671448,28,21807,2,8643,1091,4,31541,13164,0.0822281554749713,109508,53884,
47,0.0,4,22,25,73,6123,1511,169515,0.01761216237094358,55624,116,0.08776028802574044,637,138,53,3,194,2264,0.01950859680346687,874,0,85,0,0.10311003069093588,0,2753,0,1425,82,0,4260,1328,0.075080652789839,109508,53884,
47,0.0,4,22,25,73,6123,1511,169515,0.01761216237094358,55624,116,0.08776028802574044,637,138,53,3,194,2264,0.01950859680346687,874,0,85,0,0.10311003069093588,0,2753,0,1425,82,0,4260,1328,0.075080652789839,109508,53884,
14,0.0,0,2,12,16,6123,1511,169515,0.01797752808988764,55624,116,0.08776028802574044,637,212,164,1,377,2264,0.01950859680346687,874,0,48,0,0.16225243415241802,0,1451,0,1517,15,0,2983,-66,0.1337758141974023,109508,53884,
47,0.0,4,22,25,73,6123,1511,169515,0.01761216237094358,55624,116,0.08776028802574044,637,476,105,26,607,2264,0.01950859680346687,874,0,371,0,0.14275191166583698,0,2753,0,1425,82,0,4260,1328,0.075080652789839,109508,53884,
47,0.0,4,22,25,73,6123,1511,169515,0.01761216237094358,55624,116,0.08776028802574044,637,476,105,26,607,2264,0.01950859680346687,874,0,371,0,0.14275191166583698,0,2753,0,1425,82,0,4260,1328,0.075080652789839,109508,53884,
47,0.0,4,22,25,73,6123,1511,169515,0.01761216237094358,55624,116,0.08776028802574044,637,476,105,26,607,2264,0.01950859680346687,874,0,371,0,0.14275191166583698,0,2753,0,1425,82,0,4260,1328,0.075080652789839,109508,53884,
47,0.0,4,22,25,73,6123,1511,169515,0.01761216237094358,55624,116,0.08776028802574044,637,476,105,26,607,2264,0.01950859680346687,874,0,371,0,0.14275191166583698,0,2753,0,1425,82,0,4260,1328,0.075080652789839,109508,53884,
47,0.007194244604316547,4,22,25,73,6123,1511,169515,0.01761216237094358,55624,116,0.08776028802574044,637,241,209,2,452,2264,0.01950859680346687,874,0,32,1,0.04571006060999289,1,2753,0,1425,82,1,4260,1328,0.075080652789839,109508,53884,
47,0.007194244604316547,4,22,25,73,6123,1511,169515,0.01761216237094358,55624,116,0.08776028802574044,637,241,209,2,452,2264,0.01950859680346687,874,0,32,1,0.04571006060999289,1,2753,0,1425,82,1,4260,1328,0.075080652789839,109508,53884,
14,0.1797752808988764,0,2,12,16,6123,1511,169515,0.01797752808988764,55624,116,0.08776028802574044,637,390,589,2,981,2264,0.01950859680346687,874,2,-199,14,0.14028411380101807,16,1451,0,1517,15,12,2983,-66,0.1337758141974023,109508,53884,
14,0.0,0,2,12,16,6123,1511,169515,0.01797752808988764,55624,116,0.08776028802574044,637,212,164,1,377,2264,0.01950859680346687,874,0,48,0,0.16225243415241802,0,1451,0,1517,15,0,2983,-66,0.1337758141974023,109508,53884,
14,0.0,0,2,12,16,6123,1511,169515,0.01797752808988764,55624,116,0.08776028802574044,637,198,409,6,613,2264,0.01950859680346687,874,0,-211,0,0.07015561161617508,0,1451,0,1517,15,0,2983,-66,0.1337758141974023,109508,53884,
14,0.0,0,2,12,16,6123,1511,169515,0.01797752808988764,55624,116,0.08776028802574044,637,198,409,6,613,2264,0.01950859680346687,874,0,-211,0,0.07015561161617508,0,1451,0,1517,15,0,2983,-66,0.1337758141974023,109508,53884,
14,0.0,0,2,12,16,6123,1511,169515,0.01797752808988764,55624,116,0.08776028802574044,637,92,2,0,94,2264,0.01950859680346687,874,0,90,0,0.1404826538009964,0,1451,0,1517,15,0,2983,-66,0.1337758141974023,109508,53884,
69,0.14705882352941177,0,15,54,84,6123,1511,169515,0.07564865755927572,55624,116,0.08776028802574044,637,554,164,9,727,2264,0.01950859680346687,874,1,390,4,0.13016622350073115,5,1136,0,284,25,3,1445,852,0.11530781226227402,109508,53884,
69,0.14705882352941177,0,15,54,84,6123,1511,169515,0.07564865755927572,55624,116,0.08776028802574044,637,554,164,9,727,2264,0.01950859680346687,874,1,390,4,0.13016622350073115,5,1136,0,284,25,3,1445,852,0.11530781226227402,109508,53884,
69,0.14705882352941177,0,15,54,84,6123,1511,169515,0.07564865755927572,55624,116,0.08776028802574044,637,554,164,9,727,2264,0.01950859680346687,874,1,390,4,0.13016622350073115,5,1136,0,284,25,3,1445,852,0.11530781226227402,109508,53884,
69,0.14705882352941177,0,15,54,84,6123,1511,169515,0.07564865755927572,55624,116,0.08776028802574044,637,554,164,9,727,2264,0.01950859680346687,874,1,390,4,0.13016622350073115,5,1136,0,284,25,3,1445,852,0.11530781226227402,109508,53884,
69,0.14705882352941177,0,15,54,84,6123,1511,169515,0.07564865755927572,55624,116,0.08776028802574044,637,554,164,9,727,2264,0.01950859680346687,874,1,390,4,0.13016622350073115,5,1136,0,284,25,3,1445,852,0.11530781226227402,109508,53884,
69,0.0,0,15,54,84,6123,1511,169515,0.07564865755927572,55624,116,0.08776028802574044,637,123,65,12,200,2264,0.01950859680346687,874,0,58,0,0.04210098843722555,0,1136,0,284,25,0,1445,852,0.11530781226227402,109508,53884,
69,0.0,0,15,54,84,6123,1511,169515,0.07564865755927572,55624,116,0.08776028802574044,637,123,34,2,159,2264,0.01950859680346687,874,0,89,0,0.02946963685462921,0,1136,0,284,25,0,1445,852,0.11530781226227402,109508,53884,
0,0.0,0,0,0,0,6123,1511,169515,0.0,55624,116,0.08776028802574044,637,0,0,0,0,2264,0.01950859680346687,874,0,0,0,0.0,0,57,0,13,0,0,70,44,0.003162236166908723,109508,53884,
0,0.0,0,0,0,0,6123,1511,169515,0.0,55624,116,0.08776028802574044,637,0,0,0,0,2264,0.01950859680346687,874,0,0,0,0.0,0,57,0,13,0,0,70,44,0.003162236166908723,109508,53884,
0,0.0,0,0,0,0,6123,1511,169515,0.0,55624,116,0.08776028802574044,637,0,0,0,0,2264,0.01950859680346687,874,0,0,0,0.0,0,57,0,13,0,0,70,44,0.003162236166908723,109508,53884,
0,0.0,0,0,0,0,6123,1511,169515,0.0,55624,116,0.08776028802574044,637,0,0,0,0,2264,0.01950859680346687,874,0,0,0,0.0,0,57,0,13,0,0,70,44,0.003162236166908723,109508,53884,
0,0.0,0,0,0,0,6123,1511,169515,0.0,55624,116,0.08776028802574044,637,0,0,0,0,2264,0.01950859680346687,874,0,0,0,0.0,0,0,0,0,0,0,0,0,0.0,109508,53884,
0,0.0,0,0,0,0,6123,1511,169515,0.0,55624,116,0.08776028802574044,637,0,0,0,0,2264,0.01950859680346687,874,0,0,0,0.0,0,0,0,0,0,0,0,0,0.0,109508,53884,
0,0.0,0,0,0,0,6123,1511,169515,0.0,55624,116,0.08776028802574044,637,0,0,0,0,2264,0.01950859680346687,874,0,0,0,0.0,0,0,0,0,0,0,0,0,0.0,109508,53884,
0,0.0,0,0,0,0,6123,1511,169515,0.0,55624,116,0.08776028802574044,637,0,0,0,0,2264,0.01950859680346687,874,0,0,0,0.0,0,0,0,0,0,0,0,0,0.0,109508,53884,
0,0.0,0,0,0,0,6123,1511,169515,0.0,55624,116,0.08776028802574044,637,0,0,0,0,2264,0.01950859680346687,874,0,0,0,0.0,0,0,0,0,0,0,0,0,0.0,109508,53884,
0,0.0,0,0,0,0,6123,1511,169515,0.0,55624,116,0.08776028802574044,637,0,0,0,0,2264,0.01950859680346687,874,0,0,0,0.0,0,0,0,0,0,0,0,0,0.0,109508,53884,
0,0.0,0,0,0,0,6123,1511,169515,0.0,55624,116,0.08776028802574044,637,0,0,0,0,2264,0.01950859680346687,874,0,0,0,0.0,0,0,0,0,0,0,0,0,0.0,109508,53884,
0,0.0,0,0,0,0,6123,1511,169515,0.0,55624,116,0.08776028802574044,637,0,0,0,0,2264,0.01950859680346687,874,0,0,0,0.0,0,0,0,0,0,0,0,0,0.0,109508,53884,
0,0.0,0,0,0,0,6123,1511,169515,0.0,55624,116,0.08776028802574044,637,0,0,0,0,2264,0.01950859680346687,874,0,0,0,0.0,0,0,0,0,0,0,0,0,0.0,109508,53884,
0,0.0,0,0,0,0,6123,1511,169515,0.0,55624,116,0.08776028802574044,637,0,0,0,0,2264,0.01950859680346687,874,0,0,0,0.0,0,0,0,0,0,0,0,0,0.0,109508,53884,
0,0.0,0,0,0,0,6123,1511,169515,0.0,55624,116,0.08776028802574044,637,0,0,0,0,2264,0.01950859680346687,874,0,0,0,0.0,0,0,0,0,0,0,0,0,0.0,109508,53884,
0,0.0,0,0,0,0,6123,1511,169515,0.0,55624,116,0.08776028802574044,637,0,0,0,0,2264,0.01950859680346687,874,0,0,0,0.0,0,0,0,0,0,0,0,0,0.0,109508,53884,
0,0.0,0,0,0,0,6123,1511,169515,0.0,55624,116,0.08776028802574044,637,0,0,0,0,2264,0.01950859680346687,874,0,0,0,0.0,0,0,0,0,0,0,0,0,0.0,109508,53884,
0,0.0,0,0,0,0,6123,1511,169515,0.0,55624,116,0.08776028802574044,637,0,0,0,0,2264,0.01950859680346687,874,0,0,0,0.0,0,0,0,0,0,0,0,0,0.0,109508,53884,
0,0.0,0,0,0,0,6123,1511,169515,0.0,55624,116,0.08776028802574044,637,0,0,0,0,2264,0.01950859680346687,874,0,0,0,0.0,0,0,0,0,0,0,0,0,0.0,109508,53884,
0,0.0,0,0,0,0,6123,1511,169515,0.0,55624,116,0.08776028802574044,637,0,0,0,0,2264,0.01950859680346687,874,0,0,0,0.0,0,0,0,0,0,0,0,0,0.0,109508,53884,
0,0.0,0,0,0,0,6123,1511,169515,0.0,55624,116,0.08776028802574044,637,0,0,0,0,2264,0.01950859680346687,874,0,0,0,0.0,0,0,0,0,0,0,0,0,0.0,109508,53884,
0,0.0,0,0,0,0,6123,1511,169515,0.0,55624,116,0.08776028802574044,637,0,0,0,0,2264,0.01950859680346687,874,0,0,0,0.0,0,0,0,0,0,0,0,0,0.0,109508,53884,
0,0.0,0,0,0,0,6123,1511,169515,0.0,55624,116,0.08776028802574044,637,0,0,0,0,2264,0.01950859680346687,874,0,0,0,0.0,0,0,0,0,0,0,0,0,0.0,109508,53884,
0,0.0,0,0,0,0,6123,1511,169515,0.0,55624,116,0.08776028802574044,637,0,0,0,0,2264,0.01950859680346687,874,0,0,0,0.0,0,0,0,0,0,0,0,0,0.0,109508,53884,
0,0.0,0,0,0,0,6123,1511,169515,0.0,55624,116,0.08776028802574044,637,0,0,0,0,2264,0.01950859680346687,874,0,0,0,0.0,0,0,0,0,0,0,0,0,0.0,109508,53884,
0,0.0,0,0,0,0,6123,1511,169515,0.0,55624,116,0.08776028802574044,637,0,0,0,0,2264,0.01950859680346687,874,0,0,0,0.0,0,0,0,0,0,0,0,0,0.0,109508,53884,
1,0.0,0,1,0,2,6123,1511,169515,0.0011904761904761904,55624,116,0.08776028802574044,637,28,0,1,29,2264,0.01950859680346687,874,0,28,0,0.03162128549125453,0,241,0,115,10,0,366,126,0.03136495453626439,109508,53884,
0,0.0,0,0,0,0,6123,1511,169515,0.0,55624,116,0.08776028802574044,637,33,47,2,82,2264,0.01950859680346687,874,0,-14,0,0.06865797354089355,0,97,0,47,2,0,146,50,0.042502677702758396,109508,53884,
0,0.0,0,0,0,0,6123,1511,169515,0.0,55624,116,0.08776028802574044,637,137,29,1,167,2264,0.01950859680346687,874,0,108,0,0.0486180941781072,0,337,0,164,11,0,512,173,0.03189947831976538,109508,53884,
0,0.0,0,0,0,0,6123,1511,169515,0.0,55624,116,0.08776028802574044,637,0,0,0,0,2264,0.01950859680346687,874,0,0,0,0.0,0,1643,0,1139,89,0,2871,504,0.042189609954532185,109508,53884,
0,0.0,0,0,0,0,6123,1511,169515,0.0,55624,116,0.08776028802574044,637,0,0,0,0,2264,0.01950859680346687,874,0,0,0,0.0,0,1643,0,1139,89,0,2871,504,0.042189609954532185,109508,53884,
0,0.0,0,0,0,0,6123,1511,169515,0.0,55624,116,0.08776028802574044,637,0,0,0,0,2264,0.01950859680346687,874,0,0,0,0.0,0,1643,0,1139,89,0,2871,504,0.042189609954532185,109508,53884,
0,0.0,0,0,0,0,6123,1511,169515,0.0,55624,116,0.08776028802574044,637,0,0,0,0,2264,0.01950859680346687,874,0,0,0,0.0,0,1643,0,1139,89,0,2871,504,0.042189609954532185,109508,53884,
0,0.0,0,0,0,0,6123,1511,169515,0.0,55624,116,0.08776028802574044,637,1251,718,86,2055,2264,0.01950859680346687,874,0,533,0,0.19977472688170428,0,1643,0,1139,89,0,2871,504,0.042189609954532185,109508,53884,
0,0.0,0,0,0,0,6123,1511,169515,0.0,55624,116,0.08776028802574044,637,0,0,0,0,2264,0.01950859680346687,874,0,0,0,0.0,0,1643,0,1139,89,0,2871,504,0.042189609954532185,109508,53884,
0,0.0,0,0,0,0,6123,1511,169515,0.0,55624,116,0.08776028802574044,637,135,115,0,250,2264,0.01950859680346687,874,0,20,0,0.092803326330813,0,1643,0,1139,89,0,2871,504,0.042189609954532185,109508,53884,
0,0.0,0,0,0,0,6123,1511,169515,0.0,55624,116,0.08776028802574044,637,135,115,0,250,2264,0.01950859680346687,874,0,20,0,0.092803326330813,0,1643,0,1139,89,0,2871,504,0.042189609954532185,109508,53884,
0,0.0,0,0,0,0,6123,1511,169515,0.0,55624,116,0.08776028802574044,637,0,0,0,0,2264,0.01950859680346687,874,0,0,0,0.0,0,1643,0,1139,89,0,2871,504,0.042189609954532185,109508,53884,
0,0.0,0,0,0,0,6123,1511,169515,0.0,55624,116,0.08776028802574044,637,0,0,0,0,2264,0.01950859680346687,874,0,0,0,0.0,0,1643,0,1139,89,0,2871,504,0.042189609954532185,109508,53884,
0,0.0,0,0,0,0,6123,1511,169515,0.0,55624,116,0.08776028802574044,637,0,0,0,0,2264,0.01950859680346687,874,0,0,0,0.0,0,1643,0,1139,89,0,2871,504,0.042189609954532185,109508,53884,
0,0.0,0,0,0,0,6123,1511,169515,0.0,55624,116,0.08776028802574044,637,0,0,0,0,2264,0.01950859680346687,874,0,0,0,0.0,0,1643,0,1139,89,0,2871,504,0.042189609954532185,109508,53884,
0,0.0,0,0,0,0,6123,1511,169515,0.0,55624,116,0.08776028802574044,637,0,0,0,0,2264,0.01950859680346687,874,0,0,0,0.0,0,1643,0,1139,89,0,2871,504,0.042189609954532185,109508,53884,
0,0.0,0,0,0,0,6123,1511,169515,0.0,55624,116,0.08776028802574044,637,0,0,0,0,2264,0.01950859680346687,874,0,0,0,0.0,0,1643,0,1139,89,0,2871,504,0.042189609954532185,109508,53884,
0,0.0,0,0,0,0,6123,1511,169515,0.0,55624,116,0.08776028802574044,637,0,0,0,0,2264,0.01950859680346687,874,0,0,0,0.0,0,1643,0,1139,89,0,2871,504,0.042189609954532185,109508,53884,
0,0.0,0,0,0,0,6123,1511,169515,0.0,55624,116,0.08776028802574044,637,0,0,0,0,2264,0.01950859680346687,874,0,0,0,0.0,0,1643,0,1139,89,0,2871,504,0.042189609954532185,109508,53884,
1,0.0,0,1,0,2,6123,1511,169515,0.0060790273556231,55624,116,0.08776028802574044,637,111,129,2,242,2264,0.01950859680346687,874,0,-18,0,0.19765012440460664,0,653,0,417,3,0,1073,236,0.10335600439164819,109508,53884,
1,0.0425531914893617,0,1,0,2,6123,1511,169515,0.0060790273556231,55624,116,0.08776028802574044,637,99,45,1,145,2264,0.01950859680346687,874,1,54,1,0.03423511417062462,2,653,0,417,3,0,1073,236,0.10335600439164819,109508,53884,
0,0.0,0,0,0,0,6123,1511,169515,0.0,55624,116,0.08776028802574044,637,0,0,0,0,2264,0.01950859680346687,874,0,0,0,0.0,0,0,0,0,0,0,0,0,0.0,109508,53884,
0,0.0,0,0,0,0,6123,1511,169515,0.0,55624,116,0.08776028802574044,637,0,0,0,0,2264,0.01950859680346687,874,0,0,0,0.0,0,0,0,0,0,0,0,0,0.0,109508,53884,
0,0.0,0,0,0,0,6123,1511,169515,0.0,55624,116,0.08776028802574044,637,0,0,0,0,2264,0.01950859680346687,874,0,0,0,0.0,0,0,0,0,0,0,0,0,0.0,109508,53884,
0,0.0,0,0,0,0,6123,1511,169515,0.0,55624,116,0.08776028802574044,637,0,0,0,0,2264,0.01950859680346687,874,0,0,0,0.0,0,0,0,0,0,0,0,0,0.0,109508,53884,
0,0.0,0,0,0,0,6123,1511,169515,0.0,55624,116,0.08776028802574044,637,0,0,0,0,2264,0.01950859680346687,874,0,0,0,0.0,0,0,0,0,0,0,0,0,0.0,109508,53884,
0,0.0,0,0,0,0,6123,1511,169515,0.0,55624,116,0.08776028802574044,637,0,0,0,0,2264,0.01950859680346687,874,0,0,0,0.0,0,0,0,0,0,0,0,0,0.0,109508,53884,
0,0.0,0,0,0,0,6123,1511,169515,0.0,55624,116,0.08776028802574044,637,0,0,0,0,2264,0.01950859680346687,874,0,0,0,0.0,0,0,0,0,0,0,0,0,0.0,109508,53884,
0,0.0,0,0,0,0,6123,1511,169515,0.0,55624,116,0.08776028802574044,637,0,0,0,0,2264,0.01950859680346687,874,0,0,0,0.0,0,0,0,0,0,0,0,0,0.0,109508,53884,
0,0.0,0,0,0,0,6123,1511,169515,0.0,55624,116,0.08776028802574044,637,0,0,0,0,2264,0.01950859680346687,874,0,0,0,0.0,0,0,0,0,0,0,0,0,0.0,109508,53884,
0,0.0,0,0,0,0,6123,1511,169515,0.0,55624,116,0.08776028802574044,637,0,0,0,0,2264,0.01950859680346687,874,0,0,0,0.0,0,0,0,0,0,0,0,0,0.0,109508,53884,
0,0.0,0,0,0,0,6123,1511,169515,0.0,55624,116,0.08776028802574044,637,0,0,0,0,2264,0.01950859680346687,874,0,0,0,0.0,0,0,0,0,0,0,0,0,0.0,109508,53884,
0,0.0,0,0,0,0,6123,1511,169515,0.0,55624,116,0.08776028802574044,637,0,0,0,0,2264,0.01950859680346687,874,0,0,0,0.0,0,0,0,0,0,0,0,0,0.0,109508,53884,
0,0.0,0,0,0,0,6123,1511,169515,0.0,55624,116,0.08776028802574044,637,0,0,0,0,2264,0.01950859680346687,874,0,0,0,0.0,0,0,0,0,0,0,0,0,0.0,109508,53884,
0,0.0,0,0,0,0,6123,1511,169515,0.0,55624,116,0.08776028802574044,637,0,0,0,0,2264,0.01950859680346687,874,0,0,0,0.0,0,0,0,0,0,0,0,0,0.0,109508,53884,
0,0.0,0,0,0,0,6123,1511,169515,0.0,55624,116,0.08776028802574044,637,0,0,0,0,2264,0.01950859680346687,874,0,0,0,0.0,0,0,0,0,0,0,0,0,0.0,109508,53884,
0,0.0,0,0,0,0,6123,1511,169515,0.0,55624,116,0.08776028802574044,637,0,0,0,0,2264,0.01950859680346687,874,0,0,0,0.0,0,0,0,0,0,0,0,0,0.0,109508,53884,
0,0.0,0,0,0,0,6123,1511,169515,0.0,55624,116,0.08776028802574044,637,0,0,0,0,2264,0.01950859680346687,874,0,0,0,0.0,0,0,0,0,0,0,0,0,0.0,109508,53884,
0,0.0,0,0,0,0,6123,1511,169515,0.0,55624,116,0.08776028802574044,637,0,0,0,0,2264,0.01950859680346687,874,0,0,0,0.0,0,0,0,0,0,0,0,0,0.0,109508,53884,
0,0.0,0,0,0,0,6123,1511,169515,0.0,55624,116,0.08776028802574044,637,0,0,0,0,2264,0.01950859680346687,874,0,0,0,0.0,0,0,0,0,0,0,0,0,0.0,109508,53884,
0,0.0,0,0,0,0,6123,1511,169515,0.0,55624,116,0.08776028802574044,637,0,0,0,0,2264,0.01950859680346687,874,0,0,0,0.0,0,0,0,0,0,0,0,0,0.0,109508,53884,
0,0.0,0,0,0,0,6123,1511,169515,0.0,55624,116,0.08776028802574044,637,0,0,0,0,2264,0.01950859680346687,874,0,0,0,0.0,0,0,0,0,0,0,0,0,0.0,109508,53884,
0,0.0,0,0,0,0,6123,1511,169515,0.0,55624,116,0.08776028802574044,637,0,0,0,0,2264,0.01950859680346687,874,0,0,0,0.0,0,0,0,0,0,0,0,0,0.0,109508,53884,
0,0.0,0,0,0,0,6123,1511,169515,0.0,55624,116,0.08776028802574044,637,0,0,0,0,2264,0.01950859680346687,874,0,0,0,0.0,0,0,0,0,0,0,0,0,0.0,109508,53884,
0,0.0,0,0,0,0,6123,1511,169515,0.0,55624,116,0.08776028802574044,637,0,0,0,0,2264,0.01950859680346687,874,0,0,0,0.0,0,0,0,0,0,0,0,0,0.0,109508,53884,
0,0.0,0,0,0,0,6123,1511,169515,0.0,55624,116,0.08776028802574044,637,0,0,0,0,2264,0.01950859680346687,874,0,0,0,0.0,0,0,0,0,0,0,0,0,0.0,109508,53884,
0,0.0,0,0,0,0,6123,1511,169515,0.0,55624,116,0.08776028802574044,637,0,0,0,0,2264,0.01950859680346687,874,0,0,0,0.0,0,0,0,0,0,0,0,0,0.0,109508,53884,
0,0.0,0,0,0,0,6123,1511,169515,0.0,55624,116,0.08776028802574044,637,0,0,0,0,2264,0.01950859680346687,874,0,0,0,0.0,0,0,0,0,0,0,0,0,0.0,109508,53884,
0,0.0,0,0,0,0,6123,1511,169515,0.0,55624,116,0.08776028802574044,637,0,0,0,0,2264,0.01950859680346687,874,0,0,0,0.0,0,0,0,0,0,0,0,0,0.0,109508,53884,
77,0.015873015873015872,5,37,40,119,6123,1511,169515,0.01239415524303707,55624,116,0.08776028802574044,637,301,63,3,367,2264,0.01950859680346687,874,1,238,1,0.05466654642253743,2,21807,0,8643,1091,0,31541,13164,0.0822281554749713,109508,53884,
77,0.0,5,37,40,119,6123,1511,169515,0.01239415524303707,55624,116,0.08776028802574044,637,4602,3448,521,8571,2264,0.01950859680346687,874,0,1154,0,0.1724377723998226,0,21807,0,8643,1091,0,31541,13164,0.0822281554749713,109508,53884,
77,0.0,5,37,40,119,6123,1511,169515,0.01239415524303707,55624,116,0.08776028802574044,637,171,55,2,228,2264,0.01950859680346687,874,0,116,0,0.12689555696282592,0,21807,0,8643,1091,0,31541,13164,0.0822281554749713,109508,53884,
77,0.0,5,37,40,119,6123,1511,169515,0.01239415524303707,55624,116,0.08776028802574044,637,171,55,2,228,2264,0.01950859680346687,874,0,116,0,0.12689555696282592,0,21807,0,8643,1091,0,31541,13164,0.0822281554749713,109508,53884,
77,0.0,5,37,40,119,6123,1511,169515,0.01239415524303707,55624,116,0.08776028802574044,637,171,55,2,228,2264,0.01950859680346687,874,0,116,0,0.12689555696282592,0,21807,0,8643,1091,0,31541,13164,0.0822281554749713,109508,53884,
77,0.06701030927835051,5,37,40,119,6123,1511,169515,0.01239415524303707,55624,116,0.08776028802574044,637,1531,364,171,2066,2264,0.01950859680346687,874,10,1167,14,0.13629033695920204,26,21807,2,8643,1091,4,31541,13164,0.0822281554749713,109508,53884,
77,0.0,5,37,40,119,6123,1511,169515,0.01239415524303707,55624,116,0.08776028802574044,637,278,22,8,308,2264,0.01950859680346687,874,0,256,0,0.08577544581297414,0,21807,0,8643,1091,0,31541,13164,0.0822281554749713,109508,53884,
77,0.0,5,37,40,119,6123,1511,169515,0.01239415524303707,55624,116,0.08776028802574044,637,278,22,8,308,2264,0.01950859680346687,874,0,256,0,0.08577544581297414,0,21807,0,8643,1091,0,31541,13164,0.0822281554749713,109508,53884,
77,0.0,5,37,40,119,6123,1511,169515,0.01239415524303707,55624,116,0.08776028802574044,637,391,107,41,539,2264,0.01950859680346687,874,0,284,0,0.11287003677389158,0,21807,0,8643,1091,0,31541,13164,0.0822281554749713,109508,53884,
77,0.0,5,37,40,119,6123,1511,169515,0.01239415524303707,55624,116,0.08776028802574044,637,138,67,18,223,2264,0.01950859680346687,874,0,71,0,0.08131637442691929,0,21807,0,8643,1091,0,31541,13164,0.0822281554749713,109508,53884,
77,0.0,5,37,40,119,6123,1511,169515,0.01239415524303707,55624,116,0.08776028802574044,637,138,67,18,223,2264,0.01950859680346687,874,0,71,0,0.08131637442691929,0,21807,0,8643,1091,0,31541,13164,0.0822281554749713,109508,53884,
77,0.04185351270553064,5,37,40,119,6123,1511,169515,0.01239415524303707,55624,116,0.08776028802574044,637,4002,2117,207,6326,2264,0.01950859680346687,874,11,1885,15,0.1568150977671448,28,21807,2,8643,1091,4,31541,13164,0.0822281554749713,109508,53884,
77,0.0,5,37,40,119,6123,1511,169515,0.01239415524303707,55624,116,0.08776028802574044,637,73,0,0,73,2264,0.01950859680346687,874,0,73,0,0.046173308032890575,0,21807,0,8643,1091,0,31541,13164,0.0822281554749713,109508,53884,
77,0.0,5,37,40,119,6123,1511,169515,0.01239415524303707,55624,116,0.08776028802574044,637,73,0,0,73,2264,0.01950859680346687,874,0,73,0,0.046173308032890575,0,21807,0,8643,1091,0,31541,13164,0.0822281554749713,109508,53884,
0,0.0,0,0,0,0,6123,1511,169515,0.0,55624,116,0.08776028802574044,637,101,68,0,169,2264,0.01950859680346687,874,0,33,0,0.05289668578720209,0,702,0,273,8,0,983,429,0.0757488612739663,109508,53884,
77,0.04185351270553064,5,37,40,119,6123,1511,169515,0.01239415524303707,55624,116,0.08776028802574044,637,4002,2117,207,6326,2264,0.01950859680346687,874,11,1885,15,0.1568150977671448,28,21807,2,8643,1091,4,31541,13164,0.0822281554749713,109508,53884,
77,0.04185351270553064,5,37,40,119,6123,1511,169515,0.01239415524303707,55624,116,0.08776028802574044,637,4002,2117,207,6326,2264,0.01950859680346687,874,11,1885,15,0.1568150977671448,28,21807,2,8643,1091,4,31541,13164,0.0822281554749713,109508,53884,
77,0.04185351270553064,5,37,40,119,6123,1511,169515,0.01239415524303707,55624,116,0.08776028802574044,637,4002,2117,207,6326,2264,0.01950859680346687,874,11,1885,15,0.1568150977671448,28,21807,2,8643,1091,4,31541,13164,0.0822281554749713,109508,53884,
77,0.04185351270553064,5,37,40,119,6123,1511,169515,0.01239415524303707,55624,116,0.08776028802574044,637,4002,2117,207,6326,2264,0.01950859680346687,874,11,1885,15,0.1568150977671448,28,21807,2,8643,1091,4,31541,13164,0.0822281554749713,109508,53884,
77,0.04185351270553064,5,37,40,119,6123,1511,169515,0.01239415524303707,55624,116,0.08776028802574044,637,4002,2117,207,6326,2264,0.01950859680346687,874,11,1885,15,0.1568150977671448,28,21807,2,8643,1091,4,31541,13164,0.0822281554749713,109508,53884,
77,0.04185351270553064,5,37,40,119,6123,1511,169515,0.01239415524303707,55624,116,0.08776028802574044,637,4002,2117,207,6326,2264,0.01950859680346687,874,11,1885,15,0.1568150977671448,28,21807,2,8643,1091,4,31541,13164,0.0822281554749713,109508,53884,
77,0.04185351270553064,5,37,40,119,6123,1511,169515,0.01239415524303707,55624,116,0.08776028802574044,637,4002,2117,207,6326,2264,0.01950859680346687,874,11,1885,15,0.1568150977671448,28,21807,2,8643,1091,4,31541,13164,0.0822281554749713,109508,53884,
77,0.04185351270553064,5,37,40,119,6123,1511,169515,0.01239415524303707,55624,116,0.08776028802574044,637,4002,2117,207,6326,2264,0.01950859680346687,874,11,1885,15,0.1568150977671448,28,21807,2,8643,1091,4,31541,13164,0.0822281554749713,109508,53884,
77,0.04185351270553064,5,37,40,119,6123,1511,169515,0.01239415524303707,55624,116,0.08776028802574044,637,4002,2117,207,6326,2264,0.01950859680346687,874,11,1885,15,0.1568150977671448,28,21807,2,8643,1091,4,31541,13164,0.0822281554749713,109508,53884,
77,0.04185351270553064,5,37,40,119,6123,1511,169515,0.01239415524303707,55624,116,0.08776028802574044,637,4002,2117,207,6326,2264,0.01950859680346687,874,11,1885,15,0.1568150977671448,28,21807,2,8643,1091,4,31541,13164,0.0822281554749713,109508,53884,
77,0.04185351270553064,5,37,40,119,6123,1511,169515,0.01239415524303707,55624,116,0.08776028802574044,637,4002,2117,207,6326,2264,0.01950859680346687,874,11,1885,15,0.1568150977671448,28,21807,2,8643,1091,4,31541,13164,0.0822281554749713,109508,53884,
77,0.04185351270553064,5,37,40,119,6123,1511,169515,0.01239415524303707,55624,116,0.08776028802574044,637,4002,2117,207,6326,2264,0.01950859680346687,874,11,1885,15,0.1568150977671448,28,21807,2,8643,1091,4,31541,13164,0.0822281554749713,109508,53884,
77,0.04185351270553064,5,37,40,119,6123,1511,169515,0.01239415524303707,55624,116,0.08776028802574044,637,4002,2117,207,6326,2264,0.01950859680346687,874,11,1885,15,0.1568150977671448,28,21807,2,8643,1091,4,31541,13164,0.0822281554749713,109508,53884,
77,0.04185351270553064,5,37,40,119,6123,1511,169515,0.01239415524303707,55624,116,0.08776028802574044,637,4002,2117,207,6326,2264,0.01950859680346687,874,11,1885,15,0.1568150977671448,28,21807,2,8643,1091,4,31541,13164,0.0822281554749713,109508,53884,
77,0.0,5,37,40,119,6123,1511,169515,0.01239415524303707,55624,116,0.08776028802574044,637,235,15,0,250,2264,0.01950859680346687,874,0,220,0,0.13741013728583434,0,21807,0,8643,1091,0,31541,13164,0.0822281554749713,109508,53884,
77,0.0,5,37,40,119,6123,1511,169515,0.01239415524303707,55624,116,0.08776028802574044,637,1326,299,7,1632,2264,0.01950859680346687,874,0,1027,0,0.15600498804627133,0,21807,0,8643,1091,0,31541,13164,0.0822281554749713,109508,53884,
77,0.0,5,37,40,119,6123,1511,169515,0.01239415524303707,55624,116,0.08776028802574044,637,1326,299,7,1632,2264,0.01950859680346687,874,0,1027,0,0.15600498804627133,0,21807,0,8643,1091,0,31541,13164,0.0822281554749713,109508,53884,
77,0.0,5,37,40,119,6123,1511,169515,0.01239415524303707,55624,116,0.08776028802574044,637,1326,299,7,1632,2264,0.01950859680346687,874,0,1027,0,0.15600498804627133,0,21807,0,8643,1091,0,31541,13164,0.0822281554749713,109508,53884,
77,0.0,5,37,40,119,6123,1511,169515,0.01239415524303707,55624,116,0.08776028802574044,637,1326,299,7,1632,2264,0.01950859680346687,874,0,1027,0,0.15600498804627133,0,21807,0,8643,1091,0,31541,13164,0.0822281554749713,109508,53884,
77,0.087984496124031,5,37,40,119,6123,1511,169515,0.01239415524303707,55624,116,0.08776028802574044,637,3129,258,20,3407,2264,0.01950859680346687,874,2,2871,3,0.15108505074784342,5,21807,0,8643,1091,1,31541,13164,0.0822281554749713,109508,53884,
77,0.087984496124031,5,37,40,119,6123,1511,169515,0.01239415524303707,55624,116,0.08776028802574044,637,3129,258,20,3407,2264,0.01950859680346687,874,2,2871,3,0.15108505074784342,5,21807,0,8643,1091,1,31541,13164,0.0822281554749713,109508,53884,
77,0.0,5,37,40,119,6123,1511,169515,0.01239415524303707,55624,116,0.08776028802574044,637,4,30,0,34,2264,0.01950859680346687,874,0,-26,0,0.03520091430946258,0,21807,0,8643,1091,0,31541,13164,0.0822281554749713,109508,53884,
77,0.0,5,37,40,119,6123,1511,169515,0.01239415524303707,55624,116,0.08776028802574044,637,361,134,7,502,2264,0.01950859680346687,874,0,227,0,0.20770817085702928,0,21807,0,8643,1091,0,31541,13164,0.0822281554749713,109508,53884,
77,0.0,5,37,40,119,6123,1511,169515,0.01239415524303707,55624,116,0.08776028802574044,637,2,186,0,188,2264,0.01950859680346687,874,0,-184,0,0.004618620912105499,0,21807,0,8643,1091,0,31541,13164,0.0822281554749713,109508,53884,
2,0.0,1,3,-1,6,6123,1511,169515,0.007267992424242424,55624,116,0.08776028802574044,637,824,561,30,1415,2264,0.01950859680346687,874,0,263,0,0.17219470523981448,0,1864,0,1563,40,0,3467,301,0.16953068995004264,109508,53884,
2,0.0,0,0,2,2,6123,1511,169515,5.635390250774866E-4,55624,116,0.08776028802574044,637,224,32,4,260,2264,0.01950859680346687,874,0,192,0,0.2732420791808182,0,2747,0,1962,224,0,4933,785,0.12602498988185318,109508,53884,
2,0.007326007326007326,0,0,2,2,6123,1511,169515,5.635390250774866E-4,55624,116,0.08776028802574044,637,55,0,0,55,2264,0.01950859680346687,874,0,55,2,0.05291950923921184,2,2747,0,1962,224,2,4933,785,0.12602498988185318,109508,53884,
2,0.0,0,0,2,2,6123,1511,169515,5.635390250774866E-4,55624,116,0.08776028802574044,637,1240,863,210,2313,2264,0.01950859680346687,874,0,377,0,0.10169304922589949,0,2747,0,1962,224,0,4933,785,0.12602498988185318,109508,53884,
2,0.0,0,0,2,2,6123,1511,169515,5.635390250774866E-4,55624,116,0.08776028802574044,637,162,59,2,223,2264,0.01950859680346687,874,0,103,0,0.03865358141485891,0,2747,0,1962,224,0,4933,785,0.12602498988185318,109508,53884,
2,0.0,1,3,-1,6,6123,1511,169515,0.007267992424242424,55624,116,0.08776028802574044,637,824,561,30,1415,2264,0.01950859680346687,874,0,263,0,0.17219470523981448,0,1864,0,1563,40,0,3467,301,0.16953068995004264,109508,53884,
2,0.0,1,3,-1,6,6123,1511,169515,0.007267992424242424,55624,116,0.08776028802574044,637,824,561,30,1415,2264,0.01950859680346687,874,0,263,0,0.17219470523981448,0,1864,0,1563,40,0,3467,301,0.16953068995004264,109508,53884,
2,0.0,0,0,2,2,6123,1511,169515,5.635390250774866E-4,55624,116,0.08776028802574044,637,185,134,3,322,2264,0.01950859680346687,874,0,51,0,0.0615763329177595,0,2747,0,1962,224,0,4933,785,0.12602498988185318,109508,53884,
0,0.0,0,0,0,0,6123,1511,169515,0.0,55624,116,0.08776028802574044,637,1142,996,137,2275,2264,0.01950859680346687,874,0,146,0,0.17684863830509176,0,1304,0,1033,137,0,2474,271,0.08690206547664626,109508,53884,
0,0.0,0,0,0,0,6123,1511,169515,0.0,55624,116,0.08776028802574044,637,1142,996,137,2275,2264,0.01950859680346687,874,0,146,0,0.17684863830509176,0,1304,0,1033,137,0,2474,271,0.08690206547664626,109508,53884,
0,0.0,0,0,0,0,6123,1511,169515,0.0,55624,116,0.08776028802574044,637,1142,996,137,2275,2264,0.01950859680346687,874,0,146,0,0.17684863830509176,0,1304,0,1033,137,0,2474,271,0.08690206547664626,109508,53884,
0,0.0,0,0,0,0,6123,1511,169515,0.0,55624,116,0.08776028802574044,637,1142,996,137,2275,2264,0.01950859680346687,874,0,146,0,0.17684863830509176,0,1304,0,1033,137,0,2474,271,0.08690206547664626,109508,53884,
0,0.0,0,0,0,0,6123,1511,169515,0.0,55624,116,0.08776028802574044,637,1142,996,137,2275,2264,0.01950859680346687,874,0,146,0,0.17684863830509176,0,1304,0,1033,137,0,2474,271,0.08690206547664626,109508,53884,
0,0.0,0,0,0,0,6123,1511,169515,0.0,55624,116,0.08776028802574044,637,1142,996,137,2275,2264,0.01950859680346687,874,0,146,0,0.17684863830509176,0,1304,0,1033,137,0,2474,271,0.08690206547664626,109508,53884,
0,0.0,0,0,0,0,6123,1511,169515,0.0,55624,116,0.08776028802574044,637,1142,996,137,2275,2264,0.01950859680346687,874,0,146,0,0.17684863830509176,0,1304,0,1033,137,0,2474,271,0.08690206547664626,109508,53884,
0,0.0,0,0,0,0,6123,1511,169515,0.0,55624,116,0.08776028802574044,637,282,5,0,287,2264,0.01950859680346687,874,0,277,0,0.08361449372498923,0,282,0,5,0,0,287,277,0.08361449372498923,109508,53884,
0,0.0,0,0,0,0,6123,1511,169515,0.0,55624,116,0.08776028802574044,637,282,5,0,287,2264,0.01950859680346687,874,0,277,0,0.08361449372498923,0,282,0,5,0,0,287,277,0.08361449372498923,109508,53884,
0,0.0,0,0,0,0,6123,1511,169515,0.0,55624,116,0.08776028802574044,637,282,5,0,287,2264,0.01950859680346687,874,0,277,0,0.08361449372498923,0,282,0,5,0,0,287,277,0.08361449372498923,109508,53884,
0,0.0,0,0,0,0,6123,1511,169515,0.0,55624,116,0.08776028802574044,637,282,5,0,287,2264,0.01950859680346687,874,0,277,0,0.08361449372498923,0,282,0,5,0,0,287,277,0.08361449372498923,109508,53884,
0,0.0,0,0,0,0,6123,1511,169515,0.0,55624,116,0.08776028802574044,637,282,5,0,287,2264,0.01950859680346687,874,0,277,0,0.08361449372498923,0,282,0,5,0,0,287,277,0.08361449372498923,109508,53884,
0,0.0,0,0,0,0,6123,1511,169515,0.0,55624,116,0.08776028802574044,637,282,5,0,287,2264,0.01950859680346687,874,0,277,0,0.08361449372498923,0,282,0,5,0,0,287,277,0.08361449372498923,109508,53884,
0,0.0,0,0,0,0,6123,1511,169515,0.0,55624,116,0.08776028802574044,637,103,2,0,105,2264,0.01950859680346687,874,0,101,0,0.003525917593264012,0,103,0,2,0,0,105,101,0.003525917593264012,109508,53884,
0,0.0,0,0,0,0,6123,1511,169515,0.0,55624,116,0.08776028802574044,637,137,10,1,148,2264,0.01950859680346687,874,0,127,0,0.012538988883365099,0,137,0,10,1,0,148,127,0.012538988883365099,109508,53884,
0,0.0,0,0,0,0,6123,1511,169515,0.0,55624,116,0.08776028802574044,637,120,9,0,129,2264,0.01950859680346687,874,0,111,0,0.01109258604996544,0,120,0,9,0,0,129,111,0.01109258604996544,109508,53884,
0,0.0,0,0,0,0,6123,1511,169515,0.0,55624,116,0.08776028802574044,637,125,10,0,135,2264,0.01950859680346687,874,0,115,0,0.00994825134242708,0,125,0,10,0,0,135,115,0.00994825134242708,109508,53884,
0,0.0,0,0,0,0,6123,1511,169515,0.0,55624,116,0.08776028802574044,637,128,11,0,139,2264,0.01950859680346687,874,0,117,0,0.00990240512255085,0,128,0,11,0,0,139,117,0.00990240512255085,109508,53884,
0,0.0,0,0,0,0,6123,1511,169515,0.0,55624,116,0.08776028802574044,637,285,2,0,287,2264,0.01950859680346687,874,0,283,0,0.023925927529837594,0,285,0,2,0,0,287,283,0.023925927529837594,109508,53884,
0,0.0,0,0,0,0,6123,1511,169515,0.0,55624,116,0.08776028802574044,637,285,2,0,287,2264,0.01950859680346687,874,0,283,0,0.023925927529837594,0,285,0,2,0,0,287,283,0.023925927529837594,109508,53884,
0,0.0,0,0,0,0,6123,1511,169515,0.0,55624,116,0.08776028802574044,637,143,5,2,150,2264,0.01950859680346687,874,0,138,0,0.007733724189728519,0,143,0,5,2,0,150,138,0.007733724189728519,109508,53884,
0,0.0,0,0,0,0,6123,1511,169515,0.0,55624,116,0.08776028802574044,637,144,1,0,145,2264,0.01950859680346687,874,0,143,0,0.08474635811629737,0,144,0,1,0,0,145,143,0.08474635811629737,109508,53884,
3,0.015625,0,3,0,6,6123,1511,169515,0.002232142857142857,55624,116,0.08776028802574044,637,635,5,0,640,2264,0.01950859680346687,874,3,630,3,0.17786319260970535,6,1578,0,586,5,0,2169,992,0.058729873436578435,109508,53884,
3,0.015625,0,3,0,6,6123,1511,169515,0.002232142857142857,55624,116,0.08776028802574044,637,635,5,0,640,2264,0.01950859680346687,874,3,630,3,0.17786319260970535,6,1578,0,586,5,0,2169,992,0.058729873436578435,109508,53884,
3,0.015625,0,3,0,6,6123,1511,169515,0.002232142857142857,55624,116,0.08776028802574044,637,635,5,0,640,2264,0.01950859680346687,874,3,630,3,0.17786319260970535,6,1578,0,586,5,0,2169,992,0.058729873436578435,109508,53884,
3,0.015625,0,3,0,6,6123,1511,169515,0.002232142857142857,55624,116,0.08776028802574044,637,635,5,0,640,2264,0.01950859680346687,874,3,630,3,0.17786319260970535,6,1578,0,586,5,0,2169,992,0.058729873436578435,109508,53884,
3,0.0,0,3,0,6,6123,1511,169515,0.002232142857142857,55624,116,0.08776028802574044,637,59,35,0,94,2264,0.01950859680346687,874,0,24,0,0.02529891036712319,0,1578,0,586,5,0,2169,992,0.058729873436578435,109508,53884,
3,0.0,0,3,0,6,6123,1511,169515,0.002232142857142857,55624,116,0.08776028802574044,637,348,14,0,362,2264,0.01950859680346687,874,0,334,0,0.03486838958576949,0,1578,0,586,5,0,2169,992,0.058729873436578435,109508,53884,
0,0.0,0,0,0,0,6123,1511,169515,0.0,55624,116,0.08776028802574044,637,418,153,6,577,2264,0.01950859680346687,874,0,265,0,0.19089090341522194,0,527,0,287,6,0,820,240,0.09860299741187474,109508,53884,
0,0.0,0,0,0,0,6123,1511,169515,0.0,55624,116,0.08776028802574044,637,418,153,6,577,2264,0.01950859680346687,874,0,265,0,0.19089090341522194,0,527,0,287,6,0,820,240,0.09860299741187474,109508,53884,
0,0.0,0,0,0,0,6123,1511,169515,0.0,55624,116,0.08776028802574044,637,101,68,0,169,2264,0.01950859680346687,874,0,33,0,0.05289668578720209,0,702,0,273,8,0,983,429,0.0757488612739663,109508,53884,
0,0.0,0,0,0,0,6123,1511,169515,0.0,55624,116,0.08776028802574044,637,52,1,0,53,2264,0.01950859680346687,874,0,51,0,0.1901676612674055,0,52,0,1,0,0,53,51,0.1901676612674055,109508,53884,
8,0.0,0,8,0,16,6123,1511,169515,0.0010172287626991987,55624,116,0.08776028802574044,637,248,286,0,534,2264,0.01950859680346687,874,0,-38,0,0.23262010836438068,0,3183,0,968,22,0,4173,2215,0.08247801409829683,109508,53884,
8,0.0,0,8,0,16,6123,1511,169515,0.0010172287626991987,55624,116,0.08776028802574044,637,248,286,0,534,2264,0.01950859680346687,874,0,-38,0,0.23262010836438068,0,3183,0,968,22,0,4173,2215,0.08247801409829683,109508,53884,
8,0.0,0,8,0,16,6123,1511,169515,0.0010172287626991987,55624,116,0.08776028802574044,637,248,286,0,534,2264,0.01950859680346687,874,0,-38,0,0.23262010836438068,0,3183,0,968,22,0,4173,2215,0.08247801409829683,109508,53884,
8,0.0,0,8,0,16,6123,1511,169515,0.0010172287626991987,55624,116,0.08776028802574044,637,139,1,0,140,2264,0.01950859680346687,874,0,138,0,0.005767110421560253,0,3183,0,968,22,0,4173,2215,0.08247801409829683,109508,53884,
8,0.0,0,8,0,16,6123,1511,169515,0.0010172287626991987,55624,116,0.08776028802574044,637,499,10,0,509,2264,0.01950859680346687,874,0,489,0,0.1055698745236282,0,3183,0,968,22,0,4173,2215,0.08247801409829683,109508,53884,
8,0.0,0,8,0,16,6123,1511,169515,0.0010172287626991987,55624,116,0.08776028802574044,637,499,10,0,509,2264,0.01950859680346687,874,0,489,0,0.1055698745236282,0,3183,0,968,22,0,4173,2215,0.08247801409829683,109508,53884,
8,0.0,0,8,0,16,6123,1511,169515,0.0010172287626991987,55624,116,0.08776028802574044,637,499,10,0,509,2264,0.01950859680346687,874,0,489,0,0.1055698745236282,0,3183,0,968,22,0,4173,2215,0.08247801409829683,109508,53884,
8,0.0,0,8,0,16,6123,1511,169515,0.0010172287626991987,55624,116,0.08776028802574044,637,499,10,0,509,2264,0.01950859680346687,874,0,489,0,0.1055698745236282,0,3183,0,968,22,0,4173,2215,0.08247801409829683,109508,53884,
8,0.0,0,8,0,16,6123,1511,169515,0.0010172287626991987,55624,116,0.08776028802574044,637,499,10,0,509,2264,0.01950859680346687,874,0,489,0,0.1055698745236282,0,3183,0,968,22,0,4173,2215,0.08247801409829683,109508,53884,
8,0.0,0,8,0,16,6123,1511,169515,0.0010172287626991987,55624,116,0.08776028802574044,637,499,10,0,509,2264,0.01950859680346687,874,0,489,0,0.1055698745236282,0,3183,0,968,22,0,4173,2215,0.08247801409829683,109508,53884,
8,0.0,0,8,0,16,6123,1511,169515,0.0010172287626991987,55624,116,0.08776028802574044,637,499,10,0,509,2264,0.01950859680346687,874,0,489,0,0.1055698745236282,0,3183,0,968,22,0,4173,2215,0.08247801409829683,109508,53884,
46,0.13043478260869565,0,44,2,90,6123,1511,169515,0.0803164055370969,55624,116,0.08776028802574044,637,336,321,0,657,2264,0.01950859680346687,874,2,15,1,0.1717485014871094,3,2174,0,1482,24,-1,3680,692,0.21290070547583864,109508,53884,
117,0.0,19,82,35,218,6123,1511,169515,0.04730122883310808,55624,116,0.08776028802574044,637,432,35,12,479,2264,0.01950859680346687,874,0,397,0,0.28005262290109967,0,1384,0,427,65,0,1876,957,0.12375854126245919,109508,53884,
117,0.0,19,82,35,218,6123,1511,169515,0.04730122883310808,55624,116,0.08776028802574044,637,36,37,0,73,2264,0.01950859680346687,874,0,-1,0,0.06764712633125229,0,1384,0,427,65,0,1876,957,0.12375854126245919,109508,53884,
117,0.0,19,82,35,218,6123,1511,169515,0.04730122883310808,55624,116,0.08776028802574044,637,54,29,8,91,2264,0.01950859680346687,874,0,25,0,0.10329813004268688,0,1384,0,427,65,0,1876,957,0.12375854126245919,109508,53884,
117,0.045454545454545456,19,82,35,218,6123,1511,169515,0.04730122883310808,55624,116,0.08776028802574044,637,148,54,22,224,2264,0.01950859680346687,874,1,94,1,0.16061908351089854,2,1384,0,427,65,0,1876,957,0.12375854126245919,109508,53884,
117,0.14285714285714285,19,82,35,218,6123,1511,169515,0.04730122883310808,55624,116,0.08776028802574044,637,2,20,0,22,2264,0.01950859680346687,874,20,-18,2,0.14285714285714285,22,1384,0,427,65,-18,1876,957,0.12375854126245919,109508,53884,
117,0.14285714285714285,19,82,35,218,6123,1511,169515,0.04730122883310808,55624,116,0.08776028802574044,637,2,20,0,22,2264,0.01950859680346687,874,20,-18,2,0.14285714285714285,22,1384,0,427,65,-18,1876,957,0.12375854126245919,109508,53884,
117,0.0,19,82,35,218,6123,1511,169515,0.04730122883310808,55624,116,0.08776028802574044,637,6,29,2,37,2264,0.01950859680346687,874,0,-23,0,0.36935483870967745,0,1384,0,427,65,0,1876,957,0.12375854126245919,109508,53884,
0,0.0,0,0,0,0,6123,1511,169515,0.0,55624,116,0.08776028802574044,637,363,32,11,406,2264,0.01950859680346687,874,0,331,0,0.12379242260496427,0,2433,0,227,85,0,2745,2206,0.06537244134170125,109508,53884,
0,0.0,0,0,0,0,6123,1511,169515,0.0,55624,116,0.08776028802574044,637,158,4,0,162,2264,0.01950859680346687,874,0,154,0,0.0176712486814346,0,2433,0,227,85,0,2745,2206,0.06537244134170125,109508,53884,
0,0.0,0,0,0,0,6123,1511,169515,0.0,55624,116,0.08776028802574044,637,158,4,0,162,2264,0.01950859680346687,874,0,154,0,0.0176712486814346,0,2433,0,227,85,0,2745,2206,0.06537244134170125,109508,53884,
0,0.0,0,0,0,0,6123,1511,169515,0.0,55624,116,0.08776028802574044,637,158,4,0,162,2264,0.01950859680346687,874,0,154,0,0.0176712486814346,0,2433,0,227,85,0,2745,2206,0.06537244134170125,109508,53884,
0,0.0,0,0,0,0,6123,1511,169515,0.0,55624,116,0.08776028802574044,637,158,4,0,162,2264,0.01950859680346687,874,0,154,0,0.0176712486814346,0,2433,0,227,85,0,2745,2206,0.06537244134170125,109508,53884,
0,0.0,0,0,0,0,6123,1511,169515,0.0,55624,116,0.08776028802574044,637,158,4,0,162,2264,0.01950859680346687,874,0,154,0,0.0176712486814346,0,2433,0,227,85,0,2745,2206,0.06537244134170125,109508,53884,
0,0.0,0,0,0,0,6123,1511,169515,0.0,55624,116,0.08776028802574044,637,158,4,0,162,2264,0.01950859680346687,874,0,154,0,0.0176712486814346,0,2433,0,227,85,0,2745,2206,0.06537244134170125,109508,53884,
0,0.0,0,0,0,0,6123,1511,169515,0.0,55624,116,0.08776028802574044,637,158,4,0,162,2264,0.01950859680346687,874,0,154,0,0.0176712486814346,0,2433,0,227,85,0,2745,2206,0.06537244134170125,109508,53884,
0,0.0,0,0,0,0,6123,1511,169515,0.0,55624,116,0.08776028802574044,637,158,4,0,162,2264,0.01950859680346687,874,0,154,0,0.0176712486814346,0,2433,0,227,85,0,2745,2206,0.06537244134170125,109508,53884,
0,0.0,0,0,0,0,6123,1511,169515,0.0,55624,116,0.08776028802574044,637,158,4,0,162,2264,0.01950859680346687,874,0,154,0,0.0176712486814346,0,2433,0,227,85,0,2745,2206,0.06537244134170125,109508,53884,
0,0.0,0,0,0,0,6123,1511,169515,0.0,55624,116,0.08776028802574044,637,158,4,0,162,2264,0.01950859680346687,874,0,154,0,0.0176712486814346,0,2433,0,227,85,0,2745,2206,0.06537244134170125,109508,53884,
0,0.0,0,0,0,0,6123,1511,169515,0.0,55624,116,0.08776028802574044,637,158,4,0,162,2264,0.01950859680346687,874,0,154,0,0.0176712486814346,0,2433,0,227,85,0,2745,2206,0.06537244134170125,109508,53884,
0,0.0,0,0,0,0,6123,1511,169515,0.0,55624,116,0.08776028802574044,637,158,4,0,162,2264,0.01950859680346687,874,0,154,0,0.0176712486814346,0,2433,0,227,85,0,2745,2206,0.06537244134170125,109508,53884,
0,0.0,0,0,0,0,6123,1511,169515,0.0,55624,116,0.08776028802574044,637,700,51,22,773,2264,0.01950859680346687,874,0,649,0,0.10369021525102376,0,2433,0,227,85,0,2745,2206,0.06537244134170125,109508,53884,
0,0.0,0,0,0,0,6123,1511,169515,0.0,55624,116,0.08776028802574044,637,700,51,22,773,2264,0.01950859680346687,874,0,649,0,0.10369021525102376,0,2433,0,227,85,0,2745,2206,0.06537244134170125,109508,53884,
0,0.0,0,0,0,0,6123,1511,169515,0.0,55624,116,0.08776028802574044,637,700,51,22,773,2264,0.01950859680346687,874,0,649,0,0.10369021525102376,0,2433,0,227,85,0,2745,2206,0.06537244134170125,109508,53884,
0,0.0,0,0,0,0,6123,1511,169515,0.0,55624,116,0.08776028802574044,637,700,51,22,773,2264,0.01950859680346687,874,0,649,0,0.10369021525102376,0,2433,0,227,85,0,2745,2206,0.06537244134170125,109508,53884,
0,0.0,0,0,0,0,6123,1511,169515,0.0,55624,116,0.08776028802574044,637,700,51,22,773,2264,0.01950859680346687,874,0,649,0,0.10369021525102376,0,2433,0,227,85,0,2745,2206,0.06537244134170125,109508,53884,
0,0.0,0,0,0,0,6123,1511,169515,0.0,55624,116,0.08776028802574044,637,29,13,10,52,2264,0.01950859680346687,874,0,16,0,0.04554069724647212,0,2433,0,227,85,0,2745,2206,0.06537244134170125,109508,53884,
0,0.0,0,0,0,0,6123,1511,169515,0.0,55624,116,0.08776028802574044,637,29,13,10,52,2264,0.01950859680346687,874,0,16,0,0.04554069724647212,0,2433,0,227,85,0,2745,2206,0.06537244134170125,109508,53884,
0,0.0,0,0,0,0,6123,1511,169515,0.0,55624,116,0.08776028802574044,637,29,13,10,52,2264,0.01950859680346687,874,0,16,0,0.04554069724647212,0,2433,0,227,85,0,2745,2206,0.06537244134170125,109508,53884,
0,0.0,0,0,0,0,6123,1511,169515,0.0,55624,116,0.08776028802574044,637,29,13,10,52,2264,0.01950859680346687,874,0,16,0,0.04554069724647212,0,2433,0,227,85,0,2745,2206,0.06537244134170125,109508,53884,
0,0.0,0,0,0,0,6123,1511,169515,0.0,55624,116,0.08776028802574044,637,29,13,10,52,2264,0.01950859680346687,874,0,16,0,0.04554069724647212,0,2433,0,227,85,0,2745,2206,0.06537244134170125,109508,53884,
0,0.0,0,0,0,0,6123,1511,169515,0.0,55624,116,0.08776028802574044,637,81,20,2,103,2264,0.01950859680346687,874,0,61,0,0.12152350776438055,0,2433,0,227,85,0,2745,2206,0.06537244134170125,109508,53884,
0,0.0,0,0,0,0,6123,1511,169515,0.0,55624,116,0.08776028802574044,637,81,20,2,103,2264,0.01950859680346687,874,0,61,0,0.12152350776438055,0,2433,0,227,85,0,2745,2206,0.06537244134170125,109508,53884,
2,0.0,0,0,2,2,6123,1511,169515,0.0014847809948032665,55624,116,0.08776028802574044,637,795,1,0,796,2264,0.01950859680346687,874,0,794,0,0.015212544238871237,0,934,0,51,3,0,988,883,0.03698448675375813,109508,53884,
2,0.0,0,0,2,2,6123,1511,169515,0.0014847809948032665,55624,116,0.08776028802574044,637,795,1,0,796,2264,0.01950859680346687,874,0,794,0,0.015212544238871237,0,934,0,51,3,0,988,883,0.03698448675375813,109508,53884,
2,0.0,0,0,2,2,6123,1511,169515,0.0014847809948032665,55624,116,0.08776028802574044,637,795,1,0,796,2264,0.01950859680346687,874,0,794,0,0.015212544238871237,0,934,0,51,3,0,988,883,0.03698448675375813,109508,53884,
2,0.0,0,0,2,2,6123,1511,169515,0.0014847809948032665,55624,116,0.08776028802574044,637,795,1,0,796,2264,0.01950859680346687,874,0,794,0,0.015212544238871237,0,934,0,51,3,0,988,883,0.03698448675375813,109508,53884,
2,0.0,0,0,2,2,6123,1511,169515,0.0014847809948032665,55624,116,0.08776028802574044,637,795,1,0,796,2264,0.01950859680346687,874,0,794,0,0.015212544238871237,0,934,0,51,3,0,988,883,0.03698448675375813,109508,53884,
0,0.0,0,0,0,0,6123,1511,169515,0.0,55624,116,0.08776028802574044,637,0,1,0,1,2264,0.01950859680346687,874,0,-1,0,8.517887563884157E-4,0,189,0,18,0,0,207,171,0.0016342028298700704,109508,53884,
0,0.0,0,0,0,0,6123,1511,169515,0.0,55624,116,0.08776028802574044,637,56,1,0,57,2264,0.01950859680346687,874,0,55,0,0.003718961844726052,0,189,0,18,0,0,207,171,0.0016342028298700704,109508,53884,
12,0.0,0,8,4,20,6123,1511,169515,0.0014949190532242598,55624,116,0.08776028802574044,637,70,1,0,71,2264,0.01950859680346687,874,0,69,0,0.003592137787453181,0,1437,0,111,71,0,1619,1326,0.015313516041139423,109508,53884,
12,0.0,0,8,4,20,6123,1511,169515,0.0014949190532242598,55624,116,0.08776028802574044,637,70,1,0,71,2264,0.01950859680346687,874,0,69,0,0.003592137787453181,0,1437,0,111,71,0,1619,1326,0.015313516041139423,109508,53884,
12,0.0,0,8,4,20,6123,1511,169515,0.0014949190532242598,55624,116,0.08776028802574044,637,0,1,0,1,2264,0.01950859680346687,874,0,-1,0,8.103727714748784E-4,0,1437,0,111,71,0,1619,1326,0.015313516041139423,109508,53884,
12,0.0,0,8,4,20,6123,1511,169515,0.0014949190532242598,55624,116,0.08776028802574044,637,0,1,0,1,2264,0.01950859680346687,874,0,-1,0,8.103727714748784E-4,0,1437,0,111,71,0,1619,1326,0.015313516041139423,109508,53884,
12,0.0,0,8,4,20,6123,1511,169515,0.0014949190532242598,55624,116,0.08776028802574044,637,0,1,0,1,2264,0.01950859680346687,874,0,-1,0,8.103727714748784E-4,0,1437,0,111,71,0,1619,1326,0.015313516041139423,109508,53884,
12,0.0,0,8,4,20,6123,1511,169515,0.0014949190532242598,55624,116,0.08776028802574044,637,0,1,0,1,2264,0.01950859680346687,874,0,-1,0,8.025682182985554E-4,0,1437,0,111,71,0,1619,1326,0.015313516041139423,109508,53884,
12,0.0,0,8,4,20,6123,1511,169515,0.0014949190532242598,55624,116,0.08776028802574044,637,0,1,0,1,2264,0.01950859680346687,874,0,-1,0,7.94912559618442E-4,0,1437,0,111,71,0,1619,1326,0.015313516041139423,109508,53884,
12,0.0,0,8,4,20,6123,1511,169515,0.0014949190532242598,55624,116,0.08776028802574044,637,0,1,0,1,2264,0.01950859680346687,874,0,-1,0,7.94912559618442E-4,0,1437,0,111,71,0,1619,1326,0.015313516041139423,109508,53884,
12,0.0,0,8,4,20,6123,1511,169515,0.0014949190532242598,55624,116,0.08776028802574044,637,0,1,0,1,2264,0.01950859680346687,874,0,-1,0,7.94912559618442E-4,0,1437,0,111,71,0,1619,1326,0.015313516041139423,109508,53884,
12,0.008928571428571428,0,8,4,20,6123,1511,169515,0.0014949190532242598,55624,116,0.08776028802574044,637,108,0,0,108,2264,0.01950859680346687,874,0,108,5,0.009006533024216919,5,1437,0,111,71,5,1619,1326,0.015313516041139423,109508,53884,
12,0.008928571428571428,0,8,4,20,6123,1511,169515,0.0014949190532242598,55624,116,0.08776028802574044,637,108,0,0,108,2264,0.01950859680346687,874,0,108,5,0.009006533024216919,5,1437,0,111,71,5,1619,1326,0.015313516041139423,109508,53884,
12,0.0,0,8,4,20,6123,1511,169515,0.0014949190532242598,55624,116,0.08776028802574044,637,152,1,1,154,2264,0.01950859680346687,874,0,151,0,0.06778169014084508,0,1437,0,111,71,0,1619,1326,0.015313516041139423,109508,53884,
12,0.02119460500963391,0,8,4,20,6123,1511,169515,0.0014949190532242598,55624,116,0.08776028802574044,637,264,6,0,270,2264,0.01950859680346687,874,6,258,5,0.023587572341310085,11,1437,0,111,71,-1,1619,1326,0.015313516041139423,109508,53884,
12,0.0,0,8,4,20,6123,1511,169515,0.0014949190532242598,55624,116,0.08776028802574044,637,33,14,3,50,2264,0.01950859680346687,874,0,19,0,0.007818608287724784,0,1437,0,111,71,0,1619,1326,0.015313516041139423,109508,53884,
12,0.0,0,8,4,20,6123,1511,169515,0.0014949190532242598,55624,116,0.08776028802574044,637,33,14,3,50,2264,0.01950859680346687,874,0,19,0,0.007818608287724784,0,1437,0,111,71,0,1619,1326,0.015313516041139423,109508,53884,
1,0.0,0,1,0,2,6123,1511,169515,3.9872408293460925E-4,55624,116,0.08776028802574044,637,0,0,0,0,2264,0.01950859680346687,874,0,0,0,0.0,0,1652,0,562,59,0,2273,1090,0.0337059715005736,109508,53884,
1,0.0,0,1,0,2,6123,1511,169515,3.9872408293460925E-4,55624,116,0.08776028802574044,637,0,0,0,0,2264,0.01950859680346687,874,0,0,0,0.0,0,1652,0,562,59,0,2273,1090,0.0337059715005736,109508,53884,
1,0.0,0,1,0,2,6123,1511,169515,3.9872408293460925E-4,55624,116,0.08776028802574044,637,0,0,0,0,2264,0.01950859680346687,874,0,0,0,0.0,0,1652,0,562,59,0,2273,1090,0.0337059715005736,109508,53884,
1,0.0,0,1,0,2,6123,1511,169515,3.9872408293460925E-4,55624,116,0.08776028802574044,637,0,0,0,0,2264,0.01950859680346687,874,0,0,0,0.0,0,1652,0,562,59,0,2273,1090,0.0337059715005736,109508,53884,
1,0.0,0,1,0,2,6123,1511,169515,3.9872408293460925E-4,55624,116,0.08776028802574044,637,0,0,0,0,2264,0.01950859680346687,874,0,0,0,0.0,0,1652,0,562,59,0,2273,1090,0.0337059715005736,109508,53884,
1,0.0,0,1,0,2,6123,1511,169515,3.9872408293460925E-4,55624,116,0.08776028802574044,637,0,0,0,0,2264,0.01950859680346687,874,0,0,0,0.0,0,1652,0,562,59,0,2273,1090,0.0337059715005736,109508,53884,
1,0.0,0,1,0,2,6123,1511,169515,3.9872408293460925E-4,55624,116,0.08776028802574044,637,0,0,0,0,2264,0.01950859680346687,874,0,0,0,0.0,0,1652,0,562,59,0,2273,1090,0.0337059715005736,109508,53884,
1,0.0,0,1,0,2,6123,1511,169515,3.9872408293460925E-4,55624,116,0.08776028802574044,637,0,0,0,0,2264,0.01950859680346687,874,0,0,0,0.0,0,1652,0,562,59,0,2273,1090,0.0337059715005736,109508,53884,
1,0.008771929824561403,0,1,0,2,6123,1511,169515,3.9872408293460925E-4,55624,116,0.08776028802574044,637,78,36,12,126,2264,0.01950859680346687,874,1,42,1,0.05373987561590198,2,1652,0,562,59,0,2273,1090,0.0337059715005736,109508,53884,
1,0.008771929824561403,0,1,0,2,6123,1511,169515,3.9872408293460925E-4,55624,116,0.08776028802574044,637,78,36,12,126,2264,0.01950859680346687,874,1,42,1,0.05373987561590198,2,1652,0,562,59,0,2273,1090,0.0337059715005736,109508,53884,
1,0.0,0,1,0,2,6123,1511,169515,3.9872408293460925E-4,55624,116,0.08776028802574044,637,0,0,0,0,2264,0.01950859680346687,874,0,0,0,0.0,0,1652,0,562,59,0,2273,1090,0.0337059715005736,109508,53884,
1,0.0,0,1,0,2,6123,1511,169515,3.9872408293460925E-4,55624,116,0.08776028802574044,637,0,0,0,0,2264,0.01950859680346687,874,0,0,0,0.0,0,1652,0,562,59,0,2273,1090,0.0337059715005736,109508,53884,
1,0.0,0,1,0,2,6123,1511,169515,3.9872408293460925E-4,55624,116,0.08776028802574044,637,0,0,0,0,2264,0.01950859680346687,874,0,0,0,0.0,0,1652,0,562,59,0,2273,1090,0.0337059715005736,109508,53884,
1,0.0,0,1,0,2,6123,1511,169515,3.9872408293460925E-4,55624,116,0.08776028802574044,637,0,0,0,0,2264,0.01950859680346687,874,0,0,0,0.0,0,1652,0,562,59,0,2273,1090,0.0337059715005736,109508,53884,
1,0.0,0,1,0,2,6123,1511,169515,3.9872408293460925E-4,55624,116,0.08776028802574044,637,0,0,0,0,2264,0.01950859680346687,874,0,0,0,0.0,0,1652,0,562,59,0,2273,1090,0.0337059715005736,109508,53884,
1,0.0,0,1,0,2,6123,1511,169515,3.9872408293460925E-4,55624,116,0.08776028802574044,637,0,0,0,0,2264,0.01950859680346687,874,0,0,0,0.0,0,1652,0,562,59,0,2273,1090,0.0337059715005736,109508,53884,
1,0.0,0,1,0,2,6123,1511,169515,3.9872408293460925E-4,55624,116,0.08776028802574044,637,0,0,0,0,2264,0.01950859680346687,874,0,0,0,0.0,0,1652,0,562,59,0,2273,1090,0.0337059715005736,109508,53884,
1,0.0,0,1,0,2,6123,1511,169515,3.9872408293460925E-4,55624,116,0.08776028802574044,637,0,0,0,0,2264,0.01950859680346687,874,0,0,0,0.0,0,1652,0,562,59,0,2273,1090,0.0337059715005736,109508,53884,
1,0.0,0,1,0,2,6123,1511,169515,3.9872408293460925E-4,55624,116,0.08776028802574044,637,0,0,0,0,2264,0.01950859680346687,874,0,0,0,0.0,0,1652,0,562,59,0,2273,1090,0.0337059715005736,109508,53884,
1,0.0,0,1,0,2,6123,1511,169515,3.9872408293460925E-4,55624,116,0.08776028802574044,637,0,0,0,0,2264,0.01950859680346687,874,0,0,0,0.0,0,1652,0,562,59,0,2273,1090,0.0337059715005736,109508,53884,
1,0.0,0,1,0,2,6123,1511,169515,3.9872408293460925E-4,55624,116,0.08776028802574044,637,0,0,0,0,2264,0.01950859680346687,874,0,0,0,0.0,0,1652,0,562,59,0,2273,1090,0.0337059715005736,109508,53884,
1,0.0,0,1,0,2,6123,1511,169515,3.9872408293460925E-4,55624,116,0.08776028802574044,637,0,0,0,0,2264,0.01950859680346687,874,0,0,0,0.0,0,1652,0,562,59,0,2273,1090,0.0337059715005736,109508,53884,
1,0.0,0,1,0,2,6123,1511,169515,3.9872408293460925E-4,55624,116,0.08776028802574044,637,0,0,0,0,2264,0.01950859680346687,874,0,0,0,0.0,0,1652,0,562,59,0,2273,1090,0.0337059715005736,109508,53884,
1,0.0,0,1,0,2,6123,1511,169515,3.9872408293460925E-4,55624,116,0.08776028802574044,637,0,0,0,0,2264,0.01950859680346687,874,0,0,0,0.0,0,1652,0,562,59,0,2273,1090,0.0337059715005736,109508,53884,
1,0.0,0,1,0,2,6123,1511,169515,3.9872408293460925E-4,55624,116,0.08776028802574044,637,0,0,0,0,2264,0.01950859680346687,874,0,0,0,0.0,0,1652,0,562,59,0,2273,1090,0.0337059715005736,109508,53884,
1,0.0,0,1,0,2,6123,1511,169515,3.9872408293460925E-4,55624,116,0.08776028802574044,637,0,0,0,0,2264,0.01950859680346687,874,0,0,0,0.0,0,1652,0,562,59,0,2273,1090,0.0337059715005736,109508,53884,
1,0.0,0,1,0,2,6123,1511,169515,3.9872408293460925E-4,55624,116,0.08776028802574044,637,314,52,1,367,2264,0.01950859680346687,874,0,262,0,0.1504390512930149,0,1652,0,562,59,0,2273,1090,0.0337059715005736,109508,53884,
1,0.0,0,1,0,2,6123,1511,169515,3.9872408293460925E-4,55624,116,0.08776028802574044,637,0,0,0,0,2264,0.01950859680346687,874,0,0,0,0.0,0,1652,0,562,59,0,2273,1090,0.0337059715005736,109508,53884,
1,0.0,0,1,0,2,6123,1511,169515,3.9872408293460925E-4,55624,116,0.08776028802574044,637,426,99,6,531,2264,0.01950859680346687,874,0,327,0,0.11883479622400878,0,1652,0,562,59,0,2273,1090,0.0337059715005736,109508,53884,
1,0.0,0,1,0,2,6123,1511,169515,3.9872408293460925E-4,55624,116,0.08776028802574044,637,426,99,6,531,2264,0.01950859680346687,874,0,327,0,0.11883479622400878,0,1652,0,562,59,0,2273,1090,0.0337059715005736,109508,53884,
1,0.0,0,1,0,2,6123,1511,169515,3.9872408293460925E-4,55624,116,0.08776028802574044,637,426,99,6,531,2264,0.01950859680346687,874,0,327,0,0.11883479622400878,0,1652,0,562,59,0,2273,1090,0.0337059715005736,109508,53884,
1,0.0,0,1,0,2,6123,1511,169515,3.9872408293460925E-4,55624,116,0.08776028802574044,637,426,99,6,531,2264,0.01950859680346687,874,0,327,0,0.11883479622400878,0,1652,0,562,59,0,2273,1090,0.0337059715005736,109508,53884,
1,0.0,0,1,0,2,6123,1511,169515,3.9872408293460925E-4,55624,116,0.08776028802574044,637,0,0,0,0,2264,0.01950859680346687,874,0,0,0,0.0,0,1652,0,562,59,0,2273,1090,0.0337059715005736,109508,53884,
0,0.0,0,0,0,0,6123,1511,169515,0.0,55624,116,0.08776028802574044,637,63,209,2,274,2264,0.01950859680346687,874,0,-146,0,0.292531664232445,0,737,0,834,2,0,1573,-97,0.14267425070663667,109508,53884,
0,0.0,0,0,0,0,6123,1511,169515,0.0,55624,116,0.08776028802574044,637,63,209,2,274,2264,0.01950859680346687,874,0,-146,0,0.292531664232445,0,737,0,834,2,0,1573,-97,0.14267425070663667,109508,53884,
0,0.0,0,0,0,0,6123,1511,169515,0.0,55624,116,0.08776028802574044,637,63,209,2,274,2264,0.01950859680346687,874,0,-146,0,0.292531664232445,0,737,0,834,2,0,1573,-97,0.14267425070663667,109508,53884,
0,0.0,0,0,0,0,6123,1511,169515,0.0,55624,116,0.08776028802574044,637,63,209,2,274,2264,0.01950859680346687,874,0,-146,0,0.292531664232445,0,737,0,834,2,0,1573,-97,0.14267425070663667,109508,53884,
0,0.0,0,0,0,0,6123,1511,169515,0.0,55624,116,0.08776028802574044,637,63,209,2,274,2264,0.01950859680346687,874,0,-146,0,0.292531664232445,0,737,0,834,2,0,1573,-97,0.14267425070663667,109508,53884,
0,0.0,0,0,0,0,6123,1511,169515,0.0,55624,116,0.08776028802574044,637,0,69,0,69,2264,0.01950859680346687,874,0,-69,0,0.04262297612248993,0,737,0,834,2,0,1573,-97,0.14267425070663667,109508,53884,
0,0.0,0,0,0,0,6123,1511,169515,0.0,55624,116,0.08776028802574044,637,1,83,0,84,2264,0.01950859680346687,874,0,-82,0,0.055921284235724844,0,193,0,354,0,0,547,-161,0.08481049661114992,109508,53884,
0,0.0,0,0,0,0,6123,1511,169515,0.0,55624,116,0.08776028802574044,637,0,0,0,0,2264,0.01950859680346687,874,0,0,0,0.0,0,0,0,0,0,0,0,0,0.0,109508,53884,
0,0.0,0,0,0,0,6123,1511,169515,0.0,55624,116,0.08776028802574044,637,0,0,0,0,2264,0.01950859680346687,874,0,0,0,0.0,0,0,0,0,0,0,0,0,0.0,109508,53884,
0,0.0,0,0,0,0,6123,1511,169515,0.0,55624,116,0.08776028802574044,637,0,0,0,0,2264,0.01950859680346687,874,0,0,0,0.0,0,0,0,0,0,0,0,0,0.0,109508,53884,
0,0.0,0,0,0,0,6123,1511,169515,0.0,55624,116,0.08776028802574044,637,0,0,0,0,2264,0.01950859680346687,874,0,0,0,0.0,0,0,0,0,0,0,0,0,0.0,109508,53884,
0,0.0,0,0,0,0,6123,1511,169515,0.0,55624,116,0.08776028802574044,637,0,0,0,0,2264,0.01950859680346687,874,0,0,0,0.0,0,0,0,0,0,0,0,0,0.0,109508,53884,
0,0.0,0,0,0,0,6123,1511,169515,0.0,55624,116,0.08776028802574044,637,0,0,0,0,2264,0.01950859680346687,874,0,0,0,0.0,0,0,0,0,0,0,0,0,0.0,109508,53884,
0,0.0,0,0,0,0,6123,1511,169515,0.0,55624,116,0.08776028802574044,637,0,0,0,0,2264,0.01950859680346687,874,0,0,0,0.0,0,0,0,0,0,0,0,0,0.0,109508,53884,
0,0.0,0,0,0,0,6123,1511,169515,0.0,55624,116,0.08776028802574044,637,0,0,0,0,2264,0.01950859680346687,874,0,0,0,0.0,0,0,0,0,0,0,0,0,0.0,109508,53884,
0,0.0,0,0,0,0,6123,1511,169515,0.0,55624,116,0.08776028802574044,637,0,0,0,0,2264,0.01950859680346687,874,0,0,0,0.0,0,0,0,0,0,0,0,0,0.0,109508,53884,
0,0.0,0,0,0,0,6123,1511,169515,0.0,55624,116,0.08776028802574044,637,0,0,0,0,2264,0.01950859680346687,874,0,0,0,0.0,0,0,0,0,0,0,0,0,0.0,109508,53884,
0,0.0,0,0,0,0,6123,1511,169515,0.0,55624,116,0.08776028802574044,637,0,0,0,0,2264,0.01950859680346687,874,0,0,0,0.0,0,0,0,0,0,0,0,0,0.0,109508,53884,
0,0.0,0,0,0,0,6123,1511,169515,0.0,55624,116,0.08776028802574044,637,0,0,0,0,2264,0.01950859680346687,874,0,0,0,0.0,0,0,0,0,0,0,0,0,0.0,109508,53884,
0,0.0,0,0,0,0,6123,1511,169515,0.0,55624,116,0.08776028802574044,637,0,0,0,0,2264,0.01950859680346687,874,0,0,0,0.0,0,0,0,0,0,0,0,0,0.0,109508,53884,
0,0.0,0,0,0,0,6123,1511,169515,0.0,55624,116,0.08776028802574044,637,0,0,0,0,2264,0.01950859680346687,874,0,0,0,0.0,0,0,0,0,0,0,0,0,0.0,109508,53884,
0,0.0,0,0,0,0,6123,1511,169515,0.0,55624,116,0.08776028802574044,637,0,0,0,0,2264,0.01950859680346687,874,0,0,0,0.0,0,0,0,0,0,0,0,0,0.0,109508,53884,
0,0.0,0,0,0,0,6123,1511,169515,0.0,55624,116,0.08776028802574044,637,0,0,0,0,2264,0.01950859680346687,874,0,0,0,0.0,0,0,0,0,0,0,0,0,0.0,109508,53884,
0,0.0,0,0,0,0,6123,1511,169515,0.0,55624,116,0.08776028802574044,637,0,0,0,0,2264,0.01950859680346687,874,0,0,0,0.0,0,0,0,0,0,0,0,0,0.0,109508,53884,
0,0.0,0,0,0,0,6123,1511,169515,0.0,55624,116,0.08776028802574044,637,0,0,0,0,2264,0.01950859680346687,874,0,0,0,0.0,0,0,0,0,0,0,0,0,0.0,109508,53884,
0,0.0,0,0,0,0,6123,1511,169515,0.0,55624,116,0.08776028802574044,637,0,0,0,0,2264,0.01950859680346687,874,0,0,0,0.0,0,0,0,0,0,0,0,0,0.0,109508,53884,
0,0.0,0,0,0,0,6123,1511,169515,0.0,55624,116,0.08776028802574044,637,0,0,0,0,2264,0.01950859680346687,874,0,0,0,0.0,0,0,0,0,0,0,0,0,0.0,109508,53884,
0,0.0,0,0,0,0,6123,1511,169515,0.0,55624,116,0.08776028802574044,637,0,0,0,0,2264,0.01950859680346687,874,0,0,0,0.0,0,0,0,0,0,0,0,0,0.0,109508,53884,
0,0.0,0,0,0,0,6123,1511,169515,0.0,55624,116,0.08776028802574044,637,0,0,0,0,2264,0.01950859680346687,874,0,0,0,0.0,0,0,0,0,0,0,0,0,0.0,109508,53884,
0,0.0,0,0,0,0,6123,1511,169515,0.0,55624,116,0.08776028802574044,637,0,0,0,0,2264,0.01950859680346687,874,0,0,0,0.0,0,0,0,0,0,0,0,0,0.0,109508,53884,
0,0.0,0,0,0,0,6123,1511,169515,0.0,55624,116,0.08776028802574044,637,0,0,0,0,2264,0.01950859680346687,874,0,0,0,0.0,0,0,0,0,0,0,0,0,0.0,109508,53884,
0,0.0,0,0,0,0,6123,1511,169515,0.0,55624,116,0.08776028802574044,637,0,0,0,0,2264,0.01950859680346687,874,0,0,0,0.0,0,0,0,0,0,0,0,0,0.0,109508,53884,
0,0.0,0,0,0,0,6123,1511,169515,0.0,55624,116,0.08776028802574044,637,0,0,0,0,2264,0.01950859680346687,874,0,0,0,0.0,0,0,0,0,0,0,0,0,0.0,109508,53884,
0,0.0,0,0,0,0,6123,1511,169515,0.0,55624,116,0.08776028802574044,637,0,0,0,0,2264,0.01950859680346687,874,0,0,0,0.0,0,0,0,0,0,0,0,0,0.0,109508,53884,
0,0.0,0,0,0,0,6123,1511,169515,0.0,55624,116,0.08776028802574044,637,0,0,0,0,2264,0.01950859680346687,874,0,0,0,0.0,0,0,0,0,0,0,0,0,0.0,109508,53884,
0,0.0,0,0,0,0,6123,1511,169515,0.0,55624,116,0.08776028802574044,637,0,0,0,0,2264,0.01950859680346687,874,0,0,0,0.0,0,0,0,0,0,0,0,0,0.0,109508,53884,
0,0.0,0,0,0,0,6123,1511,169515,0.0,55624,116,0.08776028802574044,637,0,0,0,0,2264,0.01950859680346687,874,0,0,0,0.0,0,0,0,0,0,0,0,0,0.0,109508,53884,
0,0.0,0,0,0,0,6123,1511,169515,0.0,55624,116,0.08776028802574044,637,0,0,0,0,2264,0.01950859680346687,874,0,0,0,0.0,0,0,0,0,0,0,0,0,0.0,109508,53884,
0,0.0,0,0,0,0,6123,1511,169515,0.0,55624,116,0.08776028802574044,637,0,0,0,0,2264,0.01950859680346687,874,0,0,0,0.0,0,0,0,0,0,0,0,0,0.0,109508,53884,
0,0.0,0,0,0,0,6123,1511,169515,0.0,55624,116,0.08776028802574044,637,0,0,0,0,2264,0.01950859680346687,874,0,0,0,0.0,0,0,0,0,0,0,0,0,0.0,109508,53884,
0,0.0,0,0,0,0,6123,1511,169515,0.0,55624,116,0.08776028802574044,637,0,0,0,0,2264,0.01950859680346687,874,0,0,0,0.0,0,0,0,0,0,0,0,0,0.0,109508,53884,
0,0.0,0,0,0,0,6123,1511,169515,0.0,55624,116,0.08776028802574044,637,0,0,0,0,2264,0.01950859680346687,874,0,0,0,0.0,0,0,0,0,0,0,0,0,0.0,109508,53884,
0,0.0,0,0,0,0,6123,1511,169515,0.0,55624,116,0.08776028802574044,637,0,0,0,0,2264,0.01950859680346687,874,0,0,0,0.0,0,0,0,0,0,0,0,0,0.0,109508,53884,
0,0.0,0,0,0,0,6123,1511,169515,0.0,55624,116,0.08776028802574044,637,223,210,11,444,2264,0.01950859680346687,874,0,13,0,0.1886706786916194,0,464,0,364,13,0,841,100,0.11496750562141124,109508,53884,
0,0.0,0,0,0,0,6123,1511,169515,0.0,55624,116,0.08776028802574044,637,128,2,0,130,2264,0.01950859680346687,874,0,126,0,0.12192901983025697,0,1002,0,203,13,0,1218,799,0.06737860996740075,109508,53884,
0,0.0,0,0,0,0,6123,1511,169515,0.0,55624,116,0.08776028802574044,637,0,0,0,0,2264,0.01950859680346687,874,0,0,0,0.0,0,0,0,0,0,0,0,0,0.0,109508,53884,
0,0.0,0,0,0,0,6123,1511,169515,0.0,55624,116,0.08776028802574044,637,0,0,0,0,2264,0.01950859680346687,874,0,0,0,0.0,0,0,0,0,0,0,0,0,0.0,109508,53884,
0,0.0,0,0,0,0,6123,1511,169515,0.0,55624,116,0.08776028802574044,637,0,0,0,0,2264,0.01950859680346687,874,0,0,0,0.0,0,0,0,0,0,0,0,0,0.0,109508,53884,
0,0.0,0,0,0,0,6123,1511,169515,0.0,55624,116,0.08776028802574044,637,0,0,0,0,2264,0.01950859680346687,874,0,0,0,0.0,0,0,0,0,0,0,0,0,0.0,109508,53884,
0,0.0,0,0,0,0,6123,1511,169515,0.0,55624,116,0.08776028802574044,637,0,0,0,0,2264,0.01950859680346687,874,0,0,0,0.0,0,0,0,0,0,0,0,0,0.0,109508,53884,
0,0.0,0,0,0,0,6123,1511,169515,0.0,55624,116,0.08776028802574044,637,0,0,0,0,2264,0.01950859680346687,874,0,0,0,0.0,0,0,0,0,0,0,0,0,0.0,109508,53884,
0,0.0,0,0,0,0,6123,1511,169515,0.0,55624,116,0.08776028802574044,637,0,0,0,0,2264,0.01950859680346687,874,0,0,0,0.0,0,0,0,0,0,0,0,0,0.0,109508,53884,
0,0.0,0,0,0,0,6123,1511,169515,0.0,55624,116,0.08776028802574044,637,0,0,0,0,2264,0.01950859680346687,874,0,0,0,0.0,0,0,0,0,0,0,0,0,0.0,109508,53884,
0,0.0,0,0,0,0,6123,1511,169515,0.0,55624,116,0.08776028802574044,637,0,0,0,0,2264,0.01950859680346687,874,0,0,0,0.0,0,0,0,0,0,0,0,0,0.0,109508,53884,
0,0.0,0,0,0,0,6123,1511,169515,0.0,55624,116,0.08776028802574044,637,0,0,0,0,2264,0.01950859680346687,874,0,0,0,0.0,0,0,0,0,0,0,0,0,0.0,109508,53884,
0,0.0,0,0,0,0,6123,1511,169515,0.0,55624,116,0.08776028802574044,637,0,0,0,0,2264,0.01950859680346687,874,0,0,0,0.0,0,0,0,0,0,0,0,0,0.0,109508,53884,
0,0.0,0,0,0,0,6123,1511,169515,0.0,55624,116,0.08776028802574044,637,0,0,0,0,2264,0.01950859680346687,874,0,0,0,0.0,0,0,0,0,0,0,0,0,0.0,109508,53884,
0,0.0,0,0,0,0,6123,1511,169515,0.0,55624,116,0.08776028802574044,637,0,0,0,0,2264,0.01950859680346687,874,0,0,0,0.0,0,0,0,0,0,0,0,0,0.0,109508,53884,
0,0.0,0,0,0,0,6123,1511,169515,0.0,55624,116,0.08776028802574044,637,0,0,0,0,2264,0.01950859680346687,874,0,0,0,0.0,0,0,0,0,0,0,0,0,0.0,109508,53884,
0,0.0,0,0,0,0,6123,1511,169515,0.0,55624,116,0.08776028802574044,637,0,0,0,0,2264,0.01950859680346687,874,0,0,0,0.0,0,0,0,0,0,0,0,0,0.0,109508,53884,
0,0.0,0,0,0,0,6123,1511,169515,0.0,55624,116,0.08776028802574044,637,0,0,0,0,2264,0.01950859680346687,874,0,0,0,0.0,0,0,0,0,0,0,0,0,0.0,109508,53884,
0,0.0,0,0,0,0,6123,1511,169515,0.0,55624,116,0.08776028802574044,637,0,0,0,0,2264,0.01950859680346687,874,0,0,0,0.0,0,0,0,0,0,0,0,0,0.0,109508,53884,
0,0.0,0,0,0,0,6123,1511,169515,0.0,55624,116,0.08776028802574044,637,0,0,0,0,2264,0.01950859680346687,874,0,0,0,0.0,0,0,0,0,0,0,0,0,0.0,109508,53884,
0,0.0,0,0,0,0,6123,1511,169515,0.0,55624,116,0.08776028802574044,637,0,0,0,0,2264,0.01950859680346687,874,0,0,0,0.0,0,0,0,0,0,0,0,0,0.0,109508,53884,
0,0.0,0,0,0,0,6123,1511,169515,0.0,55624,116,0.08776028802574044,637,0,0,0,0,2264,0.01950859680346687,874,0,0,0,0.0,0,70,0,310,6,0,386,-240,0.0938417884511569,109508,53884,
0,0.0,0,0,0,0,6123,1511,169515,0.0,55624,116,0.08776028802574044,637,0,57,0,57,2264,0.01950859680346687,874,0,-57,0,0.08636363636363636,0,70,0,310,6,0,386,-240,0.0938417884511569,109508,53884,
0,0.0,0,0,0,0,6123,1511,169515,0.0,55624,116,0.08776028802574044,637,0,57,0,57,2264,0.01950859680346687,874,0,-57,0,0.08636363636363636,0,70,0,310,6,0,386,-240,0.0938417884511569,109508,53884,
0,0.0,0,0,0,0,6123,1511,169515,0.0,55624,116,0.08776028802574044,637,19,242,6,267,2264,0.01950859680346687,874,0,-223,0,0.14919395473760372,0,70,0,310,6,0,386,-240,0.0938417884511569,109508,53884,
0,0.0,0,0,0,0,6123,1511,169515,0.0,55624,116,0.08776028802574044,637,19,242,6,267,2264,0.01950859680346687,874,0,-223,0,0.14919395473760372,0,70,0,310,6,0,386,-240,0.0938417884511569,109508,53884,
0,0.0,0,0,0,0,6123,1511,169515,0.0,55624,116,0.08776028802574044,637,0,0,0,0,2264,0.01950859680346687,874,0,0,0,0.0,0,0,0,0,0,0,0,0,0.0,109508,53884,
0,0.0,0,0,0,0,6123,1511,169515,0.0,55624,116,0.08776028802574044,637,0,0,0,0,2264,0.01950859680346687,874,0,0,0,0.0,0,0,0,0,0,0,0,0,0.0,109508,53884,
0,0.0,0,0,0,0,6123,1511,169515,0.0,55624,116,0.08776028802574044,637,0,0,0,0,2264,0.01950859680346687,874,0,0,0,0.0,0,0,0,0,0,0,0,0,0.0,109508,53884,
0,0.0,0,0,0,0,6123,1511,169515,0.0,55624,116,0.08776028802574044,637,0,0,0,0,2264,0.01950859680346687,874,0,0,0,0.0,0,0,0,0,0,0,0,0,0.0,109508,53884,
0,0.0,0,0,0,0,6123,1511,169515,0.0,55624,116,0.08776028802574044,637,0,0,0,0,2264,0.01950859680346687,874,0,0,0,0.0,0,0,0,0,0,0,0,0,0.0,109508,53884,
0,0.0,0,0,0,0,6123,1511,169515,0.0,55624,116,0.08776028802574044,637,0,0,0,0,2264,0.01950859680346687,874,0,0,0,0.0,0,0,0,0,0,0,0,0,0.0,109508,53884,
0,0.0,0,0,0,0,6123,1511,169515,0.0,55624,116,0.08776028802574044,637,0,0,0,0,2264,0.01950859680346687,874,0,0,0,0.0,0,0,0,0,0,0,0,0,0.0,109508,53884,
0,0.0,0,0,0,0,6123,1511,169515,0.0,55624,116,0.08776028802574044,637,0,0,0,0,2264,0.01950859680346687,874,0,0,0,0.0,0,0,0,0,0,0,0,0,0.0,109508,53884,
0,0.0,0,0,0,0,6123,1511,169515,0.0,55624,116,0.08776028802574044,637,0,0,0,0,2264,0.01950859680346687,874,0,0,0,0.0,0,0,0,0,0,0,0,0,0.0,109508,53884,
0,0.0,0,0,0,0,6123,1511,169515,0.0,55624,116,0.08776028802574044,637,0,0,0,0,2264,0.01950859680346687,874,0,0,0,0.0,0,0,0,0,0,0,0,0,0.0,109508,53884,
0,0.0,0,0,0,0,6123,1511,169515,0.0,55624,116,0.08776028802574044,637,0,0,0,0,2264,0.01950859680346687,874,0,0,0,0.0,0,0,0,0,0,0,0,0,0.0,109508,53884,
0,0.0,0,0,0,0,6123,1511,169515,0.0,55624,116,0.08776028802574044,637,0,0,0,0,2264,0.01950859680346687,874,0,0,0,0.0,0,0,0,0,0,0,0,0,0.0,109508,53884,
0,0.0,0,0,0,0,6123,1511,169515,0.0,55624,116,0.08776028802574044,637,0,0,0,0,2264,0.01950859680346687,874,0,0,0,0.0,0,0,0,0,0,0,0,0,0.0,109508,53884,
0,0.0,0,0,0,0,6123,1511,169515,0.0,55624,116,0.08776028802574044,637,0,0,0,0,2264,0.01950859680346687,874,0,0,0,0.0,0,0,0,0,0,0,0,0,0.0,109508,53884,
0,0.0,0,0,0,0,6123,1511,169515,0.0,55624,116,0.08776028802574044,637,0,0,0,0,2264,0.01950859680346687,874,0,0,0,0.0,0,0,0,0,0,0,0,0,0.0,109508,53884,
0,0.0,0,0,0,0,6123,1511,169515,0.0,55624,116,0.08776028802574044,637,0,0,0,0,2264,0.01950859680346687,874,0,0,0,0.0,0,0,0,0,0,0,0,0,0.0,109508,53884,
