F41,F40,F43,F42,F45,F44,F140,F47,F141,F46,F142,F49,F143,F48,F126,F127,F128,F129,F50,F52,F51,F36,F130,F35,F131,F38,F132,F37,F133,F134,F39,F135,F136,F137,F138,F139,
0,0.0,0,0,0,0,109930,7193,434139,0.0,156813,551,0.09131187832064054,4463,0,0,0,0,12207,0.024494189081567117,2730,0,0,0,0.0,0,0,0,0,0,0,0,0,0.0,240511,83698,
123,0.0019801980198019802,2,28,95,153,109930,7193,434139,0.005629552831448794,156813,551,0.09131187832064054,4463,255,17,3,275,12207,0.024494189081567117,2730,0,238,2,0.08569036486321428,2,3263,0,1225,1484,2,5972,2038,0.07316798425409862,240511,83698,
123,0.0018709073900841909,2,28,95,153,109930,7193,434139,0.005629552831448794,156813,551,0.09131187832064054,4463,100,53,137,290,12207,0.024494189081567117,2730,0,47,2,0.01728740581823983,2,3263,0,1225,1484,2,5972,2038,0.07316798425409862,240511,83698,
123,0.0018709073900841909,2,28,95,153,109930,7193,434139,0.005629552831448794,156813,551,0.09131187832064054,4463,100,53,137,290,12207,0.024494189081567117,2730,0,47,2,0.01728740581823983,2,3263,0,1225,1484,2,5972,2038,0.07316798425409862,240511,83698,
70,0.0,0,40,30,110,109930,7193,434139,0.029338004501884122,156813,551,0.09131187832064054,4463,78,15,312,405,12207,0.024494189081567117,2730,0,63,0,0.09479868891526508,0,1327,0,514,2428,0,4269,813,0.021736404656336375,240511,83698,
70,0.0,0,40,30,110,109930,7193,434139,0.029338004501884122,156813,551,0.09131187832064054,4463,79,62,231,372,12207,0.024494189081567117,2730,0,17,0,0.022609967470655457,0,1327,0,514,2428,0,4269,813,0.021736404656336375,240511,83698,
134,0.0,0,45,89,179,109930,7193,434139,0.03670600663311693,156813,551,0.09131187832064054,4463,0,0,0,0,12207,0.024494189081567117,2730,0,0,0,0.0,0,831,0,130,23,0,984,701,0.17124869418035807,240511,83698,
2,0.0,0,2,0,4,109930,7193,434139,0.007603041216486594,156813,551,0.09131187832064054,4463,251,22,3,276,12207,0.024494189081567117,2730,0,229,0,0.11706651383159183,0,1226,0,212,740,0,2178,1014,0.08054472593063824,240511,83698,
2,0.0,0,2,0,4,109930,7193,434139,0.007603041216486594,156813,551,0.09131187832064054,4463,251,22,3,276,12207,0.024494189081567117,2730,0,229,0,0.11706651383159183,0,1226,0,212,740,0,2178,1014,0.08054472593063824,240511,83698,
2,0.0,0,2,0,4,109930,7193,434139,0.007603041216486594,156813,551,0.09131187832064054,4463,251,22,3,276,12207,0.024494189081567117,2730,0,229,0,0.11706651383159183,0,1226,0,212,740,0,2178,1014,0.08054472593063824,240511,83698,
2,0.0,0,2,0,4,109930,7193,434139,0.007603041216486594,156813,551,0.09131187832064054,4463,251,22,3,276,12207,0.024494189081567117,2730,0,229,0,0.11706651383159183,0,1226,0,212,740,0,2178,1014,0.08054472593063824,240511,83698,
2,0.07142857142857142,0,2,0,4,109930,7193,434139,0.007603041216486594,156813,551,0.09131187832064054,4463,8,7,321,336,12207,0.024494189081567117,2730,0,1,1,0.0474241268590055,1,1226,0,212,740,1,2178,1014,0.08054472593063824,240511,83698,
2,0.07142857142857142,0,2,0,4,109930,7193,434139,0.007603041216486594,156813,551,0.09131187832064054,4463,8,7,321,336,12207,0.024494189081567117,2730,0,1,1,0.0474241268590055,1,1226,0,212,740,1,2178,1014,0.08054472593063824,240511,83698,
2,0.0,0,2,0,4,109930,7193,434139,0.007603041216486594,156813,551,0.09131187832064054,4463,5,5,73,83,12207,0.024494189081567117,2730,0,0,0,0.01713981568336345,0,1226,0,212,740,0,2178,1014,0.08054472593063824,240511,83698,
17,0.0,4,17,0,38,109930,7193,434139,0.0328722638490908,156813,551,0.09131187832064054,4463,161,0,0,161,12207,0.024494189081567117,2730,0,161,0,0.3788235294117647,0,1843,0,319,764,0,2926,1524,0.07543626361478753,240511,83698,
17,0.013937282229965157,4,17,0,38,109930,7193,434139,0.0328722638490908,156813,551,0.09131187832064054,4463,178,9,182,369,12207,0.024494189081567117,2730,2,169,2,0.039914645963655196,4,1843,0,319,764,0,2926,1524,0.07543626361478753,240511,83698,
17,0.006172839506172839,4,17,0,38,109930,7193,434139,0.0328722638490908,156813,551,0.09131187832064054,4463,190,7,7,204,12207,0.024494189081567117,2730,0,183,0,0.012851134454999273,1,1843,1,319,764,0,2926,1524,0.07543626361478753,240511,83698,
17,0.006666666666666667,4,17,0,38,109930,7193,434139,0.0328722638490908,156813,551,0.09131187832064054,4463,641,34,1,676,12207,0.024494189081567117,2730,1,607,1,0.06717458985701424,2,1843,0,319,764,0,2926,1524,0.07543626361478753,240511,83698,
17,0.006666666666666667,4,17,0,38,109930,7193,434139,0.0328722638490908,156813,551,0.09131187832064054,4463,641,34,1,676,12207,0.024494189081567117,2730,1,607,1,0.06717458985701424,2,1843,0,319,764,0,2926,1524,0.07543626361478753,240511,83698,
17,0.006666666666666667,4,17,0,38,109930,7193,434139,0.0328722638490908,156813,551,0.09131187832064054,4463,641,34,1,676,12207,0.024494189081567117,2730,1,607,1,0.06717458985701424,2,1843,0,319,764,0,2926,1524,0.07543626361478753,240511,83698,
17,0.006666666666666667,4,17,0,38,109930,7193,434139,0.0328722638490908,156813,551,0.09131187832064054,4463,641,34,1,676,12207,0.024494189081567117,2730,1,607,1,0.06717458985701424,2,1843,0,319,764,0,2926,1524,0.07543626361478753,240511,83698,
296,0.010362694300518135,46,102,194,444,109930,7193,434139,0.08368408577164388,156813,551,0.09131187832064054,4463,432,107,6,545,12207,0.024494189081567117,2730,1,325,1,0.15573118784013573,2,2954,0,624,1158,0,4736,2330,0.1404155404962785,240511,83698,
296,0.010362694300518135,46,102,194,444,109930,7193,434139,0.08368408577164388,156813,551,0.09131187832064054,4463,432,107,6,545,12207,0.024494189081567117,2730,1,325,1,0.15573118784013573,2,2954,0,624,1158,0,4736,2330,0.1404155404962785,240511,83698,
296,0.0,46,102,194,444,109930,7193,434139,0.08368408577164388,156813,551,0.09131187832064054,4463,493,45,26,564,12207,0.024494189081567117,2730,0,448,0,0.12515875813000593,0,2954,0,624,1158,0,4736,2330,0.1404155404962785,240511,83698,
296,0.2622381930334766,46,102,194,444,109930,7193,434139,0.08368408577164388,156813,551,0.09131187832064054,4463,701,106,20,827,12207,0.024494189081567117,2730,87,595,120,0.13311171416041437,227,2954,20,624,1158,33,4736,2330,0.1404155404962785,240511,83698,
296,0.2622381930334766,46,102,194,444,109930,7193,434139,0.08368408577164388,156813,551,0.09131187832064054,4463,701,106,20,827,12207,0.024494189081567117,2730,87,595,120,0.13311171416041437,227,2954,20,624,1158,33,4736,2330,0.1404155404962785,240511,83698,
296,0.2622381930334766,46,102,194,444,109930,7193,434139,0.08368408577164388,156813,551,0.09131187832064054,4463,701,106,20,827,12207,0.024494189081567117,2730,87,595,120,0.13311171416041437,227,2954,20,624,1158,33,4736,2330,0.1404155404962785,240511,83698,
296,0.121522287869962,46,102,194,444,109930,7193,434139,0.08368408577164388,156813,551,0.09131187832064054,4463,23,5,157,185,12207,0.024494189081567117,2730,3,18,22,0.04983245273843871,25,2954,0,624,1158,19,4736,2330,0.1404155404962785,240511,83698,
296,0.121522287869962,46,102,194,444,109930,7193,434139,0.08368408577164388,156813,551,0.09131187832064054,4463,23,5,157,185,12207,0.024494189081567117,2730,3,18,22,0.04983245273843871,25,2954,0,624,1158,19,4736,2330,0.1404155404962785,240511,83698,
296,0.121522287869962,46,102,194,444,109930,7193,434139,0.08368408577164388,156813,551,0.09131187832064054,4463,23,5,157,185,12207,0.024494189081567117,2730,3,18,22,0.04983245273843871,25,2954,0,624,1158,19,4736,2330,0.1404155404962785,240511,83698,
296,0.121522287869962,46,102,194,444,109930,7193,434139,0.08368408577164388,156813,551,0.09131187832064054,4463,23,5,157,185,12207,0.024494189081567117,2730,3,18,22,0.04983245273843871,25,2954,0,624,1158,19,4736,2330,0.1404155404962785,240511,83698,
296,0.121522287869962,46,102,194,444,109930,7193,434139,0.08368408577164388,156813,551,0.09131187832064054,4463,23,5,157,185,12207,0.024494189081567117,2730,3,18,22,0.04983245273843871,25,2954,0,624,1158,19,4736,2330,0.1404155404962785,240511,83698,
296,0.26842105263157895,46,102,194,444,109930,7193,434139,0.08368408577164388,156813,551,0.09131187832064054,4463,102,0,0,102,12207,0.024494189081567117,2730,0,102,102,0.26842105263157895,102,2954,0,624,1158,102,4736,2330,0.1404155404962785,240511,83698,
296,0.26842105263157895,46,102,194,444,109930,7193,434139,0.08368408577164388,156813,551,0.09131187832064054,4463,102,0,0,102,12207,0.024494189081567117,2730,0,102,102,0.26842105263157895,102,2954,0,624,1158,102,4736,2330,0.1404155404962785,240511,83698,
296,0.0,46,102,194,444,109930,7193,434139,0.08368408577164388,156813,551,0.09131187832064054,4463,294,34,4,332,12207,0.024494189081567117,2730,0,260,0,0.2084355021089158,0,2954,0,624,1158,0,4736,2330,0.1404155404962785,240511,83698,
106,0.1875,3,310,-204,419,109930,7193,434139,0.08372509356466813,156813,551,0.09131187832064054,4463,252,299,44,595,12207,0.024494189081567117,2730,2,-47,1,0.18072555800595144,3,6066,0,2235,3531,-1,11832,3831,0.1020896558533029,240511,83698,
106,0.2704771997214209,3,310,-204,419,109930,7193,434139,0.08372509356466813,156813,551,0.09131187832064054,4463,1295,566,211,2072,12207,0.024494189081567117,2730,205,729,33,0.23345228019366765,241,6066,3,2235,3531,-172,11832,3831,0.1020896558533029,240511,83698,
106,0.2704771997214209,3,310,-204,419,109930,7193,434139,0.08372509356466813,156813,551,0.09131187832064054,4463,1295,566,211,2072,12207,0.024494189081567117,2730,205,729,33,0.23345228019366765,241,6066,3,2235,3531,-172,11832,3831,0.1020896558533029,240511,83698,
106,0.2704771997214209,3,310,-204,419,109930,7193,434139,0.08372509356466813,156813,551,0.09131187832064054,4463,1295,566,211,2072,12207,0.024494189081567117,2730,205,729,33,0.23345228019366765,241,6066,3,2235,3531,-172,11832,3831,0.1020896558533029,240511,83698,
106,0.0,3,310,-204,419,109930,7193,434139,0.08372509356466813,156813,551,0.09131187832064054,4463,12,1,147,160,12207,0.024494189081567117,2730,0,11,0,0.039159870531581,0,6066,0,2235,3531,0,11832,3831,0.1020896558533029,240511,83698,
106,0.22871872575344582,3,310,-204,419,109930,7193,434139,0.08372509356466813,156813,551,0.09131187832064054,4463,1060,729,223,2012,12207,0.024494189081567117,2730,78,331,54,0.1783417131933627,132,6066,0,2235,3531,-24,11832,3831,0.1020896558533029,240511,83698,
106,0.22871872575344582,3,310,-204,419,109930,7193,434139,0.08372509356466813,156813,551,0.09131187832064054,4463,1060,729,223,2012,12207,0.024494189081567117,2730,78,331,54,0.1783417131933627,132,6066,0,2235,3531,-24,11832,3831,0.1020896558533029,240511,83698,
106,0.22871872575344582,3,310,-204,419,109930,7193,434139,0.08372509356466813,156813,551,0.09131187832064054,4463,1060,729,223,2012,12207,0.024494189081567117,2730,78,331,54,0.1783417131933627,132,6066,0,2235,3531,-24,11832,3831,0.1020896558533029,240511,83698,
106,0.22871872575344582,3,310,-204,419,109930,7193,434139,0.08372509356466813,156813,551,0.09131187832064054,4463,1060,729,223,2012,12207,0.024494189081567117,2730,78,331,54,0.1783417131933627,132,6066,0,2235,3531,-24,11832,3831,0.1020896558533029,240511,83698,
106,0.22871872575344582,3,310,-204,419,109930,7193,434139,0.08372509356466813,156813,551,0.09131187832064054,4463,1060,729,223,2012,12207,0.024494189081567117,2730,78,331,54,0.1783417131933627,132,6066,0,2235,3531,-24,11832,3831,0.1020896558533029,240511,83698,
106,0.22871872575344582,3,310,-204,419,109930,7193,434139,0.08372509356466813,156813,551,0.09131187832064054,4463,1060,729,223,2012,12207,0.024494189081567117,2730,78,331,54,0.1783417131933627,132,6066,0,2235,3531,-24,11832,3831,0.1020896558533029,240511,83698,
106,0.22871872575344582,3,310,-204,419,109930,7193,434139,0.08372509356466813,156813,551,0.09131187832064054,4463,1060,729,223,2012,12207,0.024494189081567117,2730,78,331,54,0.1783417131933627,132,6066,0,2235,3531,-24,11832,3831,0.1020896558533029,240511,83698,
106,0.22871872575344582,3,310,-204,419,109930,7193,434139,0.08372509356466813,156813,551,0.09131187832064054,4463,1060,729,223,2012,12207,0.024494189081567117,2730,78,331,54,0.1783417131933627,132,6066,0,2235,3531,-24,11832,3831,0.1020896558533029,240511,83698,
106,0.058087609469074986,3,310,-204,419,109930,7193,434139,0.08372509356466813,156813,551,0.09131187832064054,4463,1531,249,1211,2991,12207,0.024494189081567117,2730,5,1282,7,0.14141230458691403,12,6066,0,2235,3531,2,11832,3831,0.1020896558533029,240511,83698,
106,0.058087609469074986,3,310,-204,419,109930,7193,434139,0.08372509356466813,156813,551,0.09131187832064054,4463,1531,249,1211,2991,12207,0.024494189081567117,2730,5,1282,7,0.14141230458691403,12,6066,0,2235,3531,2,11832,3831,0.1020896558533029,240511,83698,
120,0.0,15,483,-363,618,109930,7193,434139,0.06894003982443854,156813,551,0.09131187832064054,4463,712,93,29,834,12207,0.024494189081567117,2730,0,619,0,0.08083324245772158,0,13588,0,5740,5099,0,24427,7848,0.12475931289645256,240511,83698,
120,0.0,15,483,-363,618,109930,7193,434139,0.06894003982443854,156813,551,0.09131187832064054,4463,712,93,29,834,12207,0.024494189081567117,2730,0,619,0,0.08083324245772158,0,13588,0,5740,5099,0,24427,7848,0.12475931289645256,240511,83698,
120,0.0,15,483,-363,618,109930,7193,434139,0.06894003982443854,156813,551,0.09131187832064054,4463,712,93,29,834,12207,0.024494189081567117,2730,0,619,0,0.08083324245772158,0,13588,0,5740,5099,0,24427,7848,0.12475931289645256,240511,83698,
120,0.0,15,483,-363,618,109930,7193,434139,0.06894003982443854,156813,551,0.09131187832064054,4463,712,93,29,834,12207,0.024494189081567117,2730,0,619,0,0.08083324245772158,0,13588,0,5740,5099,0,24427,7848,0.12475931289645256,240511,83698,
120,0.4166666666666667,15,483,-363,618,109930,7193,434139,0.06894003982443854,156813,551,0.09131187832064054,4463,215,100,22,337,12207,0.024494189081567117,2730,0,115,10,0.12604704021045637,10,13588,0,5740,5099,10,24427,7848,0.12475931289645256,240511,83698,
120,0.4166666666666667,15,483,-363,618,109930,7193,434139,0.06894003982443854,156813,551,0.09131187832064054,4463,215,100,22,337,12207,0.024494189081567117,2730,0,115,10,0.12604704021045637,10,13588,0,5740,5099,10,24427,7848,0.12475931289645256,240511,83698,
120,0.4166666666666667,15,483,-363,618,109930,7193,434139,0.06894003982443854,156813,551,0.09131187832064054,4463,215,100,22,337,12207,0.024494189081567117,2730,0,115,10,0.12604704021045637,10,13588,0,5740,5099,10,24427,7848,0.12475931289645256,240511,83698,
120,0.026915113871635612,15,483,-363,618,109930,7193,434139,0.06894003982443854,156813,551,0.09131187832064054,4463,349,72,11,432,12207,0.024494189081567117,2730,36,277,1,0.1296026928284497,39,13588,2,5740,5099,-35,24427,7848,0.12475931289645256,240511,83698,
120,0.026915113871635612,15,483,-363,618,109930,7193,434139,0.06894003982443854,156813,551,0.09131187832064054,4463,349,72,11,432,12207,0.024494189081567117,2730,36,277,1,0.1296026928284497,39,13588,2,5740,5099,-35,24427,7848,0.12475931289645256,240511,83698,
120,0.026915113871635612,15,483,-363,618,109930,7193,434139,0.06894003982443854,156813,551,0.09131187832064054,4463,349,72,11,432,12207,0.024494189081567117,2730,36,277,1,0.1296026928284497,39,13588,2,5740,5099,-35,24427,7848,0.12475931289645256,240511,83698,
120,0.026915113871635612,15,483,-363,618,109930,7193,434139,0.06894003982443854,156813,551,0.09131187832064054,4463,349,72,11,432,12207,0.024494189081567117,2730,36,277,1,0.1296026928284497,39,13588,2,5740,5099,-35,24427,7848,0.12475931289645256,240511,83698,
120,0.026915113871635612,15,483,-363,618,109930,7193,434139,0.06894003982443854,156813,551,0.09131187832064054,4463,349,72,11,432,12207,0.024494189081567117,2730,36,277,1,0.1296026928284497,39,13588,2,5740,5099,-35,24427,7848,0.12475931289645256,240511,83698,
120,0.026915113871635612,15,483,-363,618,109930,7193,434139,0.06894003982443854,156813,551,0.09131187832064054,4463,349,72,11,432,12207,0.024494189081567117,2730,36,277,1,0.1296026928284497,39,13588,2,5740,5099,-35,24427,7848,0.12475931289645256,240511,83698,
120,0.0,15,483,-363,618,109930,7193,434139,0.06894003982443854,156813,551,0.09131187832064054,4463,68,35,713,816,12207,0.024494189081567117,2730,0,33,0,0.0798249959343742,0,13588,0,5740,5099,0,24427,7848,0.12475931289645256,240511,83698,
120,0.0,15,483,-363,618,109930,7193,434139,0.06894003982443854,156813,551,0.09131187832064054,4463,68,35,713,816,12207,0.024494189081567117,2730,0,33,0,0.0798249959343742,0,13588,0,5740,5099,0,24427,7848,0.12475931289645256,240511,83698,
120,0.0,15,483,-363,618,109930,7193,434139,0.06894003982443854,156813,551,0.09131187832064054,4463,68,35,713,816,12207,0.024494189081567117,2730,0,33,0,0.0798249959343742,0,13588,0,5740,5099,0,24427,7848,0.12475931289645256,240511,83698,
120,0.0,15,483,-363,618,109930,7193,434139,0.06894003982443854,156813,551,0.09131187832064054,4463,68,35,713,816,12207,0.024494189081567117,2730,0,33,0,0.0798249959343742,0,13588,0,5740,5099,0,24427,7848,0.12475931289645256,240511,83698,
120,0.0,15,483,-363,618,109930,7193,434139,0.06894003982443854,156813,551,0.09131187832064054,4463,0,0,0,0,12207,0.024494189081567117,2730,0,0,0,0.0,0,13588,0,5740,5099,0,24427,7848,0.12475931289645256,240511,83698,
120,0.2222222222222222,15,483,-363,618,109930,7193,434139,0.06894003982443854,156813,551,0.09131187832064054,4463,259,114,126,499,12207,0.024494189081567117,2730,2,145,2,0.18755188137813766,4,13588,0,5740,5099,0,24427,7848,0.12475931289645256,240511,83698,
120,0.2222222222222222,15,483,-363,618,109930,7193,434139,0.06894003982443854,156813,551,0.09131187832064054,4463,259,114,126,499,12207,0.024494189081567117,2730,2,145,2,0.18755188137813766,4,13588,0,5740,5099,0,24427,7848,0.12475931289645256,240511,83698,
120,0.2222222222222222,15,483,-363,618,109930,7193,434139,0.06894003982443854,156813,551,0.09131187832064054,4463,259,114,126,499,12207,0.024494189081567117,2730,2,145,2,0.18755188137813766,4,13588,0,5740,5099,0,24427,7848,0.12475931289645256,240511,83698,
120,0.2222222222222222,15,483,-363,618,109930,7193,434139,0.06894003982443854,156813,551,0.09131187832064054,4463,259,114,126,499,12207,0.024494189081567117,2730,2,145,2,0.18755188137813766,4,13588,0,5740,5099,0,24427,7848,0.12475931289645256,240511,83698,
120,0.2222222222222222,15,483,-363,618,109930,7193,434139,0.06894003982443854,156813,551,0.09131187832064054,4463,259,114,126,499,12207,0.024494189081567117,2730,2,145,2,0.18755188137813766,4,13588,0,5740,5099,0,24427,7848,0.12475931289645256,240511,83698,
120,0.2222222222222222,15,483,-363,618,109930,7193,434139,0.06894003982443854,156813,551,0.09131187832064054,4463,259,114,126,499,12207,0.024494189081567117,2730,2,145,2,0.18755188137813766,4,13588,0,5740,5099,0,24427,7848,0.12475931289645256,240511,83698,
120,0.2222222222222222,15,483,-363,618,109930,7193,434139,0.06894003982443854,156813,551,0.09131187832064054,4463,259,114,126,499,12207,0.024494189081567117,2730,2,145,2,0.18755188137813766,4,13588,0,5740,5099,0,24427,7848,0.12475931289645256,240511,83698,
120,0.2222222222222222,15,483,-363,618,109930,7193,434139,0.06894003982443854,156813,551,0.09131187832064054,4463,259,114,126,499,12207,0.024494189081567117,2730,2,145,2,0.18755188137813766,4,13588,0,5740,5099,0,24427,7848,0.12475931289645256,240511,83698,
120,0.2222222222222222,15,483,-363,618,109930,7193,434139,0.06894003982443854,156813,551,0.09131187832064054,4463,259,114,126,499,12207,0.024494189081567117,2730,2,145,2,0.18755188137813766,4,13588,0,5740,5099,0,24427,7848,0.12475931289645256,240511,83698,
120,0.2222222222222222,15,483,-363,618,109930,7193,434139,0.06894003982443854,156813,551,0.09131187832064054,4463,259,114,126,499,12207,0.024494189081567117,2730,2,145,2,0.18755188137813766,4,13588,0,5740,5099,0,24427,7848,0.12475931289645256,240511,83698,
120,0.2222222222222222,15,483,-363,618,109930,7193,434139,0.06894003982443854,156813,551,0.09131187832064054,4463,259,114,126,499,12207,0.024494189081567117,2730,2,145,2,0.18755188137813766,4,13588,0,5740,5099,0,24427,7848,0.12475931289645256,240511,83698,
120,0.08922558922558922,15,483,-363,618,109930,7193,434139,0.06894003982443854,156813,551,0.09131187832064054,4463,470,349,80,899,12207,0.024494189081567117,2730,0,121,5,0.2144649626958225,7,13588,2,5740,5099,5,24427,7848,0.12475931289645256,240511,83698,
120,0.08922558922558922,15,483,-363,618,109930,7193,434139,0.06894003982443854,156813,551,0.09131187832064054,4463,470,349,80,899,12207,0.024494189081567117,2730,0,121,5,0.2144649626958225,7,13588,2,5740,5099,5,24427,7848,0.12475931289645256,240511,83698,
120,0.08922558922558922,15,483,-363,618,109930,7193,434139,0.06894003982443854,156813,551,0.09131187832064054,4463,470,349,80,899,12207,0.024494189081567117,2730,0,121,5,0.2144649626958225,7,13588,2,5740,5099,5,24427,7848,0.12475931289645256,240511,83698,
120,0.09382151029748284,15,483,-363,618,109930,7193,434139,0.06894003982443854,156813,551,0.09131187832064054,4463,312,367,103,782,12207,0.024494189081567117,2730,4,-55,4,0.17743708550886503,8,13588,0,5740,5099,0,24427,7848,0.12475931289645256,240511,83698,
120,0.0,15,483,-363,618,109930,7193,434139,0.06894003982443854,156813,551,0.09131187832064054,4463,847,289,195,1331,12207,0.024494189081567117,2730,0,558,0,0.28282844996929,0,13588,0,5740,5099,0,24427,7848,0.12475931289645256,240511,83698,
120,0.0,15,483,-363,618,109930,7193,434139,0.06894003982443854,156813,551,0.09131187832064054,4463,847,289,195,1331,12207,0.024494189081567117,2730,0,558,0,0.28282844996929,0,13588,0,5740,5099,0,24427,7848,0.12475931289645256,240511,83698,
120,0.0,15,483,-363,618,109930,7193,434139,0.06894003982443854,156813,551,0.09131187832064054,4463,847,289,195,1331,12207,0.024494189081567117,2730,0,558,0,0.28282844996929,0,13588,0,5740,5099,0,24427,7848,0.12475931289645256,240511,83698,
120,0.0,15,483,-363,618,109930,7193,434139,0.06894003982443854,156813,551,0.09131187832064054,4463,847,289,195,1331,12207,0.024494189081567117,2730,0,558,0,0.28282844996929,0,13588,0,5740,5099,0,24427,7848,0.12475931289645256,240511,83698,
120,0.0,15,483,-363,618,109930,7193,434139,0.06894003982443854,156813,551,0.09131187832064054,4463,97,41,31,169,12207,0.024494189081567117,2730,0,56,0,0.12667024132415508,0,13588,0,5740,5099,0,24427,7848,0.12475931289645256,240511,83698,
120,0.0,15,483,-363,618,109930,7193,434139,0.06894003982443854,156813,551,0.09131187832064054,4463,97,41,31,169,12207,0.024494189081567117,2730,0,56,0,0.12667024132415508,0,13588,0,5740,5099,0,24427,7848,0.12475931289645256,240511,83698,
120,0.0,15,483,-363,618,109930,7193,434139,0.06894003982443854,156813,551,0.09131187832064054,4463,97,41,31,169,12207,0.024494189081567117,2730,0,56,0,0.12667024132415508,0,13588,0,5740,5099,0,24427,7848,0.12475931289645256,240511,83698,
120,0.1524945945378592,15,483,-363,618,109930,7193,434139,0.06894003982443854,156813,551,0.09131187832064054,4463,2098,1228,339,3665,12207,0.024494189081567117,2730,36,870,20,0.1895008823692245,56,13588,0,5740,5099,-16,24427,7848,0.12475931289645256,240511,83698,
120,0.1524945945378592,15,483,-363,618,109930,7193,434139,0.06894003982443854,156813,551,0.09131187832064054,4463,2098,1228,339,3665,12207,0.024494189081567117,2730,36,870,20,0.1895008823692245,56,13588,0,5740,5099,-16,24427,7848,0.12475931289645256,240511,83698,
120,0.1524945945378592,15,483,-363,618,109930,7193,434139,0.06894003982443854,156813,551,0.09131187832064054,4463,2098,1228,339,3665,12207,0.024494189081567117,2730,36,870,20,0.1895008823692245,56,13588,0,5740,5099,-16,24427,7848,0.12475931289645256,240511,83698,
120,0.1524945945378592,15,483,-363,618,109930,7193,434139,0.06894003982443854,156813,551,0.09131187832064054,4463,2098,1228,339,3665,12207,0.024494189081567117,2730,36,870,20,0.1895008823692245,56,13588,0,5740,5099,-16,24427,7848,0.12475931289645256,240511,83698,
120,0.1524945945378592,15,483,-363,618,109930,7193,434139,0.06894003982443854,156813,551,0.09131187832064054,4463,2098,1228,339,3665,12207,0.024494189081567117,2730,36,870,20,0.1895008823692245,56,13588,0,5740,5099,-16,24427,7848,0.12475931289645256,240511,83698,
120,0.1524945945378592,15,483,-363,618,109930,7193,434139,0.06894003982443854,156813,551,0.09131187832064054,4463,2098,1228,339,3665,12207,0.024494189081567117,2730,36,870,20,0.1895008823692245,56,13588,0,5740,5099,-16,24427,7848,0.12475931289645256,240511,83698,
120,0.1524945945378592,15,483,-363,618,109930,7193,434139,0.06894003982443854,156813,551,0.09131187832064054,4463,2098,1228,339,3665,12207,0.024494189081567117,2730,36,870,20,0.1895008823692245,56,13588,0,5740,5099,-16,24427,7848,0.12475931289645256,240511,83698,
120,0.1524945945378592,15,483,-363,618,109930,7193,434139,0.06894003982443854,156813,551,0.09131187832064054,4463,2098,1228,339,3665,12207,0.024494189081567117,2730,36,870,20,0.1895008823692245,56,13588,0,5740,5099,-16,24427,7848,0.12475931289645256,240511,83698,
120,0.1524945945378592,15,483,-363,618,109930,7193,434139,0.06894003982443854,156813,551,0.09131187832064054,4463,2098,1228,339,3665,12207,0.024494189081567117,2730,36,870,20,0.1895008823692245,56,13588,0,5740,5099,-16,24427,7848,0.12475931289645256,240511,83698,
120,0.1524945945378592,15,483,-363,618,109930,7193,434139,0.06894003982443854,156813,551,0.09131187832064054,4463,2098,1228,339,3665,12207,0.024494189081567117,2730,36,870,20,0.1895008823692245,56,13588,0,5740,5099,-16,24427,7848,0.12475931289645256,240511,83698,
120,0.1524945945378592,15,483,-363,618,109930,7193,434139,0.06894003982443854,156813,551,0.09131187832064054,4463,2098,1228,339,3665,12207,0.024494189081567117,2730,36,870,20,0.1895008823692245,56,13588,0,5740,5099,-16,24427,7848,0.12475931289645256,240511,83698,
120,0.1524945945378592,15,483,-363,618,109930,7193,434139,0.06894003982443854,156813,551,0.09131187832064054,4463,2098,1228,339,3665,12207,0.024494189081567117,2730,36,870,20,0.1895008823692245,56,13588,0,5740,5099,-16,24427,7848,0.12475931289645256,240511,83698,
120,0.1524945945378592,15,483,-363,618,109930,7193,434139,0.06894003982443854,156813,551,0.09131187832064054,4463,2098,1228,339,3665,12207,0.024494189081567117,2730,36,870,20,0.1895008823692245,56,13588,0,5740,5099,-16,24427,7848,0.12475931289645256,240511,83698,
120,0.1524945945378592,15,483,-363,618,109930,7193,434139,0.06894003982443854,156813,551,0.09131187832064054,4463,2098,1228,339,3665,12207,0.024494189081567117,2730,36,870,20,0.1895008823692245,56,13588,0,5740,5099,-16,24427,7848,0.12475931289645256,240511,83698,
120,0.1524945945378592,15,483,-363,618,109930,7193,434139,0.06894003982443854,156813,551,0.09131187832064054,4463,2098,1228,339,3665,12207,0.024494189081567117,2730,36,870,20,0.1895008823692245,56,13588,0,5740,5099,-16,24427,7848,0.12475931289645256,240511,83698,
120,0.04918032786885246,15,483,-363,618,109930,7193,434139,0.06894003982443854,156813,551,0.09131187832064054,4463,257,170,25,452,12207,0.024494189081567117,2730,2,87,1,0.1173794589377776,3,13588,0,5740,5099,-1,24427,7848,0.12475931289645256,240511,83698,
120,0.44086021505376344,15,483,-363,618,109930,7193,434139,0.06894003982443854,156813,551,0.09131187832064054,4463,377,275,71,723,12207,0.024494189081567117,2730,14,102,17,0.13040512115135355,41,13588,10,5740,5099,3,24427,7848,0.12475931289645256,240511,83698,
120,0.19871794871794873,15,483,-363,618,109930,7193,434139,0.06894003982443854,156813,551,0.09131187832064054,4463,740,77,620,1437,12207,0.024494189081567117,2730,4,663,6,0.11050798182602767,10,13588,0,5740,5099,2,24427,7848,0.12475931289645256,240511,83698,
120,0.03896103896103896,15,483,-363,618,109930,7193,434139,0.06894003982443854,156813,551,0.09131187832064054,4463,164,180,26,370,12207,0.024494189081567117,2730,2,-16,4,0.13359830926268557,6,13588,0,5740,5099,2,24427,7848,0.12475931289645256,240511,83698,
120,0.011976047904191617,15,483,-363,618,109930,7193,434139,0.06894003982443854,156813,551,0.09131187832064054,4463,1683,458,71,2212,12207,0.024494189081567117,2730,1,1225,1,0.13984838137091782,2,13588,0,5740,5099,0,24427,7848,0.12475931289645256,240511,83698,
120,0.011976047904191617,15,483,-363,618,109930,7193,434139,0.06894003982443854,156813,551,0.09131187832064054,4463,1683,458,71,2212,12207,0.024494189081567117,2730,1,1225,1,0.13984838137091782,2,13588,0,5740,5099,0,24427,7848,0.12475931289645256,240511,83698,
120,0.011976047904191617,15,483,-363,618,109930,7193,434139,0.06894003982443854,156813,551,0.09131187832064054,4463,1683,458,71,2212,12207,0.024494189081567117,2730,1,1225,1,0.13984838137091782,2,13588,0,5740,5099,0,24427,7848,0.12475931289645256,240511,83698,
120,0.011976047904191617,15,483,-363,618,109930,7193,434139,0.06894003982443854,156813,551,0.09131187832064054,4463,1683,458,71,2212,12207,0.024494189081567117,2730,1,1225,1,0.13984838137091782,2,13588,0,5740,5099,0,24427,7848,0.12475931289645256,240511,83698,
120,0.011976047904191617,15,483,-363,618,109930,7193,434139,0.06894003982443854,156813,551,0.09131187832064054,4463,1683,458,71,2212,12207,0.024494189081567117,2730,1,1225,1,0.13984838137091782,2,13588,0,5740,5099,0,24427,7848,0.12475931289645256,240511,83698,
120,0.011976047904191617,15,483,-363,618,109930,7193,434139,0.06894003982443854,156813,551,0.09131187832064054,4463,1683,458,71,2212,12207,0.024494189081567117,2730,1,1225,1,0.13984838137091782,2,13588,0,5740,5099,0,24427,7848,0.12475931289645256,240511,83698,
120,0.011976047904191617,15,483,-363,618,109930,7193,434139,0.06894003982443854,156813,551,0.09131187832064054,4463,1683,458,71,2212,12207,0.024494189081567117,2730,1,1225,1,0.13984838137091782,2,13588,0,5740,5099,0,24427,7848,0.12475931289645256,240511,83698,
120,0.011976047904191617,15,483,-363,618,109930,7193,434139,0.06894003982443854,156813,551,0.09131187832064054,4463,1683,458,71,2212,12207,0.024494189081567117,2730,1,1225,1,0.13984838137091782,2,13588,0,5740,5099,0,24427,7848,0.12475931289645256,240511,83698,
120,0.011976047904191617,15,483,-363,618,109930,7193,434139,0.06894003982443854,156813,551,0.09131187832064054,4463,1683,458,71,2212,12207,0.024494189081567117,2730,1,1225,1,0.13984838137091782,2,13588,0,5740,5099,0,24427,7848,0.12475931289645256,240511,83698,
120,0.011976047904191617,15,483,-363,618,109930,7193,434139,0.06894003982443854,156813,551,0.09131187832064054,4463,1683,458,71,2212,12207,0.024494189081567117,2730,1,1225,1,0.13984838137091782,2,13588,0,5740,5099,0,24427,7848,0.12475931289645256,240511,83698,
120,0.011976047904191617,15,483,-363,618,109930,7193,434139,0.06894003982443854,156813,551,0.09131187832064054,4463,1683,458,71,2212,12207,0.024494189081567117,2730,1,1225,1,0.13984838137091782,2,13588,0,5740,5099,0,24427,7848,0.12475931289645256,240511,83698,
120,0.011976047904191617,15,483,-363,618,109930,7193,434139,0.06894003982443854,156813,551,0.09131187832064054,4463,1683,458,71,2212,12207,0.024494189081567117,2730,1,1225,1,0.13984838137091782,2,13588,0,5740,5099,0,24427,7848,0.12475931289645256,240511,83698,
120,0.011976047904191617,15,483,-363,618,109930,7193,434139,0.06894003982443854,156813,551,0.09131187832064054,4463,1683,458,71,2212,12207,0.024494189081567117,2730,1,1225,1,0.13984838137091782,2,13588,0,5740,5099,0,24427,7848,0.12475931289645256,240511,83698,
120,0.011976047904191617,15,483,-363,618,109930,7193,434139,0.06894003982443854,156813,551,0.09131187832064054,4463,1683,458,71,2212,12207,0.024494189081567117,2730,1,1225,1,0.13984838137091782,2,13588,0,5740,5099,0,24427,7848,0.12475931289645256,240511,83698,
1,0.0625,0,2,-1,3,109930,7193,434139,0.0625,156813,551,0.09131187832064054,4463,9,3,0,12,12207,0.024494189081567117,2730,2,6,1,0.055635095447870785,3,9,0,3,0,-1,12,6,0.055635095447870785,240511,83698,
21,0.21016343207354443,5,100,-79,126,109930,7193,434139,0.030959016260167,156813,551,0.09131187832064054,4463,1000,9,1,1010,12207,0.024494189081567117,2730,9,991,0,0.4250092396159812,10,3141,1,337,49,-9,3527,2804,0.12225714067256215,240511,83698,
21,0.21016343207354443,5,100,-79,126,109930,7193,434139,0.030959016260167,156813,551,0.09131187832064054,4463,1000,9,1,1010,12207,0.024494189081567117,2730,9,991,0,0.4250092396159812,10,3141,1,337,49,-9,3527,2804,0.12225714067256215,240511,83698,
21,0.21016343207354443,5,100,-79,126,109930,7193,434139,0.030959016260167,156813,551,0.09131187832064054,4463,1000,9,1,1010,12207,0.024494189081567117,2730,9,991,0,0.4250092396159812,10,3141,1,337,49,-9,3527,2804,0.12225714067256215,240511,83698,
21,0.21016343207354443,5,100,-79,126,109930,7193,434139,0.030959016260167,156813,551,0.09131187832064054,4463,1000,9,1,1010,12207,0.024494189081567117,2730,9,991,0,0.4250092396159812,10,3141,1,337,49,-9,3527,2804,0.12225714067256215,240511,83698,
21,0.21016343207354443,5,100,-79,126,109930,7193,434139,0.030959016260167,156813,551,0.09131187832064054,4463,1000,9,1,1010,12207,0.024494189081567117,2730,9,991,0,0.4250092396159812,10,3141,1,337,49,-9,3527,2804,0.12225714067256215,240511,83698,
21,0.21016343207354443,5,100,-79,126,109930,7193,434139,0.030959016260167,156813,551,0.09131187832064054,4463,1000,9,1,1010,12207,0.024494189081567117,2730,9,991,0,0.4250092396159812,10,3141,1,337,49,-9,3527,2804,0.12225714067256215,240511,83698,
21,0.21016343207354443,5,100,-79,126,109930,7193,434139,0.030959016260167,156813,551,0.09131187832064054,4463,1000,9,1,1010,12207,0.024494189081567117,2730,9,991,0,0.4250092396159812,10,3141,1,337,49,-9,3527,2804,0.12225714067256215,240511,83698,
21,0.21016343207354443,5,100,-79,126,109930,7193,434139,0.030959016260167,156813,551,0.09131187832064054,4463,1000,9,1,1010,12207,0.024494189081567117,2730,9,991,0,0.4250092396159812,10,3141,1,337,49,-9,3527,2804,0.12225714067256215,240511,83698,
21,0.21016343207354443,5,100,-79,126,109930,7193,434139,0.030959016260167,156813,551,0.09131187832064054,4463,1000,9,1,1010,12207,0.024494189081567117,2730,9,991,0,0.4250092396159812,10,3141,1,337,49,-9,3527,2804,0.12225714067256215,240511,83698,
21,0.21016343207354443,5,100,-79,126,109930,7193,434139,0.030959016260167,156813,551,0.09131187832064054,4463,1000,9,1,1010,12207,0.024494189081567117,2730,9,991,0,0.4250092396159812,10,3141,1,337,49,-9,3527,2804,0.12225714067256215,240511,83698,
21,0.21016343207354443,5,100,-79,126,109930,7193,434139,0.030959016260167,156813,551,0.09131187832064054,4463,1000,9,1,1010,12207,0.024494189081567117,2730,9,991,0,0.4250092396159812,10,3141,1,337,49,-9,3527,2804,0.12225714067256215,240511,83698,
21,0.21016343207354443,5,100,-79,126,109930,7193,434139,0.030959016260167,156813,551,0.09131187832064054,4463,1000,9,1,1010,12207,0.024494189081567117,2730,9,991,0,0.4250092396159812,10,3141,1,337,49,-9,3527,2804,0.12225714067256215,240511,83698,
21,0.21016343207354443,5,100,-79,126,109930,7193,434139,0.030959016260167,156813,551,0.09131187832064054,4463,1000,9,1,1010,12207,0.024494189081567117,2730,9,991,0,0.4250092396159812,10,3141,1,337,49,-9,3527,2804,0.12225714067256215,240511,83698,
21,0.21016343207354443,5,100,-79,126,109930,7193,434139,0.030959016260167,156813,551,0.09131187832064054,4463,1000,9,1,1010,12207,0.024494189081567117,2730,9,991,0,0.4250092396159812,10,3141,1,337,49,-9,3527,2804,0.12225714067256215,240511,83698,
21,0.0,5,100,-79,126,109930,7193,434139,0.030959016260167,156813,551,0.09131187832064054,4463,102,24,11,137,12207,0.024494189081567117,2730,0,78,0,0.2337374282566735,0,3141,0,337,49,0,3527,2804,0.12225714067256215,240511,83698,
21,0.1875,5,100,-79,126,109930,7193,434139,0.030959016260167,156813,551,0.09131187832064054,4463,1499,64,0,1563,12207,0.024494189081567117,2730,1,1435,2,0.22221690496746632,3,3141,0,337,49,1,3527,2804,0.12225714067256215,240511,83698,
21,0.1875,5,100,-79,126,109930,7193,434139,0.030959016260167,156813,551,0.09131187832064054,4463,1499,64,0,1563,12207,0.024494189081567117,2730,1,1435,2,0.22221690496746632,3,3141,0,337,49,1,3527,2804,0.12225714067256215,240511,83698,
21,0.006345848757271285,5,100,-79,126,109930,7193,434139,0.030959016260167,156813,551,0.09131187832064054,4463,65,12,0,77,12207,0.024494189081567117,2730,12,53,0,0.061943267959105805,12,3141,0,337,49,-12,3527,2804,0.12225714067256215,240511,83698,
21,0.08964143426294821,5,100,-79,126,109930,7193,434139,0.030959016260167,156813,551,0.09131187832064054,4463,204,104,11,319,12207,0.024494189081567117,2730,23,100,18,0.24589451149407035,45,3141,4,337,49,-5,3527,2804,0.12225714067256215,240511,83698,
21,0.0,5,100,-79,126,109930,7193,434139,0.030959016260167,156813,551,0.09131187832064054,4463,11,7,0,18,12207,0.024494189081567117,2730,0,4,0,0.04965471937454696,0,3141,0,337,49,0,3527,2804,0.12225714067256215,240511,83698,
52,0.14380085141961552,6,18,34,76,109930,7193,434139,0.17840181705815078,156813,551,0.09131187832064054,4463,79,53,7,139,12207,0.024494189081567117,2730,16,26,26,0.1094727952352672,48,181,6,65,15,10,261,116,0.10490353031359091,240511,83698,
0,0.0,0,0,0,0,109930,7193,434139,0.0,156813,551,0.09131187832064054,4463,1,1,2,4,12207,0.024494189081567117,2730,0,0,0,0.002179711948120499,0,216,0,51,14,0,281,165,0.06701850789348986,240511,83698,
0,0.0,0,0,0,0,109930,7193,434139,0.0,156813,551,0.09131187832064054,4463,5,4,3,12,12207,0.024494189081567117,2730,0,1,0,0.020771904455261794,0,216,0,51,14,0,281,165,0.06701850789348986,240511,83698,
0,0.0,0,0,0,0,109930,7193,434139,0.0,156813,551,0.09131187832064054,4463,163,3,0,166,12207,0.024494189081567117,2730,0,160,0,0.11033169529611035,0,216,0,51,14,0,281,165,0.06701850789348986,240511,83698,
0,0.0,0,0,0,0,109930,7193,434139,0.0,156813,551,0.09131187832064054,4463,163,3,0,166,12207,0.024494189081567117,2730,0,160,0,0.11033169529611035,0,216,0,51,14,0,281,165,0.06701850789348986,240511,83698,
0,0.0,0,0,0,0,109930,7193,434139,0.0,156813,551,0.09131187832064054,4463,163,3,0,166,12207,0.024494189081567117,2730,0,160,0,0.11033169529611035,0,216,0,51,14,0,281,165,0.06701850789348986,240511,83698,
1,0.007692307692307693,0,1,0,2,109930,7193,434139,0.007692307692307693,156813,551,0.09131187832064054,4463,160,52,85,297,12207,0.024494189081567117,2730,1,108,1,0.11327300411864222,2,160,0,52,85,0,297,108,0.11327300411864222,240511,83698,
1,0.007692307692307693,0,1,0,2,109930,7193,434139,0.007692307692307693,156813,551,0.09131187832064054,4463,160,52,85,297,12207,0.024494189081567117,2730,1,108,1,0.11327300411864222,2,160,0,52,85,0,297,108,0.11327300411864222,240511,83698,
1,0.007692307692307693,0,1,0,2,109930,7193,434139,0.007692307692307693,156813,551,0.09131187832064054,4463,160,52,85,297,12207,0.024494189081567117,2730,1,108,1,0.11327300411864222,2,160,0,52,85,0,297,108,0.11327300411864222,240511,83698,
1,0.007692307692307693,0,1,0,2,109930,7193,434139,0.007692307692307693,156813,551,0.09131187832064054,4463,160,52,85,297,12207,0.024494189081567117,2730,1,108,1,0.11327300411864222,2,160,0,52,85,0,297,108,0.11327300411864222,240511,83698,
4,0.061224489795918366,0,8,-4,12,109930,7193,434139,0.02001676217704092,156813,551,0.09131187832064054,4463,711,98,667,1476,12207,0.024494189081567117,2730,2,613,1,0.14131892329313947,3,999,0,183,1327,-1,2509,816,0.05569909715231245,240511,83698,
4,0.061224489795918366,0,8,-4,12,109930,7193,434139,0.02001676217704092,156813,551,0.09131187832064054,4463,711,98,667,1476,12207,0.024494189081567117,2730,2,613,1,0.14131892329313947,3,999,0,183,1327,-1,2509,816,0.05569909715231245,240511,83698,
4,0.061224489795918366,0,8,-4,12,109930,7193,434139,0.02001676217704092,156813,551,0.09131187832064054,4463,711,98,667,1476,12207,0.024494189081567117,2730,2,613,1,0.14131892329313947,3,999,0,183,1327,-1,2509,816,0.05569909715231245,240511,83698,
4,0.061224489795918366,0,8,-4,12,109930,7193,434139,0.02001676217704092,156813,551,0.09131187832064054,4463,711,98,667,1476,12207,0.024494189081567117,2730,2,613,1,0.14131892329313947,3,999,0,183,1327,-1,2509,816,0.05569909715231245,240511,83698,
4,0.0,0,8,-4,12,109930,7193,434139,0.02001676217704092,156813,551,0.09131187832064054,4463,8,7,85,100,12207,0.024494189081567117,2730,0,1,0,0.010434348970068896,0,999,0,183,1327,0,2509,816,0.05569909715231245,240511,83698,
4,0.0,0,8,-4,12,109930,7193,434139,0.02001676217704092,156813,551,0.09131187832064054,4463,8,7,85,100,12207,0.024494189081567117,2730,0,1,0,0.010434348970068896,0,999,0,183,1327,0,2509,816,0.05569909715231245,240511,83698,
4,0.0,0,8,-4,12,109930,7193,434139,0.02001676217704092,156813,551,0.09131187832064054,4463,8,7,85,100,12207,0.024494189081567117,2730,0,1,0,0.010434348970068896,0,999,0,183,1327,0,2509,816,0.05569909715231245,240511,83698,
4,0.047619047619047616,0,8,-4,12,109930,7193,434139,0.02001676217704092,156813,551,0.09131187832064054,4463,44,12,287,343,12207,0.024494189081567117,2730,2,32,1,0.07493042455723367,3,999,0,183,1327,-1,2509,816,0.05569909715231245,240511,83698,
4,0.047619047619047616,0,8,-4,12,109930,7193,434139,0.02001676217704092,156813,551,0.09131187832064054,4463,44,12,287,343,12207,0.024494189081567117,2730,2,32,1,0.07493042455723367,3,999,0,183,1327,-1,2509,816,0.05569909715231245,240511,83698,
89,0.017363173194136217,0,17,72,106,109930,7193,434139,0.0455396464272051,156813,551,0.09131187832064054,4463,1600,255,1340,3195,12207,0.024494189081567117,2730,3,1345,2,0.13494662662533974,5,2663,0,718,3363,-1,6744,1945,0.0910385721455393,240511,83698,
89,0.017363173194136217,0,17,72,106,109930,7193,434139,0.0455396464272051,156813,551,0.09131187832064054,4463,1600,255,1340,3195,12207,0.024494189081567117,2730,3,1345,2,0.13494662662533974,5,2663,0,718,3363,-1,6744,1945,0.0910385721455393,240511,83698,
89,0.017363173194136217,0,17,72,106,109930,7193,434139,0.0455396464272051,156813,551,0.09131187832064054,4463,1600,255,1340,3195,12207,0.024494189081567117,2730,3,1345,2,0.13494662662533974,5,2663,0,718,3363,-1,6744,1945,0.0910385721455393,240511,83698,
89,0.017363173194136217,0,17,72,106,109930,7193,434139,0.0455396464272051,156813,551,0.09131187832064054,4463,1600,255,1340,3195,12207,0.024494189081567117,2730,3,1345,2,0.13494662662533974,5,2663,0,718,3363,-1,6744,1945,0.0910385721455393,240511,83698,
89,0.017363173194136217,0,17,72,106,109930,7193,434139,0.0455396464272051,156813,551,0.09131187832064054,4463,1600,255,1340,3195,12207,0.024494189081567117,2730,3,1345,2,0.13494662662533974,5,2663,0,718,3363,-1,6744,1945,0.0910385721455393,240511,83698,
89,0.017363173194136217,0,17,72,106,109930,7193,434139,0.0455396464272051,156813,551,0.09131187832064054,4463,1600,255,1340,3195,12207,0.024494189081567117,2730,3,1345,2,0.13494662662533974,5,2663,0,718,3363,-1,6744,1945,0.0910385721455393,240511,83698,
89,0.017363173194136217,0,17,72,106,109930,7193,434139,0.0455396464272051,156813,551,0.09131187832064054,4463,1600,255,1340,3195,12207,0.024494189081567117,2730,3,1345,2,0.13494662662533974,5,2663,0,718,3363,-1,6744,1945,0.0910385721455393,240511,83698,
89,0.017363173194136217,0,17,72,106,109930,7193,434139,0.0455396464272051,156813,551,0.09131187832064054,4463,1600,255,1340,3195,12207,0.024494189081567117,2730,3,1345,2,0.13494662662533974,5,2663,0,718,3363,-1,6744,1945,0.0910385721455393,240511,83698,
89,0.017363173194136217,0,17,72,106,109930,7193,434139,0.0455396464272051,156813,551,0.09131187832064054,4463,1600,255,1340,3195,12207,0.024494189081567117,2730,3,1345,2,0.13494662662533974,5,2663,0,718,3363,-1,6744,1945,0.0910385721455393,240511,83698,
89,0.017363173194136217,0,17,72,106,109930,7193,434139,0.0455396464272051,156813,551,0.09131187832064054,4463,1600,255,1340,3195,12207,0.024494189081567117,2730,3,1345,2,0.13494662662533974,5,2663,0,718,3363,-1,6744,1945,0.0910385721455393,240511,83698,
89,0.12224455611390285,0,17,72,106,109930,7193,434139,0.0455396464272051,156813,551,0.09131187832064054,4463,228,114,649,991,12207,0.024494189081567117,2730,4,114,44,0.146585368318022,48,2663,0,718,3363,40,6744,1945,0.0910385721455393,240511,83698,
89,0.12224455611390285,0,17,72,106,109930,7193,434139,0.0455396464272051,156813,551,0.09131187832064054,4463,228,114,649,991,12207,0.024494189081567117,2730,4,114,44,0.146585368318022,48,2663,0,718,3363,40,6744,1945,0.0910385721455393,240511,83698,
89,0.018547063441090417,0,17,72,106,109930,7193,434139,0.0455396464272051,156813,551,0.09131187832064054,4463,71,136,472,679,12207,0.024494189081567117,2730,6,-65,5,0.10268316085912561,11,2663,0,718,3363,-1,6744,1945,0.0910385721455393,240511,83698,
89,0.0,0,17,72,106,109930,7193,434139,0.0455396464272051,156813,551,0.09131187832064054,4463,146,9,130,285,12207,0.024494189081567117,2730,0,137,0,0.02082980203385815,0,2663,0,718,3363,0,6744,1945,0.0910385721455393,240511,83698,
89,0.0,0,17,72,106,109930,7193,434139,0.0455396464272051,156813,551,0.09131187832064054,4463,146,9,130,285,12207,0.024494189081567117,2730,0,137,0,0.02082980203385815,0,2663,0,718,3363,0,6744,1945,0.0910385721455393,240511,83698,
3,0.015306122448979591,0,4,-1,7,109930,7193,434139,0.0069417954097526855,156813,551,0.09131187832064054,4463,67,76,598,741,12207,0.024494189081567117,2730,2,-9,1,0.08681814504846119,3,359,0,268,1448,-1,2075,91,0.05714300537846077,240511,83698,
3,0.012461059190031152,0,4,-1,7,109930,7193,434139,0.0069417954097526855,156813,551,0.09131187832064054,4463,206,174,832,1212,12207,0.024494189081567117,2730,2,32,2,0.12307348351839563,4,359,0,268,1448,0,2075,91,0.05714300537846077,240511,83698,
21,0.013953488372093023,5,13,8,39,109930,7193,434139,0.039310058774738935,156813,551,0.09131187832064054,4463,1,2,0,3,12207,0.024494189081567117,2730,2,-1,1,0.013953488372093023,3,4800,0,3651,3480,-1,11931,1149,0.13885968953182,240511,83698,
21,0.0,5,13,8,39,109930,7193,434139,0.039310058774738935,156813,551,0.09131187832064054,4463,1229,3290,2485,7004,12207,0.024494189081567117,2730,0,-2061,0,0.24383887882520408,0,4800,0,3651,3480,0,11931,1149,0.13885968953182,240511,83698,
21,0.12503501400560224,5,13,8,39,109930,7193,434139,0.039310058774738935,156813,551,0.09131187832064054,4463,2347,7,1,2355,12207,0.024494189081567117,2730,7,2340,19,0.19434650415376103,27,4800,1,3651,3480,12,11931,1149,0.13885968953182,240511,83698,
21,0.12503501400560224,5,13,8,39,109930,7193,434139,0.039310058774738935,156813,551,0.09131187832064054,4463,2347,7,1,2355,12207,0.024494189081567117,2730,7,2340,19,0.19434650415376103,27,4800,1,3651,3480,12,11931,1149,0.13885968953182,240511,83698,
21,0.12503501400560224,5,13,8,39,109930,7193,434139,0.039310058774738935,156813,551,0.09131187832064054,4463,2347,7,1,2355,12207,0.024494189081567117,2730,7,2340,19,0.19434650415376103,27,4800,1,3651,3480,12,11931,1149,0.13885968953182,240511,83698,
21,0.12503501400560224,5,13,8,39,109930,7193,434139,0.039310058774738935,156813,551,0.09131187832064054,4463,2347,7,1,2355,12207,0.024494189081567117,2730,7,2340,19,0.19434650415376103,27,4800,1,3651,3480,12,11931,1149,0.13885968953182,240511,83698,
21,0.12503501400560224,5,13,8,39,109930,7193,434139,0.039310058774738935,156813,551,0.09131187832064054,4463,2347,7,1,2355,12207,0.024494189081567117,2730,7,2340,19,0.19434650415376103,27,4800,1,3651,3480,12,11931,1149,0.13885968953182,240511,83698,
21,0.12503501400560224,5,13,8,39,109930,7193,434139,0.039310058774738935,156813,551,0.09131187832064054,4463,2347,7,1,2355,12207,0.024494189081567117,2730,7,2340,19,0.19434650415376103,27,4800,1,3651,3480,12,11931,1149,0.13885968953182,240511,83698,
21,0.13618190904547725,5,13,8,39,109930,7193,434139,0.039310058774738935,156813,551,0.09131187832064054,4463,1105,311,973,2389,12207,0.024494189081567117,2730,4,794,1,0.091338937161288,9,4800,4,3651,3480,-3,11931,1149,0.13885968953182,240511,83698,
21,0.13618190904547725,5,13,8,39,109930,7193,434139,0.039310058774738935,156813,551,0.09131187832064054,4463,1105,311,973,2389,12207,0.024494189081567117,2730,4,794,1,0.091338937161288,9,4800,4,3651,3480,-3,11931,1149,0.13885968953182,240511,83698,
21,0.13618190904547725,5,13,8,39,109930,7193,434139,0.039310058774738935,156813,551,0.09131187832064054,4463,1105,311,973,2389,12207,0.024494189081567117,2730,4,794,1,0.091338937161288,9,4800,4,3651,3480,-3,11931,1149,0.13885968953182,240511,83698,
65,0.12648136177547942,0,38,27,103,109930,7193,434139,0.09838110896274253,156813,551,0.09131187832064054,4463,518,462,33,1013,12207,0.024494189081567117,2730,13,56,13,0.18489904538160207,26,1633,0,924,85,0,2642,709,0.14771543999809872,240511,83698,
65,0.12648136177547942,0,38,27,103,109930,7193,434139,0.09838110896274253,156813,551,0.09131187832064054,4463,518,462,33,1013,12207,0.024494189081567117,2730,13,56,13,0.18489904538160207,26,1633,0,924,85,0,2642,709,0.14771543999809872,240511,83698,
65,0.12648136177547942,0,38,27,103,109930,7193,434139,0.09838110896274253,156813,551,0.09131187832064054,4463,518,462,33,1013,12207,0.024494189081567117,2730,13,56,13,0.18489904538160207,26,1633,0,924,85,0,2642,709,0.14771543999809872,240511,83698,
65,0.12648136177547942,0,38,27,103,109930,7193,434139,0.09838110896274253,156813,551,0.09131187832064054,4463,518,462,33,1013,12207,0.024494189081567117,2730,13,56,13,0.18489904538160207,26,1633,0,924,85,0,2642,709,0.14771543999809872,240511,83698,
65,0.12648136177547942,0,38,27,103,109930,7193,434139,0.09838110896274253,156813,551,0.09131187832064054,4463,518,462,33,1013,12207,0.024494189081567117,2730,13,56,13,0.18489904538160207,26,1633,0,924,85,0,2642,709,0.14771543999809872,240511,83698,
65,0.12648136177547942,0,38,27,103,109930,7193,434139,0.09838110896274253,156813,551,0.09131187832064054,4463,518,462,33,1013,12207,0.024494189081567117,2730,13,56,13,0.18489904538160207,26,1633,0,924,85,0,2642,709,0.14771543999809872,240511,83698,
65,0.12648136177547942,0,38,27,103,109930,7193,434139,0.09838110896274253,156813,551,0.09131187832064054,4463,518,462,33,1013,12207,0.024494189081567117,2730,13,56,13,0.18489904538160207,26,1633,0,924,85,0,2642,709,0.14771543999809872,240511,83698,
65,0.12648136177547942,0,38,27,103,109930,7193,434139,0.09838110896274253,156813,551,0.09131187832064054,4463,518,462,33,1013,12207,0.024494189081567117,2730,13,56,13,0.18489904538160207,26,1633,0,924,85,0,2642,709,0.14771543999809872,240511,83698,
65,0.12648136177547942,0,38,27,103,109930,7193,434139,0.09838110896274253,156813,551,0.09131187832064054,4463,518,462,33,1013,12207,0.024494189081567117,2730,13,56,13,0.18489904538160207,26,1633,0,924,85,0,2642,709,0.14771543999809872,240511,83698,
65,0.12648136177547942,0,38,27,103,109930,7193,434139,0.09838110896274253,156813,551,0.09131187832064054,4463,518,462,33,1013,12207,0.024494189081567117,2730,13,56,13,0.18489904538160207,26,1633,0,924,85,0,2642,709,0.14771543999809872,240511,83698,
65,0.12648136177547942,0,38,27,103,109930,7193,434139,0.09838110896274253,156813,551,0.09131187832064054,4463,518,462,33,1013,12207,0.024494189081567117,2730,13,56,13,0.18489904538160207,26,1633,0,924,85,0,2642,709,0.14771543999809872,240511,83698,
65,0.0,0,38,27,103,109930,7193,434139,0.09838110896274253,156813,551,0.09131187832064054,4463,341,89,39,469,12207,0.024494189081567117,2730,0,252,0,0.2383292711178609,0,1633,0,924,85,0,2642,709,0.14771543999809872,240511,83698,
65,0.2166231564076392,0,38,27,103,109930,7193,434139,0.09838110896274253,156813,551,0.09131187832064054,4463,327,314,9,650,12207,0.024494189081567117,2730,20,13,44,0.16486330216720535,64,1633,0,924,85,24,2642,709,0.14771543999809872,240511,83698,
65,0.2166231564076392,0,38,27,103,109930,7193,434139,0.09838110896274253,156813,551,0.09131187832064054,4463,327,314,9,650,12207,0.024494189081567117,2730,20,13,44,0.16486330216720535,64,1633,0,924,85,24,2642,709,0.14771543999809872,240511,83698,
65,0.2166231564076392,0,38,27,103,109930,7193,434139,0.09838110896274253,156813,551,0.09131187832064054,4463,327,314,9,650,12207,0.024494189081567117,2730,20,13,44,0.16486330216720535,64,1633,0,924,85,24,2642,709,0.14771543999809872,240511,83698,
65,0.2166231564076392,0,38,27,103,109930,7193,434139,0.09838110896274253,156813,551,0.09131187832064054,4463,327,314,9,650,12207,0.024494189081567117,2730,20,13,44,0.16486330216720535,64,1633,0,924,85,24,2642,709,0.14771543999809872,240511,83698,
65,0.2166231564076392,0,38,27,103,109930,7193,434139,0.09838110896274253,156813,551,0.09131187832064054,4463,327,314,9,650,12207,0.024494189081567117,2730,20,13,44,0.16486330216720535,64,1633,0,924,85,24,2642,709,0.14771543999809872,240511,83698,
65,0.2166231564076392,0,38,27,103,109930,7193,434139,0.09838110896274253,156813,551,0.09131187832064054,4463,327,314,9,650,12207,0.024494189081567117,2730,20,13,44,0.16486330216720535,64,1633,0,924,85,24,2642,709,0.14771543999809872,240511,83698,
65,0.2166231564076392,0,38,27,103,109930,7193,434139,0.09838110896274253,156813,551,0.09131187832064054,4463,327,314,9,650,12207,0.024494189081567117,2730,20,13,44,0.16486330216720535,64,1633,0,924,85,24,2642,709,0.14771543999809872,240511,83698,
65,0.2166231564076392,0,38,27,103,109930,7193,434139,0.09838110896274253,156813,551,0.09131187832064054,4463,327,314,9,650,12207,0.024494189081567117,2730,20,13,44,0.16486330216720535,64,1633,0,924,85,24,2642,709,0.14771543999809872,240511,83698,
65,0.2166231564076392,0,38,27,103,109930,7193,434139,0.09838110896274253,156813,551,0.09131187832064054,4463,327,314,9,650,12207,0.024494189081567117,2730,20,13,44,0.16486330216720535,64,1633,0,924,85,24,2642,709,0.14771543999809872,240511,83698,
65,0.0,0,38,27,103,109930,7193,434139,0.09838110896274253,156813,551,0.09131187832064054,4463,286,9,0,295,12207,0.024494189081567117,2730,0,277,0,0.030776638619775674,0,1633,0,924,85,0,2642,709,0.14771543999809872,240511,83698,
65,0.0,0,38,27,103,109930,7193,434139,0.09838110896274253,156813,551,0.09131187832064054,4463,286,9,0,295,12207,0.024494189081567117,2730,0,277,0,0.030776638619775674,0,1633,0,924,85,0,2642,709,0.14771543999809872,240511,83698,
65,0.01702127659574468,0,38,27,103,109930,7193,434139,0.09838110896274253,156813,551,0.09131187832064054,4463,68,30,0,98,12207,0.024494189081567117,2730,2,38,2,0.10279793477807249,4,1633,0,924,85,0,2642,709,0.14771543999809872,240511,83698,
65,0.01702127659574468,0,38,27,103,109930,7193,434139,0.09838110896274253,156813,551,0.09131187832064054,4463,68,30,0,98,12207,0.024494189081567117,2730,2,38,2,0.10279793477807249,4,1633,0,924,85,0,2642,709,0.14771543999809872,240511,83698,
65,0.01702127659574468,0,38,27,103,109930,7193,434139,0.09838110896274253,156813,551,0.09131187832064054,4463,68,30,0,98,12207,0.024494189081567117,2730,2,38,2,0.10279793477807249,4,1633,0,924,85,0,2642,709,0.14771543999809872,240511,83698,
65,0.01702127659574468,0,38,27,103,109930,7193,434139,0.09838110896274253,156813,551,0.09131187832064054,4463,68,30,0,98,12207,0.024494189081567117,2730,2,38,2,0.10279793477807249,4,1633,0,924,85,0,2642,709,0.14771543999809872,240511,83698,
65,0.01702127659574468,0,38,27,103,109930,7193,434139,0.09838110896274253,156813,551,0.09131187832064054,4463,68,30,0,98,12207,0.024494189081567117,2730,2,38,2,0.10279793477807249,4,1633,0,924,85,0,2642,709,0.14771543999809872,240511,83698,
65,0.01702127659574468,0,38,27,103,109930,7193,434139,0.09838110896274253,156813,551,0.09131187832064054,4463,68,30,0,98,12207,0.024494189081567117,2730,2,38,2,0.10279793477807249,4,1633,0,924,85,0,2642,709,0.14771543999809872,240511,83698,
65,0.01702127659574468,0,38,27,103,109930,7193,434139,0.09838110896274253,156813,551,0.09131187832064054,4463,68,30,0,98,12207,0.024494189081567117,2730,2,38,2,0.10279793477807249,4,1633,0,924,85,0,2642,709,0.14771543999809872,240511,83698,
65,0.01702127659574468,0,38,27,103,109930,7193,434139,0.09838110896274253,156813,551,0.09131187832064054,4463,68,30,0,98,12207,0.024494189081567117,2730,2,38,2,0.10279793477807249,4,1633,0,924,85,0,2642,709,0.14771543999809872,240511,83698,
65,0.01702127659574468,0,38,27,103,109930,7193,434139,0.09838110896274253,156813,551,0.09131187832064054,4463,68,30,0,98,12207,0.024494189081567117,2730,2,38,2,0.10279793477807249,4,1633,0,924,85,0,2642,709,0.14771543999809872,240511,83698,
5,0.03125,0,5,0,10,109930,7193,434139,0.030483556298773692,156813,551,0.09131187832064054,4463,589,71,13,673,12207,0.024494189081567117,2730,1,518,1,0.06361772895198788,2,982,0,164,21,0,1167,818,0.09921690422612252,240511,83698,
5,0.03125,0,5,0,10,109930,7193,434139,0.030483556298773692,156813,551,0.09131187832064054,4463,589,71,13,673,12207,0.024494189081567117,2730,1,518,1,0.06361772895198788,2,982,0,164,21,0,1167,818,0.09921690422612252,240511,83698,
5,0.03125,0,5,0,10,109930,7193,434139,0.030483556298773692,156813,551,0.09131187832064054,4463,589,71,13,673,12207,0.024494189081567117,2730,1,518,1,0.06361772895198788,2,982,0,164,21,0,1167,818,0.09921690422612252,240511,83698,
5,0.03125,0,5,0,10,109930,7193,434139,0.030483556298773692,156813,551,0.09131187832064054,4463,589,71,13,673,12207,0.024494189081567117,2730,1,518,1,0.06361772895198788,2,982,0,164,21,0,1167,818,0.09921690422612252,240511,83698,
5,0.03125,0,5,0,10,109930,7193,434139,0.030483556298773692,156813,551,0.09131187832064054,4463,589,71,13,673,12207,0.024494189081567117,2730,1,518,1,0.06361772895198788,2,982,0,164,21,0,1167,818,0.09921690422612252,240511,83698,
5,0.03125,0,5,0,10,109930,7193,434139,0.030483556298773692,156813,551,0.09131187832064054,4463,589,71,13,673,12207,0.024494189081567117,2730,1,518,1,0.06361772895198788,2,982,0,164,21,0,1167,818,0.09921690422612252,240511,83698,
5,0.03125,0,5,0,10,109930,7193,434139,0.030483556298773692,156813,551,0.09131187832064054,4463,589,71,13,673,12207,0.024494189081567117,2730,1,518,1,0.06361772895198788,2,982,0,164,21,0,1167,818,0.09921690422612252,240511,83698,
6,0.0,0,6,0,12,109930,7193,434139,0.010723860589812333,156813,551,0.09131187832064054,4463,35,1,0,36,12207,0.024494189081567117,2730,0,34,0,0.019764808364255947,0,191,0,29,22,0,242,162,0.05200650004964122,240511,83698,
6,0.0,0,6,0,12,109930,7193,434139,0.010723860589812333,156813,551,0.09131187832064054,4463,35,1,0,36,12207,0.024494189081567117,2730,0,34,0,0.019764808364255947,0,191,0,29,22,0,242,162,0.05200650004964122,240511,83698,
6,0.032171581769437,0,6,0,12,109930,7193,434139,0.010723860589812333,156813,551,0.09131187832064054,4463,151,23,19,193,12207,0.024494189081567117,2730,6,128,6,0.12806439198188416,12,191,0,29,22,0,242,162,0.05200650004964122,240511,83698,
6,0.032171581769437,0,6,0,12,109930,7193,434139,0.010723860589812333,156813,551,0.09131187832064054,4463,151,23,19,193,12207,0.024494189081567117,2730,6,128,6,0.12806439198188416,12,191,0,29,22,0,242,162,0.05200650004964122,240511,83698,
6,0.032171581769437,0,6,0,12,109930,7193,434139,0.010723860589812333,156813,551,0.09131187832064054,4463,151,23,19,193,12207,0.024494189081567117,2730,6,128,6,0.12806439198188416,12,191,0,29,22,0,242,162,0.05200650004964122,240511,83698,
2,0.08449074074074074,0,12,-10,14,109930,7193,434139,0.016898148148148148,156813,551,0.09131187832064054,4463,1840,459,144,2443,12207,0.024494189081567117,2730,12,1381,2,0.3203469897878932,14,2361,0,479,157,-10,2997,1882,0.1334557781959498,240511,83698,
2,0.08449074074074074,0,12,-10,14,109930,7193,434139,0.016898148148148148,156813,551,0.09131187832064054,4463,1840,459,144,2443,12207,0.024494189081567117,2730,12,1381,2,0.3203469897878932,14,2361,0,479,157,-10,2997,1882,0.1334557781959498,240511,83698,
2,0.08449074074074074,0,12,-10,14,109930,7193,434139,0.016898148148148148,156813,551,0.09131187832064054,4463,1840,459,144,2443,12207,0.024494189081567117,2730,12,1381,2,0.3203469897878932,14,2361,0,479,157,-10,2997,1882,0.1334557781959498,240511,83698,
2,0.08449074074074074,0,12,-10,14,109930,7193,434139,0.016898148148148148,156813,551,0.09131187832064054,4463,1840,459,144,2443,12207,0.024494189081567117,2730,12,1381,2,0.3203469897878932,14,2361,0,479,157,-10,2997,1882,0.1334557781959498,240511,83698,
2,0.08449074074074074,0,12,-10,14,109930,7193,434139,0.016898148148148148,156813,551,0.09131187832064054,4463,1840,459,144,2443,12207,0.024494189081567117,2730,12,1381,2,0.3203469897878932,14,2361,0,479,157,-10,2997,1882,0.1334557781959498,240511,83698,
2,0.08449074074074074,0,12,-10,14,109930,7193,434139,0.016898148148148148,156813,551,0.09131187832064054,4463,1840,459,144,2443,12207,0.024494189081567117,2730,12,1381,2,0.3203469897878932,14,2361,0,479,157,-10,2997,1882,0.1334557781959498,240511,83698,
1,0.0,0,2,-1,3,109930,7193,434139,4.8231511254019296E-4,156813,551,0.09131187832064054,4463,272,3,12,287,12207,0.024494189081567117,2730,0,269,0,0.11880203795738399,0,2818,0,1254,3220,0,7292,1564,0.06645937071497951,240511,83698,
1,0.0,0,2,-1,3,109930,7193,434139,4.8231511254019296E-4,156813,551,0.09131187832064054,4463,272,3,12,287,12207,0.024494189081567117,2730,0,269,0,0.11880203795738399,0,2818,0,1254,3220,0,7292,1564,0.06645937071497951,240511,83698,
1,0.0,0,2,-1,3,109930,7193,434139,4.8231511254019296E-4,156813,551,0.09131187832064054,4463,2,3,2,7,12207,0.024494189081567117,2730,0,-1,0,0.0014709969887409754,0,2818,0,1254,3220,0,7292,1564,0.06645937071497951,240511,83698,
1,0.0,0,2,-1,3,109930,7193,434139,4.8231511254019296E-4,156813,551,0.09131187832064054,4463,2,3,2,7,12207,0.024494189081567117,2730,0,-1,0,0.0014709969887409754,0,2818,0,1254,3220,0,7292,1564,0.06645937071497951,240511,83698,
1,0.0,0,2,-1,3,109930,7193,434139,4.8231511254019296E-4,156813,551,0.09131187832064054,4463,2,3,2,7,12207,0.024494189081567117,2730,0,-1,0,0.0014709969887409754,0,2818,0,1254,3220,0,7292,1564,0.06645937071497951,240511,83698,
1,0.0,0,2,-1,3,109930,7193,434139,4.8231511254019296E-4,156813,551,0.09131187832064054,4463,2,3,2,7,12207,0.024494189081567117,2730,0,-1,0,0.0014709969887409754,0,2818,0,1254,3220,0,7292,1564,0.06645937071497951,240511,83698,
1,0.0,0,2,-1,3,109930,7193,434139,4.8231511254019296E-4,156813,551,0.09131187832064054,4463,251,63,4,318,12207,0.024494189081567117,2730,0,188,0,0.2681013690114851,0,2818,0,1254,3220,0,7292,1564,0.06645937071497951,240511,83698,
1,0.0,0,2,-1,3,109930,7193,434139,4.8231511254019296E-4,156813,551,0.09131187832064054,4463,251,63,4,318,12207,0.024494189081567117,2730,0,188,0,0.2681013690114851,0,2818,0,1254,3220,0,7292,1564,0.06645937071497951,240511,83698,
1,0.00964630225080386,0,2,-1,3,109930,7193,434139,4.8231511254019296E-4,156813,551,0.09131187832064054,4463,990,96,901,1987,12207,0.024494189081567117,2730,2,894,1,0.10402622580960177,3,2818,0,1254,3220,-1,7292,1564,0.06645937071497951,240511,83698,
1,0.0,0,2,-1,3,109930,7193,434139,4.8231511254019296E-4,156813,551,0.09131187832064054,4463,327,36,2,365,12207,0.024494189081567117,2730,0,291,0,0.024184314565148884,0,2818,0,1254,3220,0,7292,1564,0.06645937071497951,240511,83698,
1,0.0,0,2,-1,3,109930,7193,434139,4.8231511254019296E-4,156813,551,0.09131187832064054,4463,7,7,2,16,12207,0.024494189081567117,2730,0,0,0,8.379456812842223E-4,0,2818,0,1254,3220,0,7292,1564,0.06645937071497951,240511,83698,
102,0.0,1,33,69,136,109930,7193,434139,0.04881260076774999,156813,551,0.09131187832064054,4463,528,45,520,1093,12207,0.024494189081567117,2730,0,483,0,0.07986478864346747,0,6132,0,808,2681,0,9621,5324,0.11493004279712613,240511,83698,
102,0.0,1,33,69,136,109930,7193,434139,0.04881260076774999,156813,551,0.09131187832064054,4463,528,45,520,1093,12207,0.024494189081567117,2730,0,483,0,0.07986478864346747,0,6132,0,808,2681,0,9621,5324,0.11493004279712613,240511,83698,
102,0.0,1,33,69,136,109930,7193,434139,0.04881260076774999,156813,551,0.09131187832064054,4463,528,45,520,1093,12207,0.024494189081567117,2730,0,483,0,0.07986478864346747,0,6132,0,808,2681,0,9621,5324,0.11493004279712613,240511,83698,
102,0.0,1,33,69,136,109930,7193,434139,0.04881260076774999,156813,551,0.09131187832064054,4463,528,45,520,1093,12207,0.024494189081567117,2730,0,483,0,0.07986478864346747,0,6132,0,808,2681,0,9621,5324,0.11493004279712613,240511,83698,
102,0.3127321850726106,1,33,69,136,109930,7193,434139,0.04881260076774999,156813,551,0.09131187832064054,4463,259,22,7,288,12207,0.024494189081567117,2730,12,237,44,0.11596551227966058,56,6132,0,808,2681,32,9621,5324,0.11493004279712613,240511,83698,
102,0.0,1,33,69,136,109930,7193,434139,0.04881260076774999,156813,551,0.09131187832064054,4463,159,67,483,709,12207,0.024494189081567117,2730,0,92,0,0.08878646298803139,0,6132,0,808,2681,0,9621,5324,0.11493004279712613,240511,83698,
102,0.0,1,33,69,136,109930,7193,434139,0.04881260076774999,156813,551,0.09131187832064054,4463,159,67,483,709,12207,0.024494189081567117,2730,0,92,0,0.08878646298803139,0,6132,0,808,2681,0,9621,5324,0.11493004279712613,240511,83698,
102,0.0,1,33,69,136,109930,7193,434139,0.04881260076774999,156813,551,0.09131187832064054,4463,159,67,483,709,12207,0.024494189081567117,2730,0,92,0,0.08878646298803139,0,6132,0,808,2681,0,9621,5324,0.11493004279712613,240511,83698,
102,0.0,1,33,69,136,109930,7193,434139,0.04881260076774999,156813,551,0.09131187832064054,4463,639,47,3,689,12207,0.024494189081567117,2730,0,592,0,0.05429014307801665,0,6132,0,808,2681,0,9621,5324,0.11493004279712613,240511,83698,
102,0.0,1,33,69,136,109930,7193,434139,0.04881260076774999,156813,551,0.09131187832064054,4463,639,47,3,689,12207,0.024494189081567117,2730,0,592,0,0.05429014307801665,0,6132,0,808,2681,0,9621,5324,0.11493004279712613,240511,83698,
102,0.0,1,33,69,136,109930,7193,434139,0.04881260076774999,156813,551,0.09131187832064054,4463,639,47,3,689,12207,0.024494189081567117,2730,0,592,0,0.05429014307801665,0,6132,0,808,2681,0,9621,5324,0.11493004279712613,240511,83698,
102,0.0,1,33,69,136,109930,7193,434139,0.04881260076774999,156813,551,0.09131187832064054,4463,639,47,3,689,12207,0.024494189081567117,2730,0,592,0,0.05429014307801665,0,6132,0,808,2681,0,9621,5324,0.11493004279712613,240511,83698,
102,0.0,1,33,69,136,109930,7193,434139,0.04881260076774999,156813,551,0.09131187832064054,4463,639,47,3,689,12207,0.024494189081567117,2730,0,592,0,0.05429014307801665,0,6132,0,808,2681,0,9621,5324,0.11493004279712613,240511,83698,
102,0.22359625668449196,1,33,69,136,109930,7193,434139,0.04881260076774999,156813,551,0.09131187832064054,4463,1798,136,80,2014,12207,0.024494189081567117,2730,9,1662,33,0.18103674515577955,43,6132,1,808,2681,24,9621,5324,0.11493004279712613,240511,83698,
102,0.22359625668449196,1,33,69,136,109930,7193,434139,0.04881260076774999,156813,551,0.09131187832064054,4463,1798,136,80,2014,12207,0.024494189081567117,2730,9,1662,33,0.18103674515577955,43,6132,1,808,2681,24,9621,5324,0.11493004279712613,240511,83698,
102,0.22359625668449196,1,33,69,136,109930,7193,434139,0.04881260076774999,156813,551,0.09131187832064054,4463,1798,136,80,2014,12207,0.024494189081567117,2730,9,1662,33,0.18103674515577955,43,6132,1,808,2681,24,9621,5324,0.11493004279712613,240511,83698,
102,0.22359625668449196,1,33,69,136,109930,7193,434139,0.04881260076774999,156813,551,0.09131187832064054,4463,1798,136,80,2014,12207,0.024494189081567117,2730,9,1662,33,0.18103674515577955,43,6132,1,808,2681,24,9621,5324,0.11493004279712613,240511,83698,
102,0.22359625668449196,1,33,69,136,109930,7193,434139,0.04881260076774999,156813,551,0.09131187832064054,4463,1798,136,80,2014,12207,0.024494189081567117,2730,9,1662,33,0.18103674515577955,43,6132,1,808,2681,24,9621,5324,0.11493004279712613,240511,83698,
102,0.22359625668449196,1,33,69,136,109930,7193,434139,0.04881260076774999,156813,551,0.09131187832064054,4463,1798,136,80,2014,12207,0.024494189081567117,2730,9,1662,33,0.18103674515577955,43,6132,1,808,2681,24,9621,5324,0.11493004279712613,240511,83698,
102,0.22359625668449196,1,33,69,136,109930,7193,434139,0.04881260076774999,156813,551,0.09131187832064054,4463,1798,136,80,2014,12207,0.024494189081567117,2730,9,1662,33,0.18103674515577955,43,6132,1,808,2681,24,9621,5324,0.11493004279712613,240511,83698,
102,0.22359625668449196,1,33,69,136,109930,7193,434139,0.04881260076774999,156813,551,0.09131187832064054,4463,1798,136,80,2014,12207,0.024494189081567117,2730,9,1662,33,0.18103674515577955,43,6132,1,808,2681,24,9621,5324,0.11493004279712613,240511,83698,
102,0.22359625668449196,1,33,69,136,109930,7193,434139,0.04881260076774999,156813,551,0.09131187832064054,4463,1798,136,80,2014,12207,0.024494189081567117,2730,9,1662,33,0.18103674515577955,43,6132,1,808,2681,24,9621,5324,0.11493004279712613,240511,83698,
102,0.22359625668449196,1,33,69,136,109930,7193,434139,0.04881260076774999,156813,551,0.09131187832064054,4463,1798,136,80,2014,12207,0.024494189081567117,2730,9,1662,33,0.18103674515577955,43,6132,1,808,2681,24,9621,5324,0.11493004279712613,240511,83698,
102,0.0,1,33,69,136,109930,7193,434139,0.04881260076774999,156813,551,0.09131187832064054,4463,353,9,0,362,12207,0.024494189081567117,2730,0,344,0,0.14628875362383856,0,6132,0,808,2681,0,9621,5324,0.11493004279712613,240511,83698,
102,0.30123617436564737,1,33,69,136,109930,7193,434139,0.04881260076774999,156813,551,0.09131187832064054,4463,1463,220,1138,2821,12207,0.024494189081567117,2730,12,1243,22,0.11722768737269046,34,6132,0,808,2681,10,9621,5324,0.11493004279712613,240511,83698,
102,0.30123617436564737,1,33,69,136,109930,7193,434139,0.04881260076774999,156813,551,0.09131187832064054,4463,1463,220,1138,2821,12207,0.024494189081567117,2730,12,1243,22,0.11722768737269046,34,6132,0,808,2681,10,9621,5324,0.11493004279712613,240511,83698,
102,0.30123617436564737,1,33,69,136,109930,7193,434139,0.04881260076774999,156813,551,0.09131187832064054,4463,1463,220,1138,2821,12207,0.024494189081567117,2730,12,1243,22,0.11722768737269046,34,6132,0,808,2681,10,9621,5324,0.11493004279712613,240511,83698,
102,0.30123617436564737,1,33,69,136,109930,7193,434139,0.04881260076774999,156813,551,0.09131187832064054,4463,1463,220,1138,2821,12207,0.024494189081567117,2730,12,1243,22,0.11722768737269046,34,6132,0,808,2681,10,9621,5324,0.11493004279712613,240511,83698,
102,0.30123617436564737,1,33,69,136,109930,7193,434139,0.04881260076774999,156813,551,0.09131187832064054,4463,1463,220,1138,2821,12207,0.024494189081567117,2730,12,1243,22,0.11722768737269046,34,6132,0,808,2681,10,9621,5324,0.11493004279712613,240511,83698,
102,0.30123617436564737,1,33,69,136,109930,7193,434139,0.04881260076774999,156813,551,0.09131187832064054,4463,1463,220,1138,2821,12207,0.024494189081567117,2730,12,1243,22,0.11722768737269046,34,6132,0,808,2681,10,9621,5324,0.11493004279712613,240511,83698,
102,0.30123617436564737,1,33,69,136,109930,7193,434139,0.04881260076774999,156813,551,0.09131187832064054,4463,1463,220,1138,2821,12207,0.024494189081567117,2730,12,1243,22,0.11722768737269046,34,6132,0,808,2681,10,9621,5324,0.11493004279712613,240511,83698,
102,0.30123617436564737,1,33,69,136,109930,7193,434139,0.04881260076774999,156813,551,0.09131187832064054,4463,1463,220,1138,2821,12207,0.024494189081567117,2730,12,1243,22,0.11722768737269046,34,6132,0,808,2681,10,9621,5324,0.11493004279712613,240511,83698,
8,0.008982035928143712,0,11,-3,19,109930,7193,434139,0.02230794513414148,156813,551,0.09131187832064054,4463,121,13,2,136,12207,0.024494189081567117,2730,2,108,1,0.09794015503133231,3,808,0,126,214,-1,1148,682,0.1488438459326325,240511,83698,
8,0.04081632653061224,0,11,-3,19,109930,7193,434139,0.02230794513414148,156813,551,0.09131187832064054,4463,153,1,7,161,12207,0.024494189081567117,2730,1,152,1,0.19609868605295555,2,808,0,126,214,0,1148,682,0.1488438459326325,240511,83698,
8,0.03396358543417367,0,11,-3,19,109930,7193,434139,0.02230794513414148,156813,551,0.09131187832064054,4463,371,55,11,437,12207,0.024494189081567117,2730,7,316,6,0.13183065748041567,13,808,0,126,214,-1,1148,682,0.1488438459326325,240511,83698,
8,0.03396358543417367,0,11,-3,19,109930,7193,434139,0.02230794513414148,156813,551,0.09131187832064054,4463,371,55,11,437,12207,0.024494189081567117,2730,7,316,6,0.13183065748041567,13,808,0,126,214,-1,1148,682,0.1488438459326325,240511,83698,
12,0.18347338935574228,2,26,-14,40,109930,7193,434139,0.05898880864158808,156813,551,0.09131187832064054,4463,169,265,105,539,12207,0.024494189081567117,2730,10,-96,6,0.22641268752016921,18,5359,2,1406,295,-4,7060,3953,0.14310742188563652,240511,83698,
12,0.18347338935574228,2,26,-14,40,109930,7193,434139,0.05898880864158808,156813,551,0.09131187832064054,4463,169,265,105,539,12207,0.024494189081567117,2730,10,-96,6,0.22641268752016921,18,5359,2,1406,295,-4,7060,3953,0.14310742188563652,240511,83698,
12,0.18347338935574228,2,26,-14,40,109930,7193,434139,0.05898880864158808,156813,551,0.09131187832064054,4463,169,265,105,539,12207,0.024494189081567117,2730,10,-96,6,0.22641268752016921,18,5359,2,1406,295,-4,7060,3953,0.14310742188563652,240511,83698,
12,0.18347338935574228,2,26,-14,40,109930,7193,434139,0.05898880864158808,156813,551,0.09131187832064054,4463,169,265,105,539,12207,0.024494189081567117,2730,10,-96,6,0.22641268752016921,18,5359,2,1406,295,-4,7060,3953,0.14310742188563652,240511,83698,
12,0.18347338935574228,2,26,-14,40,109930,7193,434139,0.05898880864158808,156813,551,0.09131187832064054,4463,169,265,105,539,12207,0.024494189081567117,2730,10,-96,6,0.22641268752016921,18,5359,2,1406,295,-4,7060,3953,0.14310742188563652,240511,83698,
12,0.18347338935574228,2,26,-14,40,109930,7193,434139,0.05898880864158808,156813,551,0.09131187832064054,4463,169,265,105,539,12207,0.024494189081567117,2730,10,-96,6,0.22641268752016921,18,5359,2,1406,295,-4,7060,3953,0.14310742188563652,240511,83698,
12,0.03691764287597967,2,26,-14,40,109930,7193,434139,0.05898880864158808,156813,551,0.09131187832064054,4463,2225,592,95,2912,12207,0.024494189081567117,2730,14,1633,4,0.1802123868932367,18,5359,0,1406,295,-10,7060,3953,0.14310742188563652,240511,83698,
12,0.03691764287597967,2,26,-14,40,109930,7193,434139,0.05898880864158808,156813,551,0.09131187832064054,4463,2225,592,95,2912,12207,0.024494189081567117,2730,14,1633,4,0.1802123868932367,18,5359,0,1406,295,-10,7060,3953,0.14310742188563652,240511,83698,
12,0.03691764287597967,2,26,-14,40,109930,7193,434139,0.05898880864158808,156813,551,0.09131187832064054,4463,2225,592,95,2912,12207,0.024494189081567117,2730,14,1633,4,0.1802123868932367,18,5359,0,1406,295,-10,7060,3953,0.14310742188563652,240511,83698,
12,0.03691764287597967,2,26,-14,40,109930,7193,434139,0.05898880864158808,156813,551,0.09131187832064054,4463,2225,592,95,2912,12207,0.024494189081567117,2730,14,1633,4,0.1802123868932367,18,5359,0,1406,295,-10,7060,3953,0.14310742188563652,240511,83698,
12,0.03691764287597967,2,26,-14,40,109930,7193,434139,0.05898880864158808,156813,551,0.09131187832064054,4463,2225,592,95,2912,12207,0.024494189081567117,2730,14,1633,4,0.1802123868932367,18,5359,0,1406,295,-10,7060,3953,0.14310742188563652,240511,83698,
12,0.03691764287597967,2,26,-14,40,109930,7193,434139,0.05898880864158808,156813,551,0.09131187832064054,4463,2225,592,95,2912,12207,0.024494189081567117,2730,14,1633,4,0.1802123868932367,18,5359,0,1406,295,-10,7060,3953,0.14310742188563652,240511,83698,
12,0.03691764287597967,2,26,-14,40,109930,7193,434139,0.05898880864158808,156813,551,0.09131187832064054,4463,2225,592,95,2912,12207,0.024494189081567117,2730,14,1633,4,0.1802123868932367,18,5359,0,1406,295,-10,7060,3953,0.14310742188563652,240511,83698,
12,0.03691764287597967,2,26,-14,40,109930,7193,434139,0.05898880864158808,156813,551,0.09131187832064054,4463,2225,592,95,2912,12207,0.024494189081567117,2730,14,1633,4,0.1802123868932367,18,5359,0,1406,295,-10,7060,3953,0.14310742188563652,240511,83698,
12,0.01556420233463035,2,26,-14,40,109930,7193,434139,0.05898880864158808,156813,551,0.09131187832064054,4463,2965,549,78,3592,12207,0.024494189081567117,2730,2,2416,2,0.16546842742988604,4,5359,0,1406,295,0,7060,3953,0.14310742188563652,240511,83698,
12,0.01556420233463035,2,26,-14,40,109930,7193,434139,0.05898880864158808,156813,551,0.09131187832064054,4463,2965,549,78,3592,12207,0.024494189081567117,2730,2,2416,2,0.16546842742988604,4,5359,0,1406,295,0,7060,3953,0.14310742188563652,240511,83698,
12,0.01556420233463035,2,26,-14,40,109930,7193,434139,0.05898880864158808,156813,551,0.09131187832064054,4463,2965,549,78,3592,12207,0.024494189081567117,2730,2,2416,2,0.16546842742988604,4,5359,0,1406,295,0,7060,3953,0.14310742188563652,240511,83698,
12,0.01556420233463035,2,26,-14,40,109930,7193,434139,0.05898880864158808,156813,551,0.09131187832064054,4463,2965,549,78,3592,12207,0.024494189081567117,2730,2,2416,2,0.16546842742988604,4,5359,0,1406,295,0,7060,3953,0.14310742188563652,240511,83698,
12,0.01556420233463035,2,26,-14,40,109930,7193,434139,0.05898880864158808,156813,551,0.09131187832064054,4463,2965,549,78,3592,12207,0.024494189081567117,2730,2,2416,2,0.16546842742988604,4,5359,0,1406,295,0,7060,3953,0.14310742188563652,240511,83698,
12,0.01556420233463035,2,26,-14,40,109930,7193,434139,0.05898880864158808,156813,551,0.09131187832064054,4463,2965,549,78,3592,12207,0.024494189081567117,2730,2,2416,2,0.16546842742988604,4,5359,0,1406,295,0,7060,3953,0.14310742188563652,240511,83698,
12,0.01556420233463035,2,26,-14,40,109930,7193,434139,0.05898880864158808,156813,551,0.09131187832064054,4463,2965,549,78,3592,12207,0.024494189081567117,2730,2,2416,2,0.16546842742988604,4,5359,0,1406,295,0,7060,3953,0.14310742188563652,240511,83698,
12,0.01556420233463035,2,26,-14,40,109930,7193,434139,0.05898880864158808,156813,551,0.09131187832064054,4463,2965,549,78,3592,12207,0.024494189081567117,2730,2,2416,2,0.16546842742988604,4,5359,0,1406,295,0,7060,3953,0.14310742188563652,240511,83698,
12,0.01556420233463035,2,26,-14,40,109930,7193,434139,0.05898880864158808,156813,551,0.09131187832064054,4463,2965,549,78,3592,12207,0.024494189081567117,2730,2,2416,2,0.16546842742988604,4,5359,0,1406,295,0,7060,3953,0.14310742188563652,240511,83698,
12,0.01556420233463035,2,26,-14,40,109930,7193,434139,0.05898880864158808,156813,551,0.09131187832064054,4463,2965,549,78,3592,12207,0.024494189081567117,2730,2,2416,2,0.16546842742988604,4,5359,0,1406,295,0,7060,3953,0.14310742188563652,240511,83698,
12,0.01556420233463035,2,26,-14,40,109930,7193,434139,0.05898880864158808,156813,551,0.09131187832064054,4463,2965,549,78,3592,12207,0.024494189081567117,2730,2,2416,2,0.16546842742988604,4,5359,0,1406,295,0,7060,3953,0.14310742188563652,240511,83698,
12,0.01556420233463035,2,26,-14,40,109930,7193,434139,0.05898880864158808,156813,551,0.09131187832064054,4463,2965,549,78,3592,12207,0.024494189081567117,2730,2,2416,2,0.16546842742988604,4,5359,0,1406,295,0,7060,3953,0.14310742188563652,240511,83698,
12,0.0,6,13,-1,31,109930,7193,434139,0.029316505890543798,156813,551,0.09131187832064054,4463,40,64,345,449,12207,0.024494189081567117,2730,0,-24,0,0.10775014118192365,0,4575,0,1468,2250,0,8293,3107,0.10639909167419927,240511,83698,
12,0.0,6,13,-1,31,109930,7193,434139,0.029316505890543798,156813,551,0.09131187832064054,4463,40,64,345,449,12207,0.024494189081567117,2730,0,-24,0,0.10775014118192365,0,4575,0,1468,2250,0,8293,3107,0.10639909167419927,240511,83698,
12,0.0,6,13,-1,31,109930,7193,434139,0.029316505890543798,156813,551,0.09131187832064054,4463,40,64,345,449,12207,0.024494189081567117,2730,0,-24,0,0.10775014118192365,0,4575,0,1468,2250,0,8293,3107,0.10639909167419927,240511,83698,
12,0.0,6,13,-1,31,109930,7193,434139,0.029316505890543798,156813,551,0.09131187832064054,4463,949,112,78,1139,12207,0.024494189081567117,2730,0,837,0,0.11281108857011604,0,4575,0,1468,2250,0,8293,3107,0.10639909167419927,240511,83698,
12,0.0,6,13,-1,31,109930,7193,434139,0.029316505890543798,156813,551,0.09131187832064054,4463,949,112,78,1139,12207,0.024494189081567117,2730,0,837,0,0.11281108857011604,0,4575,0,1468,2250,0,8293,3107,0.10639909167419927,240511,83698,
12,0.0,6,13,-1,31,109930,7193,434139,0.029316505890543798,156813,551,0.09131187832064054,4463,949,112,78,1139,12207,0.024494189081567117,2730,0,837,0,0.11281108857011604,0,4575,0,1468,2250,0,8293,3107,0.10639909167419927,240511,83698,
12,0.0,6,13,-1,31,109930,7193,434139,0.029316505890543798,156813,551,0.09131187832064054,4463,949,112,78,1139,12207,0.024494189081567117,2730,0,837,0,0.11281108857011604,0,4575,0,1468,2250,0,8293,3107,0.10639909167419927,240511,83698,
12,0.0,6,13,-1,31,109930,7193,434139,0.029316505890543798,156813,551,0.09131187832064054,4463,949,112,78,1139,12207,0.024494189081567117,2730,0,837,0,0.11281108857011604,0,4575,0,1468,2250,0,8293,3107,0.10639909167419927,240511,83698,
12,0.0,6,13,-1,31,109930,7193,434139,0.029316505890543798,156813,551,0.09131187832064054,4463,949,112,78,1139,12207,0.024494189081567117,2730,0,837,0,0.11281108857011604,0,4575,0,1468,2250,0,8293,3107,0.10639909167419927,240511,83698,
12,0.0,6,13,-1,31,109930,7193,434139,0.029316505890543798,156813,551,0.09131187832064054,4463,949,112,78,1139,12207,0.024494189081567117,2730,0,837,0,0.11281108857011604,0,4575,0,1468,2250,0,8293,3107,0.10639909167419927,240511,83698,
12,0.0,6,13,-1,31,109930,7193,434139,0.029316505890543798,156813,551,0.09131187832064054,4463,949,112,78,1139,12207,0.024494189081567117,2730,0,837,0,0.11281108857011604,0,4575,0,1468,2250,0,8293,3107,0.10639909167419927,240511,83698,
12,0.0,6,13,-1,31,109930,7193,434139,0.029316505890543798,156813,551,0.09131187832064054,4463,949,112,78,1139,12207,0.024494189081567117,2730,0,837,0,0.11281108857011604,0,4575,0,1468,2250,0,8293,3107,0.10639909167419927,240511,83698,
12,0.0,6,13,-1,31,109930,7193,434139,0.029316505890543798,156813,551,0.09131187832064054,4463,949,112,78,1139,12207,0.024494189081567117,2730,0,837,0,0.11281108857011604,0,4575,0,1468,2250,0,8293,3107,0.10639909167419927,240511,83698,
12,0.0,6,13,-1,31,109930,7193,434139,0.029316505890543798,156813,551,0.09131187832064054,4463,949,112,78,1139,12207,0.024494189081567117,2730,0,837,0,0.11281108857011604,0,4575,0,1468,2250,0,8293,3107,0.10639909167419927,240511,83698,
12,0.0,6,13,-1,31,109930,7193,434139,0.029316505890543798,156813,551,0.09131187832064054,4463,949,112,78,1139,12207,0.024494189081567117,2730,0,837,0,0.11281108857011604,0,4575,0,1468,2250,0,8293,3107,0.10639909167419927,240511,83698,
12,0.0,6,13,-1,31,109930,7193,434139,0.029316505890543798,156813,551,0.09131187832064054,4463,949,112,78,1139,12207,0.024494189081567117,2730,0,837,0,0.11281108857011604,0,4575,0,1468,2250,0,8293,3107,0.10639909167419927,240511,83698,
12,0.30261437908496736,6,13,-1,31,109930,7193,434139,0.029316505890543798,156813,551,0.09131187832064054,4463,1459,551,97,2107,12207,0.024494189081567117,2730,11,908,7,0.17687658871708903,24,4575,6,1468,2250,-4,8293,3107,0.10639909167419927,240511,83698,
12,0.0,6,13,-1,31,109930,7193,434139,0.029316505890543798,156813,551,0.09131187832064054,4463,69,260,602,931,12207,0.024494189081567117,2730,0,-191,0,0.08717951288993823,0,4575,0,1468,2250,0,8293,3107,0.10639909167419927,240511,83698,
12,0.0,6,13,-1,31,109930,7193,434139,0.029316505890543798,156813,551,0.09131187832064054,4463,69,260,602,931,12207,0.024494189081567117,2730,0,-191,0,0.08717951288993823,0,4575,0,1468,2250,0,8293,3107,0.10639909167419927,240511,83698,
12,0.0,6,13,-1,31,109930,7193,434139,0.029316505890543798,156813,551,0.09131187832064054,4463,69,260,602,931,12207,0.024494189081567117,2730,0,-191,0,0.08717951288993823,0,4575,0,1468,2250,0,8293,3107,0.10639909167419927,240511,83698,
12,0.0,6,13,-1,31,109930,7193,434139,0.029316505890543798,156813,551,0.09131187832064054,4463,69,260,602,931,12207,0.024494189081567117,2730,0,-191,0,0.08717951288993823,0,4575,0,1468,2250,0,8293,3107,0.10639909167419927,240511,83698,
12,0.0,6,13,-1,31,109930,7193,434139,0.029316505890543798,156813,551,0.09131187832064054,4463,1535,195,51,1781,12207,0.024494189081567117,2730,0,1340,0,0.1390396841518034,0,4575,0,1468,2250,0,8293,3107,0.10639909167419927,240511,83698,
12,0.0,6,13,-1,31,109930,7193,434139,0.029316505890543798,156813,551,0.09131187832064054,4463,1535,195,51,1781,12207,0.024494189081567117,2730,0,1340,0,0.1390396841518034,0,4575,0,1468,2250,0,8293,3107,0.10639909167419927,240511,83698,
12,0.0,6,13,-1,31,109930,7193,434139,0.029316505890543798,156813,551,0.09131187832064054,4463,1535,195,51,1781,12207,0.024494189081567117,2730,0,1340,0,0.1390396841518034,0,4575,0,1468,2250,0,8293,3107,0.10639909167419927,240511,83698,
12,0.0,6,13,-1,31,109930,7193,434139,0.029316505890543798,156813,551,0.09131187832064054,4463,1535,195,51,1781,12207,0.024494189081567117,2730,0,1340,0,0.1390396841518034,0,4575,0,1468,2250,0,8293,3107,0.10639909167419927,240511,83698,
12,0.0,6,13,-1,31,109930,7193,434139,0.029316505890543798,156813,551,0.09131187832064054,4463,1535,195,51,1781,12207,0.024494189081567117,2730,0,1340,0,0.1390396841518034,0,4575,0,1468,2250,0,8293,3107,0.10639909167419927,240511,83698,
12,0.0,6,13,-1,31,109930,7193,434139,0.029316505890543798,156813,551,0.09131187832064054,4463,1535,195,51,1781,12207,0.024494189081567117,2730,0,1340,0,0.1390396841518034,0,4575,0,1468,2250,0,8293,3107,0.10639909167419927,240511,83698,
1,0.0,0,1,0,2,109930,7193,434139,0.003344481605351171,156813,551,0.09131187832064054,4463,368,12,1,381,12207,0.024494189081567117,2730,0,356,0,0.10079190610053942,0,1402,0,255,1904,0,3561,1147,0.031015504258590752,240511,83698,
1,0.0,0,1,0,2,109930,7193,434139,0.003344481605351171,156813,551,0.09131187832064054,4463,16,10,64,90,12207,0.024494189081567117,2730,0,6,0,0.01028256421835738,0,1402,0,255,1904,0,3561,1147,0.031015504258590752,240511,83698,
1,0.0,0,1,0,2,109930,7193,434139,0.003344481605351171,156813,551,0.09131187832064054,4463,16,10,64,90,12207,0.024494189081567117,2730,0,6,0,0.01028256421835738,0,1402,0,255,1904,0,3561,1147,0.031015504258590752,240511,83698,
1,0.0,0,1,0,2,109930,7193,434139,0.003344481605351171,156813,551,0.09131187832064054,4463,22,11,151,184,12207,0.024494189081567117,2730,0,11,0,0.008938093700470833,0,1402,0,255,1904,0,3561,1147,0.031015504258590752,240511,83698,
1,0.0,0,1,0,2,109930,7193,434139,0.003344481605351171,156813,551,0.09131187832064054,4463,22,11,151,184,12207,0.024494189081567117,2730,0,11,0,0.008938093700470833,0,1402,0,255,1904,0,3561,1147,0.031015504258590752,240511,83698,
1,0.0,0,1,0,2,109930,7193,434139,0.003344481605351171,156813,551,0.09131187832064054,4463,22,11,151,184,12207,0.024494189081567117,2730,0,11,0,0.008938093700470833,0,1402,0,255,1904,0,3561,1147,0.031015504258590752,240511,83698,
1,0.0,0,1,0,2,109930,7193,434139,0.003344481605351171,156813,551,0.09131187832064054,4463,317,24,1,342,12207,0.024494189081567117,2730,0,293,0,0.06342851478507575,0,1402,0,255,1904,0,3561,1147,0.031015504258590752,240511,83698,
1,0.0,0,1,0,2,109930,7193,434139,0.003344481605351171,156813,551,0.09131187832064054,4463,317,24,1,342,12207,0.024494189081567117,2730,0,293,0,0.06342851478507575,0,1402,0,255,1904,0,3561,1147,0.031015504258590752,240511,83698,
1,0.0,0,1,0,2,109930,7193,434139,0.003344481605351171,156813,551,0.09131187832064054,4463,8,5,199,212,12207,0.024494189081567117,2730,0,3,0,0.005939455783066355,0,1402,0,255,1904,0,3561,1147,0.031015504258590752,240511,83698,
1,0.0,0,1,0,2,109930,7193,434139,0.003344481605351171,156813,551,0.09131187832064054,4463,15,19,512,546,12207,0.024494189081567117,2730,0,-4,0,0.04532106516451544,0,1402,0,255,1904,0,3561,1147,0.031015504258590752,240511,83698,
1,0.0,0,1,0,2,109930,7193,434139,0.003344481605351171,156813,551,0.09131187832064054,4463,15,19,512,546,12207,0.024494189081567117,2730,0,-4,0,0.04532106516451544,0,1402,0,255,1904,0,3561,1147,0.031015504258590752,240511,83698,
65,0.0,0,45,20,110,109930,7193,434139,0.039071338799835056,156813,551,0.09131187832064054,4463,101,72,367,540,12207,0.024494189081567117,2730,0,29,0,0.160721585979004,0,7464,0,2515,4967,0,14946,4949,0.10126312838610864,240511,83698,
65,0.0,0,45,20,110,109930,7193,434139,0.039071338799835056,156813,551,0.09131187832064054,4463,101,72,367,540,12207,0.024494189081567117,2730,0,29,0,0.160721585979004,0,7464,0,2515,4967,0,14946,4949,0.10126312838610864,240511,83698,
65,0.0,0,45,20,110,109930,7193,434139,0.039071338799835056,156813,551,0.09131187832064054,4463,101,72,367,540,12207,0.024494189081567117,2730,0,29,0,0.160721585979004,0,7464,0,2515,4967,0,14946,4949,0.10126312838610864,240511,83698,
65,0.0706140350877193,0,45,20,110,109930,7193,434139,0.039071338799835056,156813,551,0.09131187832064054,4463,722,139,49,910,12207,0.024494189081567117,2730,3,583,2,0.1584361576018712,5,7464,0,2515,4967,-1,14946,4949,0.10126312838610864,240511,83698,
65,0.0706140350877193,0,45,20,110,109930,7193,434139,0.039071338799835056,156813,551,0.09131187832064054,4463,722,139,49,910,12207,0.024494189081567117,2730,3,583,2,0.1584361576018712,5,7464,0,2515,4967,-1,14946,4949,0.10126312838610864,240511,83698,
65,0.0706140350877193,0,45,20,110,109930,7193,434139,0.039071338799835056,156813,551,0.09131187832064054,4463,722,139,49,910,12207,0.024494189081567117,2730,3,583,2,0.1584361576018712,5,7464,0,2515,4967,-1,14946,4949,0.10126312838610864,240511,83698,
65,0.0706140350877193,0,45,20,110,109930,7193,434139,0.039071338799835056,156813,551,0.09131187832064054,4463,722,139,49,910,12207,0.024494189081567117,2730,3,583,2,0.1584361576018712,5,7464,0,2515,4967,-1,14946,4949,0.10126312838610864,240511,83698,
65,0.0706140350877193,0,45,20,110,109930,7193,434139,0.039071338799835056,156813,551,0.09131187832064054,4463,722,139,49,910,12207,0.024494189081567117,2730,3,583,2,0.1584361576018712,5,7464,0,2515,4967,-1,14946,4949,0.10126312838610864,240511,83698,
65,0.0706140350877193,0,45,20,110,109930,7193,434139,0.039071338799835056,156813,551,0.09131187832064054,4463,722,139,49,910,12207,0.024494189081567117,2730,3,583,2,0.1584361576018712,5,7464,0,2515,4967,-1,14946,4949,0.10126312838610864,240511,83698,
65,0.0,0,45,20,110,109930,7193,434139,0.039071338799835056,156813,551,0.09131187832064054,4463,169,71,129,369,12207,0.024494189081567117,2730,0,98,0,0.1887297859029616,0,7464,0,2515,4967,0,14946,4949,0.10126312838610864,240511,83698,
65,0.0,0,45,20,110,109930,7193,434139,0.039071338799835056,156813,551,0.09131187832064054,4463,169,71,129,369,12207,0.024494189081567117,2730,0,98,0,0.1887297859029616,0,7464,0,2515,4967,0,14946,4949,0.10126312838610864,240511,83698,
65,0.5098039215686274,0,45,20,110,109930,7193,434139,0.039071338799835056,156813,551,0.09131187832064054,4463,2976,898,2436,6310,12207,0.024494189081567117,2730,2,2078,24,0.21433360988513586,26,7464,0,2515,4967,22,14946,4949,0.10126312838610864,240511,83698,
65,0.5098039215686274,0,45,20,110,109930,7193,434139,0.039071338799835056,156813,551,0.09131187832064054,4463,2976,898,2436,6310,12207,0.024494189081567117,2730,2,2078,24,0.21433360988513586,26,7464,0,2515,4967,22,14946,4949,0.10126312838610864,240511,83698,
65,0.5098039215686274,0,45,20,110,109930,7193,434139,0.039071338799835056,156813,551,0.09131187832064054,4463,2976,898,2436,6310,12207,0.024494189081567117,2730,2,2078,24,0.21433360988513586,26,7464,0,2515,4967,22,14946,4949,0.10126312838610864,240511,83698,
65,0.5098039215686274,0,45,20,110,109930,7193,434139,0.039071338799835056,156813,551,0.09131187832064054,4463,2976,898,2436,6310,12207,0.024494189081567117,2730,2,2078,24,0.21433360988513586,26,7464,0,2515,4967,22,14946,4949,0.10126312838610864,240511,83698,
65,0.5098039215686274,0,45,20,110,109930,7193,434139,0.039071338799835056,156813,551,0.09131187832064054,4463,2976,898,2436,6310,12207,0.024494189081567117,2730,2,2078,24,0.21433360988513586,26,7464,0,2515,4967,22,14946,4949,0.10126312838610864,240511,83698,
65,0.5098039215686274,0,45,20,110,109930,7193,434139,0.039071338799835056,156813,551,0.09131187832064054,4463,2976,898,2436,6310,12207,0.024494189081567117,2730,2,2078,24,0.21433360988513586,26,7464,0,2515,4967,22,14946,4949,0.10126312838610864,240511,83698,
65,0.5098039215686274,0,45,20,110,109930,7193,434139,0.039071338799835056,156813,551,0.09131187832064054,4463,2976,898,2436,6310,12207,0.024494189081567117,2730,2,2078,24,0.21433360988513586,26,7464,0,2515,4967,22,14946,4949,0.10126312838610864,240511,83698,
65,0.5098039215686274,0,45,20,110,109930,7193,434139,0.039071338799835056,156813,551,0.09131187832064054,4463,2976,898,2436,6310,12207,0.024494189081567117,2730,2,2078,24,0.21433360988513586,26,7464,0,2515,4967,22,14946,4949,0.10126312838610864,240511,83698,
65,0.5098039215686274,0,45,20,110,109930,7193,434139,0.039071338799835056,156813,551,0.09131187832064054,4463,2976,898,2436,6310,12207,0.024494189081567117,2730,2,2078,24,0.21433360988513586,26,7464,0,2515,4967,22,14946,4949,0.10126312838610864,240511,83698,
65,0.0,0,45,20,110,109930,7193,434139,0.039071338799835056,156813,551,0.09131187832064054,4463,80,0,0,80,12207,0.024494189081567117,2730,0,80,0,0.6153846153846154,0,7464,0,2515,4967,0,14946,4949,0.10126312838610864,240511,83698,
65,0.0,0,45,20,110,109930,7193,434139,0.039071338799835056,156813,551,0.09131187832064054,4463,36,110,286,432,12207,0.024494189081567117,2730,0,-74,0,0.07220291038558302,0,7464,0,2515,4967,0,14946,4949,0.10126312838610864,240511,83698,
65,0.0,0,45,20,110,109930,7193,434139,0.039071338799835056,156813,551,0.09131187832064054,4463,36,110,286,432,12207,0.024494189081567117,2730,0,-74,0,0.07220291038558302,0,7464,0,2515,4967,0,14946,4949,0.10126312838610864,240511,83698,
65,0.0,0,45,20,110,109930,7193,434139,0.039071338799835056,156813,551,0.09131187832064054,4463,525,34,1,560,12207,0.024494189081567117,2730,0,491,0,0.056596646903466025,0,7464,0,2515,4967,0,14946,4949,0.10126312838610864,240511,83698,
65,0.0,0,45,20,110,109930,7193,434139,0.039071338799835056,156813,551,0.09131187832064054,4463,525,34,1,560,12207,0.024494189081567117,2730,0,491,0,0.056596646903466025,0,7464,0,2515,4967,0,14946,4949,0.10126312838610864,240511,83698,
65,0.0,0,45,20,110,109930,7193,434139,0.039071338799835056,156813,551,0.09131187832064054,4463,525,34,1,560,12207,0.024494189081567117,2730,0,491,0,0.056596646903466025,0,7464,0,2515,4967,0,14946,4949,0.10126312838610864,240511,83698,
65,0.0,0,45,20,110,109930,7193,434139,0.039071338799835056,156813,551,0.09131187832064054,4463,525,34,1,560,12207,0.024494189081567117,2730,0,491,0,0.056596646903466025,0,7464,0,2515,4967,0,14946,4949,0.10126312838610864,240511,83698,
65,0.0,0,45,20,110,109930,7193,434139,0.039071338799835056,156813,551,0.09131187832064054,4463,525,34,1,560,12207,0.024494189081567117,2730,0,491,0,0.056596646903466025,0,7464,0,2515,4967,0,14946,4949,0.10126312838610864,240511,83698,
65,0.0,0,45,20,110,109930,7193,434139,0.039071338799835056,156813,551,0.09131187832064054,4463,525,34,1,560,12207,0.024494189081567117,2730,0,491,0,0.056596646903466025,0,7464,0,2515,4967,0,14946,4949,0.10126312838610864,240511,83698,
65,0.0,0,45,20,110,109930,7193,434139,0.039071338799835056,156813,551,0.09131187832064054,4463,525,34,1,560,12207,0.024494189081567117,2730,0,491,0,0.056596646903466025,0,7464,0,2515,4967,0,14946,4949,0.10126312838610864,240511,83698,
65,0.0,0,45,20,110,109930,7193,434139,0.039071338799835056,156813,551,0.09131187832064054,4463,525,34,1,560,12207,0.024494189081567117,2730,0,491,0,0.056596646903466025,0,7464,0,2515,4967,0,14946,4949,0.10126312838610864,240511,83698,
65,0.0,0,45,20,110,109930,7193,434139,0.039071338799835056,156813,551,0.09131187832064054,4463,525,34,1,560,12207,0.024494189081567117,2730,0,491,0,0.056596646903466025,0,7464,0,2515,4967,0,14946,4949,0.10126312838610864,240511,83698,
65,0.0,0,45,20,110,109930,7193,434139,0.039071338799835056,156813,551,0.09131187832064054,4463,525,34,1,560,12207,0.024494189081567117,2730,0,491,0,0.056596646903466025,0,7464,0,2515,4967,0,14946,4949,0.10126312838610864,240511,83698,
65,0.0,0,45,20,110,109930,7193,434139,0.039071338799835056,156813,551,0.09131187832064054,4463,525,34,1,560,12207,0.024494189081567117,2730,0,491,0,0.056596646903466025,0,7464,0,2515,4967,0,14946,4949,0.10126312838610864,240511,83698,
65,0.0,0,45,20,110,109930,7193,434139,0.039071338799835056,156813,551,0.09131187832064054,4463,525,34,1,560,12207,0.024494189081567117,2730,0,491,0,0.056596646903466025,0,7464,0,2515,4967,0,14946,4949,0.10126312838610864,240511,83698,
65,0.0,0,45,20,110,109930,7193,434139,0.039071338799835056,156813,551,0.09131187832064054,4463,525,34,1,560,12207,0.024494189081567117,2730,0,491,0,0.056596646903466025,0,7464,0,2515,4967,0,14946,4949,0.10126312838610864,240511,83698,
65,0.0,0,45,20,110,109930,7193,434139,0.039071338799835056,156813,551,0.09131187832064054,4463,525,34,1,560,12207,0.024494189081567117,2730,0,491,0,0.056596646903466025,0,7464,0,2515,4967,0,14946,4949,0.10126312838610864,240511,83698,
65,0.0,0,45,20,110,109930,7193,434139,0.039071338799835056,156813,551,0.09131187832064054,4463,525,34,1,560,12207,0.024494189081567117,2730,0,491,0,0.056596646903466025,0,7464,0,2515,4967,0,14946,4949,0.10126312838610864,240511,83698,
65,0.0,0,45,20,110,109930,7193,434139,0.039071338799835056,156813,551,0.09131187832064054,4463,525,34,1,560,12207,0.024494189081567117,2730,0,491,0,0.056596646903466025,0,7464,0,2515,4967,0,14946,4949,0.10126312838610864,240511,83698,
65,0.0,0,45,20,110,109930,7193,434139,0.039071338799835056,156813,551,0.09131187832064054,4463,525,34,1,560,12207,0.024494189081567117,2730,0,491,0,0.056596646903466025,0,7464,0,2515,4967,0,14946,4949,0.10126312838610864,240511,83698,
65,0.0,0,45,20,110,109930,7193,434139,0.039071338799835056,156813,551,0.09131187832064054,4463,525,34,1,560,12207,0.024494189081567117,2730,0,491,0,0.056596646903466025,0,7464,0,2515,4967,0,14946,4949,0.10126312838610864,240511,83698,
65,0.0,0,45,20,110,109930,7193,434139,0.039071338799835056,156813,551,0.09131187832064054,4463,525,34,1,560,12207,0.024494189081567117,2730,0,491,0,0.056596646903466025,0,7464,0,2515,4967,0,14946,4949,0.10126312838610864,240511,83698,
65,0.006389776357827476,0,45,20,110,109930,7193,434139,0.039071338799835056,156813,551,0.09131187832064054,4463,8,4,86,98,12207,0.024494189081567117,2730,1,4,1,0.01577708049005271,2,7464,0,2515,4967,0,14946,4949,0.10126312838610864,240511,83698,
65,0.13333333333333333,0,45,20,110,109930,7193,434139,0.039071338799835056,156813,551,0.09131187832064054,4463,683,484,136,1303,12207,0.024494189081567117,2730,2,199,0,0.18230983012096297,2,7464,0,2515,4967,-2,14946,4949,0.10126312838610864,240511,83698,
65,0.13333333333333333,0,45,20,110,109930,7193,434139,0.039071338799835056,156813,551,0.09131187832064054,4463,683,484,136,1303,12207,0.024494189081567117,2730,2,199,0,0.18230983012096297,2,7464,0,2515,4967,-2,14946,4949,0.10126312838610864,240511,83698,
65,0.13333333333333333,0,45,20,110,109930,7193,434139,0.039071338799835056,156813,551,0.09131187832064054,4463,683,484,136,1303,12207,0.024494189081567117,2730,2,199,0,0.18230983012096297,2,7464,0,2515,4967,-2,14946,4949,0.10126312838610864,240511,83698,
65,0.13333333333333333,0,45,20,110,109930,7193,434139,0.039071338799835056,156813,551,0.09131187832064054,4463,683,484,136,1303,12207,0.024494189081567117,2730,2,199,0,0.18230983012096297,2,7464,0,2515,4967,-2,14946,4949,0.10126312838610864,240511,83698,
65,0.13333333333333333,0,45,20,110,109930,7193,434139,0.039071338799835056,156813,551,0.09131187832064054,4463,683,484,136,1303,12207,0.024494189081567117,2730,2,199,0,0.18230983012096297,2,7464,0,2515,4967,-2,14946,4949,0.10126312838610864,240511,83698,
65,0.13333333333333333,0,45,20,110,109930,7193,434139,0.039071338799835056,156813,551,0.09131187832064054,4463,683,484,136,1303,12207,0.024494189081567117,2730,2,199,0,0.18230983012096297,2,7464,0,2515,4967,-2,14946,4949,0.10126312838610864,240511,83698,
65,0.13333333333333333,0,45,20,110,109930,7193,434139,0.039071338799835056,156813,551,0.09131187832064054,4463,683,484,136,1303,12207,0.024494189081567117,2730,2,199,0,0.18230983012096297,2,7464,0,2515,4967,-2,14946,4949,0.10126312838610864,240511,83698,
65,0.006134969325153374,0,45,20,110,109930,7193,434139,0.039071338799835056,156813,551,0.09131187832064054,4463,9,5,126,140,12207,0.024494189081567117,2730,1,4,1,0.016840467317915678,2,7464,0,2515,4967,0,14946,4949,0.10126312838610864,240511,83698,
65,0.006134969325153374,0,45,20,110,109930,7193,434139,0.039071338799835056,156813,551,0.09131187832064054,4463,9,5,126,140,12207,0.024494189081567117,2730,1,4,1,0.016840467317915678,2,7464,0,2515,4967,0,14946,4949,0.10126312838610864,240511,83698,
65,0.13043478260869565,0,45,20,110,109930,7193,434139,0.039071338799835056,156813,551,0.09131187832064054,4463,352,194,289,835,12207,0.024494189081567117,2730,2,158,1,0.20204278037061785,3,7464,0,2515,4967,-1,14946,4949,0.10126312838610864,240511,83698,
65,0.13043478260869565,0,45,20,110,109930,7193,434139,0.039071338799835056,156813,551,0.09131187832064054,4463,352,194,289,835,12207,0.024494189081567117,2730,2,158,1,0.20204278037061785,3,7464,0,2515,4967,-1,14946,4949,0.10126312838610864,240511,83698,
65,0.13043478260869565,0,45,20,110,109930,7193,434139,0.039071338799835056,156813,551,0.09131187832064054,4463,352,194,289,835,12207,0.024494189081567117,2730,2,158,1,0.20204278037061785,3,7464,0,2515,4967,-1,14946,4949,0.10126312838610864,240511,83698,
65,0.13043478260869565,0,45,20,110,109930,7193,434139,0.039071338799835056,156813,551,0.09131187832064054,4463,352,194,289,835,12207,0.024494189081567117,2730,2,158,1,0.20204278037061785,3,7464,0,2515,4967,-1,14946,4949,0.10126312838610864,240511,83698,
65,0.13043478260869565,0,45,20,110,109930,7193,434139,0.039071338799835056,156813,551,0.09131187832064054,4463,352,194,289,835,12207,0.024494189081567117,2730,2,158,1,0.20204278037061785,3,7464,0,2515,4967,-1,14946,4949,0.10126312838610864,240511,83698,
65,0.13043478260869565,0,45,20,110,109930,7193,434139,0.039071338799835056,156813,551,0.09131187832064054,4463,352,194,289,835,12207,0.024494189081567117,2730,2,158,1,0.20204278037061785,3,7464,0,2515,4967,-1,14946,4949,0.10126312838610864,240511,83698,
65,0.00702576112412178,0,45,20,110,109930,7193,434139,0.039071338799835056,156813,551,0.09131187832064054,4463,281,34,3,318,12207,0.024494189081567117,2730,2,247,1,0.07681006317198628,3,7464,0,2515,4967,-1,14946,4949,0.10126312838610864,240511,83698,
65,0.0,0,45,20,110,109930,7193,434139,0.039071338799835056,156813,551,0.09131187832064054,4463,335,114,287,736,12207,0.024494189081567117,2730,0,221,0,0.18655926819724294,0,7464,0,2515,4967,0,14946,4949,0.10126312838610864,240511,83698,
65,0.015503875968992248,0,45,20,110,109930,7193,434139,0.039071338799835056,156813,551,0.09131187832064054,4463,34,26,0,60,12207,0.024494189081567117,2730,3,8,3,0.1831722247328755,6,7464,0,2515,4967,0,14946,4949,0.10126312838610864,240511,83698,
144,0.0,2,19,125,165,109930,7193,434139,0.046199910225657004,156813,551,0.09131187832064054,4463,259,4,0,263,12207,0.024494189081567117,2730,0,255,0,0.2039149468417761,0,2822,0,174,92,0,3088,2648,0.09639174315408097,240511,83698,
144,0.0,2,19,125,165,109930,7193,434139,0.046199910225657004,156813,551,0.09131187832064054,4463,8,3,7,18,12207,0.024494189081567117,2730,0,5,0,0.09205112169464891,0,2822,0,174,92,0,3088,2648,0.09639174315408097,240511,83698,
144,0.19894894894894893,2,19,125,165,109930,7193,434139,0.046199910225657004,156813,551,0.09131187832064054,4463,151,12,2,165,12207,0.024494189081567117,2730,11,139,18,0.11491043152333473,31,2822,2,174,92,7,3088,2648,0.09639174315408097,240511,83698,
144,0.004819277108433735,2,19,125,165,109930,7193,434139,0.046199910225657004,156813,551,0.09131187832064054,4463,174,1,0,175,12207,0.024494189081567117,2730,1,173,1,0.022414263901117885,2,2822,0,174,92,0,3088,2648,0.09639174315408097,240511,83698,
144,0.004819277108433735,2,19,125,165,109930,7193,434139,0.046199910225657004,156813,551,0.09131187832064054,4463,174,1,0,175,12207,0.024494189081567117,2730,1,173,1,0.022414263901117885,2,2822,0,174,92,0,3088,2648,0.09639174315408097,240511,83698,
144,0.004819277108433735,2,19,125,165,109930,7193,434139,0.046199910225657004,156813,551,0.09131187832064054,4463,174,1,0,175,12207,0.024494189081567117,2730,1,173,1,0.022414263901117885,2,2822,0,174,92,0,3088,2648,0.09639174315408097,240511,83698,
144,0.0,2,19,125,165,109930,7193,434139,0.046199910225657004,156813,551,0.09131187832064054,4463,2,2,10,14,12207,0.024494189081567117,2730,0,0,0,0.00716966966966967,0,2822,0,174,92,0,3088,2648,0.09639174315408097,240511,83698,
5,0.0,0,5,0,10,109930,7193,434139,0.001282559893016023,156813,551,0.09131187832064054,4463,82,3,80,165,12207,0.024494189081567117,2730,0,79,0,0.04122632131546776,0,1022,0,89,1380,0,2491,933,0.024409928028601133,240511,83698,
5,0.0,0,5,0,10,109930,7193,434139,0.001282559893016023,156813,551,0.09131187832064054,4463,82,3,80,165,12207,0.024494189081567117,2730,0,79,0,0.04122632131546776,0,1022,0,89,1380,0,2491,933,0.024409928028601133,240511,83698,
5,0.0,0,5,0,10,109930,7193,434139,0.001282559893016023,156813,551,0.09131187832064054,4463,82,3,80,165,12207,0.024494189081567117,2730,0,79,0,0.04122632131546776,0,1022,0,89,1380,0,2491,933,0.024409928028601133,240511,83698,
5,0.0,0,5,0,10,109930,7193,434139,0.001282559893016023,156813,551,0.09131187832064054,4463,151,9,138,298,12207,0.024494189081567117,2730,0,142,0,0.06656743515253924,0,1022,0,89,1380,0,2491,933,0.024409928028601133,240511,83698,
5,0.0,0,5,0,10,109930,7193,434139,0.001282559893016023,156813,551,0.09131187832064054,4463,31,4,96,131,12207,0.024494189081567117,2730,0,27,0,0.10848332068755899,0,1022,0,89,1380,0,2491,933,0.024409928028601133,240511,83698,
5,0.0,0,5,0,10,109930,7193,434139,0.001282559893016023,156813,551,0.09131187832064054,4463,57,1,57,115,12207,0.024494189081567117,2730,0,56,0,0.0017781731830202052,0,1022,0,89,1380,0,2491,933,0.024409928028601133,240511,83698,
5,0.0,0,5,0,10,109930,7193,434139,0.001282559893016023,156813,551,0.09131187832064054,4463,57,1,57,115,12207,0.024494189081567117,2730,0,56,0,0.0017781731830202052,0,1022,0,89,1380,0,2491,933,0.024409928028601133,240511,83698,
6,0.0,1,7,-1,14,109930,7193,434139,0.0027512073531702754,156813,551,0.09131187832064054,4463,265,13,260,538,12207,0.024494189081567117,2730,0,252,0,0.06685973167656542,0,825,0,140,1364,0,2329,685,0.07934122202062013,240511,83698,
6,0.0,1,7,-1,14,109930,7193,434139,0.0027512073531702754,156813,551,0.09131187832064054,4463,21,9,133,163,12207,0.024494189081567117,2730,0,12,0,0.03625073876790962,0,825,0,140,1364,0,2329,685,0.07934122202062013,240511,83698,
6,0.015267175572519083,1,7,-1,14,109930,7193,434139,0.0027512073531702754,156813,551,0.09131187832064054,4463,92,45,568,705,12207,0.024494189081567117,2730,4,47,4,0.10207506091934303,8,825,0,140,1364,0,2329,685,0.07934122202062013,240511,83698,
6,0.015267175572519083,1,7,-1,14,109930,7193,434139,0.0027512073531702754,156813,551,0.09131187832064054,4463,92,45,568,705,12207,0.024494189081567117,2730,4,47,4,0.10207506091934303,8,825,0,140,1364,0,2329,685,0.07934122202062013,240511,83698,
6,0.015267175572519083,1,7,-1,14,109930,7193,434139,0.0027512073531702754,156813,551,0.09131187832064054,4463,92,45,568,705,12207,0.024494189081567117,2730,4,47,4,0.10207506091934303,8,825,0,140,1364,0,2329,685,0.07934122202062013,240511,83698,
6,0.0,1,7,-1,14,109930,7193,434139,0.0027512073531702754,156813,551,0.09131187832064054,4463,279,51,212,542,12207,0.024494189081567117,2730,0,228,0,0.1379348988096621,0,825,0,140,1364,0,2329,685,0.07934122202062013,240511,83698,
6,0.0,1,7,-1,14,109930,7193,434139,0.0027512073531702754,156813,551,0.09131187832064054,4463,279,51,212,542,12207,0.024494189081567117,2730,0,228,0,0.1379348988096621,0,825,0,140,1364,0,2329,685,0.07934122202062013,240511,83698,
6,0.0,1,7,-1,14,109930,7193,434139,0.0027512073531702754,156813,551,0.09131187832064054,4463,279,51,212,542,12207,0.024494189081567117,2730,0,228,0,0.1379348988096621,0,825,0,140,1364,0,2329,685,0.07934122202062013,240511,83698,
6,0.0,1,7,-1,14,109930,7193,434139,0.0027512073531702754,156813,551,0.09131187832064054,4463,279,51,212,542,12207,0.024494189081567117,2730,0,228,0,0.1379348988096621,0,825,0,140,1364,0,2329,685,0.07934122202062013,240511,83698,
6,0.0,1,7,-1,14,109930,7193,434139,0.0027512073531702754,156813,551,0.09131187832064054,4463,279,51,212,542,12207,0.024494189081567117,2730,0,228,0,0.1379348988096621,0,825,0,140,1364,0,2329,685,0.07934122202062013,240511,83698,
6,0.0,1,7,-1,14,109930,7193,434139,0.0027512073531702754,156813,551,0.09131187832064054,4463,279,51,212,542,12207,0.024494189081567117,2730,0,228,0,0.1379348988096621,0,825,0,140,1364,0,2329,685,0.07934122202062013,240511,83698,
6,0.0,1,7,-1,14,109930,7193,434139,0.0027512073531702754,156813,551,0.09131187832064054,4463,279,51,212,542,12207,0.024494189081567117,2730,0,228,0,0.1379348988096621,0,825,0,140,1364,0,2329,685,0.07934122202062013,240511,83698,
6,0.0,1,7,-1,14,109930,7193,434139,0.0027512073531702754,156813,551,0.09131187832064054,4463,279,51,212,542,12207,0.024494189081567117,2730,0,228,0,0.1379348988096621,0,825,0,140,1364,0,2329,685,0.07934122202062013,240511,83698,
6,0.0,1,7,-1,14,109930,7193,434139,0.0027512073531702754,156813,551,0.09131187832064054,4463,14,10,90,114,12207,0.024494189081567117,2730,0,4,0,0.09761934452961922,0,825,0,140,1364,0,2329,685,0.07934122202062013,240511,83698,
6,0.0,1,7,-1,14,109930,7193,434139,0.0027512073531702754,156813,551,0.09131187832064054,4463,14,10,90,114,12207,0.024494189081567117,2730,0,4,0,0.09761934452961922,0,825,0,140,1364,0,2329,685,0.07934122202062013,240511,83698,
6,0.0,0,6,0,12,109930,7193,434139,0.0018097411856242457,156813,551,0.09131187832064054,4463,13,5,73,91,12207,0.024494189081567117,2730,0,8,0,0.019536032106295714,0,1122,0,211,2191,0,3524,911,0.07752231391489935,240511,83698,
6,0.0,0,6,0,12,109930,7193,434139,0.0018097411856242457,156813,551,0.09131187832064054,4463,13,5,73,91,12207,0.024494189081567117,2730,0,8,0,0.019536032106295714,0,1122,0,211,2191,0,3524,911,0.07752231391489935,240511,83698,
6,0.004454342984409799,0,6,0,12,109930,7193,434139,0.0018097411856242457,156813,551,0.09131187832064054,4463,7,3,196,206,12207,0.024494189081567117,2730,1,4,1,0.0026881747215836533,2,1122,0,211,2191,0,3524,911,0.07752231391489935,240511,83698,
6,0.0,0,6,0,12,109930,7193,434139,0.0018097411856242457,156813,551,0.09131187832064054,4463,176,9,161,346,12207,0.024494189081567117,2730,0,167,0,0.040857902561266986,0,1122,0,211,2191,0,3524,911,0.07752231391489935,240511,83698,
6,0.0,0,6,0,12,109930,7193,434139,0.0018097411856242457,156813,551,0.09131187832064054,4463,63,78,728,869,12207,0.024494189081567117,2730,0,-15,0,0.12239987783544581,0,1122,0,211,2191,0,3524,911,0.07752231391489935,240511,83698,
6,0.0,0,6,0,12,109930,7193,434139,0.0018097411856242457,156813,551,0.09131187832064054,4463,63,78,728,869,12207,0.024494189081567117,2730,0,-15,0,0.12239987783544581,0,1122,0,211,2191,0,3524,911,0.07752231391489935,240511,83698,
6,0.0,0,6,0,12,109930,7193,434139,0.0018097411856242457,156813,551,0.09131187832064054,4463,63,78,728,869,12207,0.024494189081567117,2730,0,-15,0,0.12239987783544581,0,1122,0,211,2191,0,3524,911,0.07752231391489935,240511,83698,
6,0.0,0,6,0,12,109930,7193,434139,0.0018097411856242457,156813,551,0.09131187832064054,4463,63,78,728,869,12207,0.024494189081567117,2730,0,-15,0,0.12239987783544581,0,1122,0,211,2191,0,3524,911,0.07752231391489935,240511,83698,
6,0.0,0,6,0,12,109930,7193,434139,0.0018097411856242457,156813,551,0.09131187832064054,4463,63,78,728,869,12207,0.024494189081567117,2730,0,-15,0,0.12239987783544581,0,1122,0,211,2191,0,3524,911,0.07752231391489935,240511,83698,
6,0.0,0,6,0,12,109930,7193,434139,0.0018097411856242457,156813,551,0.09131187832064054,4463,63,78,728,869,12207,0.024494189081567117,2730,0,-15,0,0.12239987783544581,0,1122,0,211,2191,0,3524,911,0.07752231391489935,240511,83698,
6,0.0,0,6,0,12,109930,7193,434139,0.0018097411856242457,156813,551,0.09131187832064054,4463,63,78,728,869,12207,0.024494189081567117,2730,0,-15,0,0.12239987783544581,0,1122,0,211,2191,0,3524,911,0.07752231391489935,240511,83698,
6,0.0,0,6,0,12,109930,7193,434139,0.0018097411856242457,156813,551,0.09131187832064054,4463,63,78,728,869,12207,0.024494189081567117,2730,0,-15,0,0.12239987783544581,0,1122,0,211,2191,0,3524,911,0.07752231391489935,240511,83698,
6,0.0,0,6,0,12,109930,7193,434139,0.0018097411856242457,156813,551,0.09131187832064054,4463,63,78,728,869,12207,0.024494189081567117,2730,0,-15,0,0.12239987783544581,0,1122,0,211,2191,0,3524,911,0.07752231391489935,240511,83698,
6,0.0,0,6,0,12,109930,7193,434139,0.0018097411856242457,156813,551,0.09131187832064054,4463,63,78,728,869,12207,0.024494189081567117,2730,0,-15,0,0.12239987783544581,0,1122,0,211,2191,0,3524,911,0.07752231391489935,240511,83698,
6,0.0,0,6,0,12,109930,7193,434139,0.0018097411856242457,156813,551,0.09131187832064054,4463,63,78,728,869,12207,0.024494189081567117,2730,0,-15,0,0.12239987783544581,0,1122,0,211,2191,0,3524,911,0.07752231391489935,240511,83698,
6,0.0,0,6,0,12,109930,7193,434139,0.0018097411856242457,156813,551,0.09131187832064054,4463,63,78,728,869,12207,0.024494189081567117,2730,0,-15,0,0.12239987783544581,0,1122,0,211,2191,0,3524,911,0.07752231391489935,240511,83698,
6,0.0,0,6,0,12,109930,7193,434139,0.0018097411856242457,156813,551,0.09131187832064054,4463,88,1,87,176,12207,0.024494189081567117,2730,0,87,0,0.2472117268583607,0,1122,0,211,2191,0,3524,911,0.07752231391489935,240511,83698,
6,0.0,0,6,0,12,109930,7193,434139,0.0018097411856242457,156813,551,0.09131187832064054,4463,85,5,0,90,12207,0.024494189081567117,2730,0,80,0,0.013231982773403348,0,1122,0,211,2191,0,3524,911,0.07752231391489935,240511,83698,
6,0.004246284501061571,0,6,0,12,109930,7193,434139,0.0018097411856242457,156813,551,0.09131187832064054,4463,297,19,271,587,12207,0.024494189081567117,2730,1,278,1,0.10272625331370522,2,1122,0,211,2191,0,3524,911,0.07752231391489935,240511,83698,
6,0.0,0,6,0,12,109930,7193,434139,0.0018097411856242457,156813,551,0.09131187832064054,4463,20,16,145,181,12207,0.024494189081567117,2730,0,4,0,0.1618323207895796,0,1122,0,211,2191,0,3524,911,0.07752231391489935,240511,83698,
6,0.0,0,6,0,12,109930,7193,434139,0.0018097411856242457,156813,551,0.09131187832064054,4463,20,16,145,181,12207,0.024494189081567117,2730,0,4,0,0.1618323207895796,0,1122,0,211,2191,0,3524,911,0.07752231391489935,240511,83698,
6,0.0,0,6,0,12,109930,7193,434139,0.0018097411856242457,156813,551,0.09131187832064054,4463,134,13,87,234,12207,0.024494189081567117,2730,0,121,0,0.05295940883187476,0,1122,0,211,2191,0,3524,911,0.07752231391489935,240511,83698,
6,0.0,0,6,0,12,109930,7193,434139,0.0018097411856242457,156813,551,0.09131187832064054,4463,134,13,87,234,12207,0.024494189081567117,2730,0,121,0,0.05295940883187476,0,1122,0,211,2191,0,3524,911,0.07752231391489935,240511,83698,
2,0.0,0,3,-1,5,109930,7193,434139,6.512948781567266E-4,156813,551,0.09131187832064054,4463,331,11,310,652,12207,0.024494189081567117,2730,0,320,0,0.06880345688937187,0,637,0,113,1241,0,1991,524,0.04897048010864594,240511,83698,
2,0.0,0,3,-1,5,109930,7193,434139,6.512948781567266E-4,156813,551,0.09131187832064054,4463,331,11,310,652,12207,0.024494189081567117,2730,0,320,0,0.06880345688937187,0,637,0,113,1241,0,1991,524,0.04897048010864594,240511,83698,
2,0.0,0,3,-1,5,109930,7193,434139,6.512948781567266E-4,156813,551,0.09131187832064054,4463,331,11,310,652,12207,0.024494189081567117,2730,0,320,0,0.06880345688937187,0,637,0,113,1241,0,1991,524,0.04897048010864594,240511,83698,
2,0.0,0,3,-1,5,109930,7193,434139,6.512948781567266E-4,156813,551,0.09131187832064054,4463,331,11,310,652,12207,0.024494189081567117,2730,0,320,0,0.06880345688937187,0,637,0,113,1241,0,1991,524,0.04897048010864594,240511,83698,
2,0.0,0,3,-1,5,109930,7193,434139,6.512948781567266E-4,156813,551,0.09131187832064054,4463,331,11,310,652,12207,0.024494189081567117,2730,0,320,0,0.06880345688937187,0,637,0,113,1241,0,1991,524,0.04897048010864594,240511,83698,
2,0.0,0,3,-1,5,109930,7193,434139,6.512948781567266E-4,156813,551,0.09131187832064054,4463,331,11,310,652,12207,0.024494189081567117,2730,0,320,0,0.06880345688937187,0,637,0,113,1241,0,1991,524,0.04897048010864594,240511,83698,
2,0.005210359025253812,0,3,-1,5,109930,7193,434139,6.512948781567266E-4,156813,551,0.09131187832064054,4463,26,55,530,611,12207,0.024494189081567117,2730,3,-29,2,0.09069005146222077,5,637,0,113,1241,-1,1991,524,0.04897048010864594,240511,83698,
2,0.0,0,3,-1,5,109930,7193,434139,6.512948781567266E-4,156813,551,0.09131187832064054,4463,6,8,128,142,12207,0.024494189081567117,2730,0,-2,0,0.03598899001177137,0,637,0,113,1241,0,1991,524,0.04897048010864594,240511,83698,
2,0.0,0,3,-1,5,109930,7193,434139,6.512948781567266E-4,156813,551,0.09131187832064054,4463,6,8,128,142,12207,0.024494189081567117,2730,0,-2,0,0.03598899001177137,0,637,0,113,1241,0,1991,524,0.04897048010864594,240511,83698,
2,0.0,0,3,-1,5,109930,7193,434139,6.512948781567266E-4,156813,551,0.09131187832064054,4463,109,15,91,215,12207,0.024494189081567117,2730,0,94,0,0.10420332538495167,0,637,0,113,1241,0,1991,524,0.04897048010864594,240511,83698,
2,0.005210359025253812,0,3,-1,5,109930,7193,434139,6.512948781567266E-4,156813,551,0.09131187832064054,4463,26,55,530,611,12207,0.024494189081567117,2730,3,-29,2,0.09069005146222077,5,637,0,113,1241,-1,1991,524,0.04897048010864594,240511,83698,
2,0.005210359025253812,0,3,-1,5,109930,7193,434139,6.512948781567266E-4,156813,551,0.09131187832064054,4463,26,55,530,611,12207,0.024494189081567117,2730,3,-29,2,0.09069005146222077,5,637,0,113,1241,-1,1991,524,0.04897048010864594,240511,83698,
2,0.005210359025253812,0,3,-1,5,109930,7193,434139,6.512948781567266E-4,156813,551,0.09131187832064054,4463,26,55,530,611,12207,0.024494189081567117,2730,3,-29,2,0.09069005146222077,5,637,0,113,1241,-1,1991,524,0.04897048010864594,240511,83698,
3,0.0,0,5,-2,8,109930,7193,434139,0.002530638449716305,156813,551,0.09131187832064054,4463,31,4,28,63,12207,0.024494189081567117,2730,0,27,0,0.004494838697966763,0,1189,0,271,1742,0,3202,918,0.05980556182969651,240511,83698,
3,0.005535055350553505,0,5,-2,8,109930,7193,434139,0.002530638449716305,156813,551,0.09131187832064054,4463,76,124,487,687,12207,0.024494189081567117,2730,2,-48,1,0.09008242665862083,3,1189,0,271,1742,-1,3202,918,0.05980556182969651,240511,83698,
3,0.005535055350553505,0,5,-2,8,109930,7193,434139,0.002530638449716305,156813,551,0.09131187832064054,4463,76,124,487,687,12207,0.024494189081567117,2730,2,-48,1,0.09008242665862083,3,1189,0,271,1742,-1,3202,918,0.05980556182969651,240511,83698,
3,0.005535055350553505,0,5,-2,8,109930,7193,434139,0.002530638449716305,156813,551,0.09131187832064054,4463,76,124,487,687,12207,0.024494189081567117,2730,2,-48,1,0.09008242665862083,3,1189,0,271,1742,-1,3202,918,0.05980556182969651,240511,83698,
3,0.005535055350553505,0,5,-2,8,109930,7193,434139,0.002530638449716305,156813,551,0.09131187832064054,4463,76,124,487,687,12207,0.024494189081567117,2730,2,-48,1,0.09008242665862083,3,1189,0,271,1742,-1,3202,918,0.05980556182969651,240511,83698,
3,0.005535055350553505,0,5,-2,8,109930,7193,434139,0.002530638449716305,156813,551,0.09131187832064054,4463,76,124,487,687,12207,0.024494189081567117,2730,2,-48,1,0.09008242665862083,3,1189,0,271,1742,-1,3202,918,0.05980556182969651,240511,83698,
3,0.005535055350553505,0,5,-2,8,109930,7193,434139,0.002530638449716305,156813,551,0.09131187832064054,4463,76,124,487,687,12207,0.024494189081567117,2730,2,-48,1,0.09008242665862083,3,1189,0,271,1742,-1,3202,918,0.05980556182969651,240511,83698,
3,0.005535055350553505,0,5,-2,8,109930,7193,434139,0.002530638449716305,156813,551,0.09131187832064054,4463,76,124,487,687,12207,0.024494189081567117,2730,2,-48,1,0.09008242665862083,3,1189,0,271,1742,-1,3202,918,0.05980556182969651,240511,83698,
3,0.005535055350553505,0,5,-2,8,109930,7193,434139,0.002530638449716305,156813,551,0.09131187832064054,4463,76,124,487,687,12207,0.024494189081567117,2730,2,-48,1,0.09008242665862083,3,1189,0,271,1742,-1,3202,918,0.05980556182969651,240511,83698,
3,0.005535055350553505,0,5,-2,8,109930,7193,434139,0.002530638449716305,156813,551,0.09131187832064054,4463,76,124,487,687,12207,0.024494189081567117,2730,2,-48,1,0.09008242665862083,3,1189,0,271,1742,-1,3202,918,0.05980556182969651,240511,83698,
3,0.005535055350553505,0,5,-2,8,109930,7193,434139,0.002530638449716305,156813,551,0.09131187832064054,4463,76,124,487,687,12207,0.024494189081567117,2730,2,-48,1,0.09008242665862083,3,1189,0,271,1742,-1,3202,918,0.05980556182969651,240511,83698,
3,0.005535055350553505,0,5,-2,8,109930,7193,434139,0.002530638449716305,156813,551,0.09131187832064054,4463,76,124,487,687,12207,0.024494189081567117,2730,2,-48,1,0.09008242665862083,3,1189,0,271,1742,-1,3202,918,0.05980556182969651,240511,83698,
3,0.005535055350553505,0,5,-2,8,109930,7193,434139,0.002530638449716305,156813,551,0.09131187832064054,4463,76,124,487,687,12207,0.024494189081567117,2730,2,-48,1,0.09008242665862083,3,1189,0,271,1742,-1,3202,918,0.05980556182969651,240511,83698,
3,0.005535055350553505,0,5,-2,8,109930,7193,434139,0.002530638449716305,156813,551,0.09131187832064054,4463,76,124,487,687,12207,0.024494189081567117,2730,2,-48,1,0.09008242665862083,3,1189,0,271,1742,-1,3202,918,0.05980556182969651,240511,83698,
3,0.005535055350553505,0,5,-2,8,109930,7193,434139,0.002530638449716305,156813,551,0.09131187832064054,4463,76,124,487,687,12207,0.024494189081567117,2730,2,-48,1,0.09008242665862083,3,1189,0,271,1742,-1,3202,918,0.05980556182969651,240511,83698,
3,0.005272407732864675,0,5,-2,8,109930,7193,434139,0.002530638449716305,156813,551,0.09131187832064054,4463,514,45,402,961,12207,0.024494189081567117,2730,2,469,1,0.1269604749212023,3,1189,0,271,1742,-1,3202,918,0.05980556182969651,240511,83698,
3,0.005272407732864675,0,5,-2,8,109930,7193,434139,0.002530638449716305,156813,551,0.09131187832064054,4463,514,45,402,961,12207,0.024494189081567117,2730,2,469,1,0.1269604749212023,3,1189,0,271,1742,-1,3202,918,0.05980556182969651,240511,83698,
3,0.005272407732864675,0,5,-2,8,109930,7193,434139,0.002530638449716305,156813,551,0.09131187832064054,4463,514,45,402,961,12207,0.024494189081567117,2730,2,469,1,0.1269604749212023,3,1189,0,271,1742,-1,3202,918,0.05980556182969651,240511,83698,
3,0.005272407732864675,0,5,-2,8,109930,7193,434139,0.002530638449716305,156813,551,0.09131187832064054,4463,514,45,402,961,12207,0.024494189081567117,2730,2,469,1,0.1269604749212023,3,1189,0,271,1742,-1,3202,918,0.05980556182969651,240511,83698,
3,0.0,0,5,-2,8,109930,7193,434139,0.002530638449716305,156813,551,0.09131187832064054,4463,518,43,497,1058,12207,0.024494189081567117,2730,0,475,0,0.09042756404482037,0,1189,0,271,1742,0,3202,918,0.05980556182969651,240511,83698,
3,0.0,0,5,-2,8,109930,7193,434139,0.002530638449716305,156813,551,0.09131187832064054,4463,518,43,497,1058,12207,0.024494189081567117,2730,0,475,0,0.09042756404482037,0,1189,0,271,1742,0,3202,918,0.05980556182969651,240511,83698,
3,0.0,0,5,-2,8,109930,7193,434139,0.002530638449716305,156813,551,0.09131187832064054,4463,518,43,497,1058,12207,0.024494189081567117,2730,0,475,0,0.09042756404482037,0,1189,0,271,1742,0,3202,918,0.05980556182969651,240511,83698,
3,0.0,0,5,-2,8,109930,7193,434139,0.002530638449716305,156813,551,0.09131187832064054,4463,518,43,497,1058,12207,0.024494189081567117,2730,0,475,0,0.09042756404482037,0,1189,0,271,1742,0,3202,918,0.05980556182969651,240511,83698,
3,0.0,0,5,-2,8,109930,7193,434139,0.002530638449716305,156813,551,0.09131187832064054,4463,518,43,497,1058,12207,0.024494189081567117,2730,0,475,0,0.09042756404482037,0,1189,0,271,1742,0,3202,918,0.05980556182969651,240511,83698,
3,0.0,0,5,-2,8,109930,7193,434139,0.002530638449716305,156813,551,0.09131187832064054,4463,518,43,497,1058,12207,0.024494189081567117,2730,0,475,0,0.09042756404482037,0,1189,0,271,1742,0,3202,918,0.05980556182969651,240511,83698,
3,0.0,0,5,-2,8,109930,7193,434139,0.002530638449716305,156813,551,0.09131187832064054,4463,518,43,497,1058,12207,0.024494189081567117,2730,0,475,0,0.09042756404482037,0,1189,0,271,1742,0,3202,918,0.05980556182969651,240511,83698,
3,0.0,0,5,-2,8,109930,7193,434139,0.002530638449716305,156813,551,0.09131187832064054,4463,518,43,497,1058,12207,0.024494189081567117,2730,0,475,0,0.09042756404482037,0,1189,0,271,1742,0,3202,918,0.05980556182969651,240511,83698,
3,0.0,0,5,-2,8,109930,7193,434139,0.002530638449716305,156813,551,0.09131187832064054,4463,518,43,497,1058,12207,0.024494189081567117,2730,0,475,0,0.09042756404482037,0,1189,0,271,1742,0,3202,918,0.05980556182969651,240511,83698,
3,0.0,0,5,-2,8,109930,7193,434139,0.002530638449716305,156813,551,0.09131187832064054,4463,518,43,497,1058,12207,0.024494189081567117,2730,0,475,0,0.09042756404482037,0,1189,0,271,1742,0,3202,918,0.05980556182969651,240511,83698,
3,0.0,0,5,-2,8,109930,7193,434139,0.002530638449716305,156813,551,0.09131187832064054,4463,518,43,497,1058,12207,0.024494189081567117,2730,0,475,0,0.09042756404482037,0,1189,0,271,1742,0,3202,918,0.05980556182969651,240511,83698,
3,0.00437636761487965,0,5,-2,8,109930,7193,434139,0.002530638449716305,156813,551,0.09131187832064054,4463,44,41,273,358,12207,0.024494189081567117,2730,1,3,1,0.02933007183762918,2,1189,0,271,1742,0,3202,918,0.05980556182969651,240511,83698,
3,0.00437636761487965,0,5,-2,8,109930,7193,434139,0.002530638449716305,156813,551,0.09131187832064054,4463,44,41,273,358,12207,0.024494189081567117,2730,1,3,1,0.02933007183762918,2,1189,0,271,1742,0,3202,918,0.05980556182969651,240511,83698,
4,0.013513513513513514,0,4,0,8,109930,7193,434139,0.0042287185144328,156813,551,0.09131187832064054,4463,336,225,1323,1884,12207,0.024494189081567117,2730,3,111,3,0.1497670759219247,6,538,0,258,1681,0,2477,280,0.0654701611072328,240511,83698,
4,0.013513513513513514,0,4,0,8,109930,7193,434139,0.0042287185144328,156813,551,0.09131187832064054,4463,336,225,1323,1884,12207,0.024494189081567117,2730,3,111,3,0.1497670759219247,6,538,0,258,1681,0,2477,280,0.0654701611072328,240511,83698,
4,0.013513513513513514,0,4,0,8,109930,7193,434139,0.0042287185144328,156813,551,0.09131187832064054,4463,336,225,1323,1884,12207,0.024494189081567117,2730,3,111,3,0.1497670759219247,6,538,0,258,1681,0,2477,280,0.0654701611072328,240511,83698,
4,0.013513513513513514,0,4,0,8,109930,7193,434139,0.0042287185144328,156813,551,0.09131187832064054,4463,336,225,1323,1884,12207,0.024494189081567117,2730,3,111,3,0.1497670759219247,6,538,0,258,1681,0,2477,280,0.0654701611072328,240511,83698,
4,0.013513513513513514,0,4,0,8,109930,7193,434139,0.0042287185144328,156813,551,0.09131187832064054,4463,336,225,1323,1884,12207,0.024494189081567117,2730,3,111,3,0.1497670759219247,6,538,0,258,1681,0,2477,280,0.0654701611072328,240511,83698,
4,0.013513513513513514,0,4,0,8,109930,7193,434139,0.0042287185144328,156813,551,0.09131187832064054,4463,336,225,1323,1884,12207,0.024494189081567117,2730,3,111,3,0.1497670759219247,6,538,0,258,1681,0,2477,280,0.0654701611072328,240511,83698,
4,0.013513513513513514,0,4,0,8,109930,7193,434139,0.0042287185144328,156813,551,0.09131187832064054,4463,336,225,1323,1884,12207,0.024494189081567117,2730,3,111,3,0.1497670759219247,6,538,0,258,1681,0,2477,280,0.0654701611072328,240511,83698,
4,0.013513513513513514,0,4,0,8,109930,7193,434139,0.0042287185144328,156813,551,0.09131187832064054,4463,336,225,1323,1884,12207,0.024494189081567117,2730,3,111,3,0.1497670759219247,6,538,0,258,1681,0,2477,280,0.0654701611072328,240511,83698,
4,0.013513513513513514,0,4,0,8,109930,7193,434139,0.0042287185144328,156813,551,0.09131187832064054,4463,336,225,1323,1884,12207,0.024494189081567117,2730,3,111,3,0.1497670759219247,6,538,0,258,1681,0,2477,280,0.0654701611072328,240511,83698,
4,0.013513513513513514,0,4,0,8,109930,7193,434139,0.0042287185144328,156813,551,0.09131187832064054,4463,336,225,1323,1884,12207,0.024494189081567117,2730,3,111,3,0.1497670759219247,6,538,0,258,1681,0,2477,280,0.0654701611072328,240511,83698,
4,0.013513513513513514,0,4,0,8,109930,7193,434139,0.0042287185144328,156813,551,0.09131187832064054,4463,336,225,1323,1884,12207,0.024494189081567117,2730,3,111,3,0.1497670759219247,6,538,0,258,1681,0,2477,280,0.0654701611072328,240511,83698,
4,0.013513513513513514,0,4,0,8,109930,7193,434139,0.0042287185144328,156813,551,0.09131187832064054,4463,336,225,1323,1884,12207,0.024494189081567117,2730,3,111,3,0.1497670759219247,6,538,0,258,1681,0,2477,280,0.0654701611072328,240511,83698,
4,0.013513513513513514,0,4,0,8,109930,7193,434139,0.0042287185144328,156813,551,0.09131187832064054,4463,336,225,1323,1884,12207,0.024494189081567117,2730,3,111,3,0.1497670759219247,6,538,0,258,1681,0,2477,280,0.0654701611072328,240511,83698,
4,0.013513513513513514,0,4,0,8,109930,7193,434139,0.0042287185144328,156813,551,0.09131187832064054,4463,336,225,1323,1884,12207,0.024494189081567117,2730,3,111,3,0.1497670759219247,6,538,0,258,1681,0,2477,280,0.0654701611072328,240511,83698,
4,0.013513513513513514,0,4,0,8,109930,7193,434139,0.0042287185144328,156813,551,0.09131187832064054,4463,336,225,1323,1884,12207,0.024494189081567117,2730,3,111,3,0.1497670759219247,6,538,0,258,1681,0,2477,280,0.0654701611072328,240511,83698,
4,0.013513513513513514,0,4,0,8,109930,7193,434139,0.0042287185144328,156813,551,0.09131187832064054,4463,336,225,1323,1884,12207,0.024494189081567117,2730,3,111,3,0.1497670759219247,6,538,0,258,1681,0,2477,280,0.0654701611072328,240511,83698,
4,0.013513513513513514,0,4,0,8,109930,7193,434139,0.0042287185144328,156813,551,0.09131187832064054,4463,336,225,1323,1884,12207,0.024494189081567117,2730,3,111,3,0.1497670759219247,6,538,0,258,1681,0,2477,280,0.0654701611072328,240511,83698,
4,0.013513513513513514,0,4,0,8,109930,7193,434139,0.0042287185144328,156813,551,0.09131187832064054,4463,336,225,1323,1884,12207,0.024494189081567117,2730,3,111,3,0.1497670759219247,6,538,0,258,1681,0,2477,280,0.0654701611072328,240511,83698,
4,0.013513513513513514,0,4,0,8,109930,7193,434139,0.0042287185144328,156813,551,0.09131187832064054,4463,336,225,1323,1884,12207,0.024494189081567117,2730,3,111,3,0.1497670759219247,6,538,0,258,1681,0,2477,280,0.0654701611072328,240511,83698,
4,0.013513513513513514,0,4,0,8,109930,7193,434139,0.0042287185144328,156813,551,0.09131187832064054,4463,336,225,1323,1884,12207,0.024494189081567117,2730,3,111,3,0.1497670759219247,6,538,0,258,1681,0,2477,280,0.0654701611072328,240511,83698,
4,0.013513513513513514,0,4,0,8,109930,7193,434139,0.0042287185144328,156813,551,0.09131187832064054,4463,336,225,1323,1884,12207,0.024494189081567117,2730,3,111,3,0.1497670759219247,6,538,0,258,1681,0,2477,280,0.0654701611072328,240511,83698,
4,0.0,0,4,0,8,109930,7193,434139,0.0042287185144328,156813,551,0.09131187832064054,4463,12,10,87,109,12207,0.024494189081567117,2730,0,2,0,0.026916016434005974,0,538,0,258,1681,0,2477,280,0.0654701611072328,240511,83698,
4,0.0,0,4,0,8,109930,7193,434139,0.0042287185144328,156813,551,0.09131187832064054,4463,12,10,87,109,12207,0.024494189081567117,2730,0,2,0,0.026916016434005974,0,538,0,258,1681,0,2477,280,0.0654701611072328,240511,83698,
0,0.0,0,0,0,0,109930,7193,434139,0.0,156813,551,0.09131187832064054,4463,63,3,2,68,12207,0.024494189081567117,2730,0,60,0,0.16161331805528759,0,757,0,259,355,0,1371,498,0.06761734196980768,240511,83698,
0,0.0,0,0,0,0,109930,7193,434139,0.0,156813,551,0.09131187832064054,4463,29,2,30,61,12207,0.024494189081567117,2730,0,27,0,0.0013160362802338667,0,757,0,259,355,0,1371,498,0.06761734196980768,240511,83698,
0,0.0,0,0,0,0,109930,7193,434139,0.0,156813,551,0.09131187832064054,4463,29,2,30,61,12207,0.024494189081567117,2730,0,27,0,0.0013160362802338667,0,757,0,259,355,0,1371,498,0.06761734196980768,240511,83698,
0,0.0,0,0,0,0,109930,7193,434139,0.0,156813,551,0.09131187832064054,4463,29,2,30,61,12207,0.024494189081567117,2730,0,27,0,0.0013160362802338667,0,757,0,259,355,0,1371,498,0.06761734196980768,240511,83698,
0,0.0,0,0,0,0,109930,7193,434139,0.0,156813,551,0.09131187832064054,4463,29,2,30,61,12207,0.024494189081567117,2730,0,27,0,0.0013160362802338667,0,757,0,259,355,0,1371,498,0.06761734196980768,240511,83698,
0,0.0,0,0,0,0,109930,7193,434139,0.0,156813,551,0.09131187832064054,4463,182,34,160,376,12207,0.024494189081567117,2730,0,148,0,0.08781972978910195,0,757,0,259,355,0,1371,498,0.06761734196980768,240511,83698,
0,0.0,0,0,0,0,109930,7193,434139,0.0,156813,551,0.09131187832064054,4463,182,34,160,376,12207,0.024494189081567117,2730,0,148,0,0.08781972978910195,0,757,0,259,355,0,1371,498,0.06761734196980768,240511,83698,
0,0.0,0,0,0,0,109930,7193,434139,0.0,156813,551,0.09131187832064054,4463,182,34,160,376,12207,0.024494189081567117,2730,0,148,0,0.08781972978910195,0,757,0,259,355,0,1371,498,0.06761734196980768,240511,83698,
0,0.0,0,0,0,0,109930,7193,434139,0.0,156813,551,0.09131187832064054,4463,14,21,5,40,12207,0.024494189081567117,2730,0,-7,0,0.05798045756228048,0,757,0,259,355,0,1371,498,0.06761734196980768,240511,83698,
0,0.0,0,0,0,0,109930,7193,434139,0.0,156813,551,0.09131187832064054,4463,14,21,5,40,12207,0.024494189081567117,2730,0,-7,0,0.05798045756228048,0,757,0,259,355,0,1371,498,0.06761734196980768,240511,83698,
0,0.0,0,0,0,0,109930,7193,434139,0.0,156813,551,0.09131187832064054,4463,9,13,81,103,12207,0.024494189081567117,2730,0,-4,0,0.016169265757161697,0,757,0,259,355,0,1371,498,0.06761734196980768,240511,83698,
1,0.00338409475465313,0,1,0,2,109930,7193,434139,6.768189509306261E-4,156813,551,0.09131187832064054,4463,272,20,10,302,12207,0.024494189081567117,2730,1,252,1,0.006630736579557833,2,577,0,116,31,0,724,461,0.03461732600412185,240511,83698,
1,0.00338409475465313,0,1,0,2,109930,7193,434139,6.768189509306261E-4,156813,551,0.09131187832064054,4463,272,20,10,302,12207,0.024494189081567117,2730,1,252,1,0.006630736579557833,2,577,0,116,31,0,724,461,0.03461732600412185,240511,83698,
1,0.00338409475465313,0,1,0,2,109930,7193,434139,6.768189509306261E-4,156813,551,0.09131187832064054,4463,272,20,10,302,12207,0.024494189081567117,2730,1,252,1,0.006630736579557833,2,577,0,116,31,0,724,461,0.03461732600412185,240511,83698,
1,0.00338409475465313,0,1,0,2,109930,7193,434139,6.768189509306261E-4,156813,551,0.09131187832064054,4463,272,20,10,302,12207,0.024494189081567117,2730,1,252,1,0.006630736579557833,2,577,0,116,31,0,724,461,0.03461732600412185,240511,83698,
1,0.00338409475465313,0,1,0,2,109930,7193,434139,6.768189509306261E-4,156813,551,0.09131187832064054,4463,272,20,10,302,12207,0.024494189081567117,2730,1,252,1,0.006630736579557833,2,577,0,116,31,0,724,461,0.03461732600412185,240511,83698,
1,0.00338409475465313,0,1,0,2,109930,7193,434139,6.768189509306261E-4,156813,551,0.09131187832064054,4463,272,20,10,302,12207,0.024494189081567117,2730,1,252,1,0.006630736579557833,2,577,0,116,31,0,724,461,0.03461732600412185,240511,83698,
1,0.00338409475465313,0,1,0,2,109930,7193,434139,6.768189509306261E-4,156813,551,0.09131187832064054,4463,272,20,10,302,12207,0.024494189081567117,2730,1,252,1,0.006630736579557833,2,577,0,116,31,0,724,461,0.03461732600412185,240511,83698,
1,0.00338409475465313,0,1,0,2,109930,7193,434139,6.768189509306261E-4,156813,551,0.09131187832064054,4463,272,20,10,302,12207,0.024494189081567117,2730,1,252,1,0.006630736579557833,2,577,0,116,31,0,724,461,0.03461732600412185,240511,83698,
1,0.00338409475465313,0,1,0,2,109930,7193,434139,6.768189509306261E-4,156813,551,0.09131187832064054,4463,272,20,10,302,12207,0.024494189081567117,2730,1,252,1,0.006630736579557833,2,577,0,116,31,0,724,461,0.03461732600412185,240511,83698,
1,0.0,0,1,0,2,109930,7193,434139,6.768189509306261E-4,156813,551,0.09131187832064054,4463,133,32,2,167,12207,0.024494189081567117,2730,0,101,0,0.08445807300837899,0,577,0,116,31,0,724,461,0.03461732600412185,240511,83698,
1,0.0,0,1,0,2,109930,7193,434139,6.768189509306261E-4,156813,551,0.09131187832064054,4463,133,32,2,167,12207,0.024494189081567117,2730,0,101,0,0.08445807300837899,0,577,0,116,31,0,724,461,0.03461732600412185,240511,83698,
1,0.0,0,1,0,2,109930,7193,434139,6.768189509306261E-4,156813,551,0.09131187832064054,4463,133,32,2,167,12207,0.024494189081567117,2730,0,101,0,0.08445807300837899,0,577,0,116,31,0,724,461,0.03461732600412185,240511,83698,
1,0.0,0,1,0,2,109930,7193,434139,6.768189509306261E-4,156813,551,0.09131187832064054,4463,133,32,2,167,12207,0.024494189081567117,2730,0,101,0,0.08445807300837899,0,577,0,116,31,0,724,461,0.03461732600412185,240511,83698,
1,0.0,0,1,0,2,109930,7193,434139,0.0010875475802066342,156813,551,0.09131187832064054,4463,8,8,79,95,12207,0.024494189081567117,2730,0,0,0,0.009693505852155766,0,372,0,97,625,0,1094,275,0.04888842026154124,240511,83698,
1,0.0,0,1,0,2,109930,7193,434139,0.0010875475802066342,156813,551,0.09131187832064054,4463,8,8,79,95,12207,0.024494189081567117,2730,0,0,0,0.009693505852155766,0,372,0,97,625,0,1094,275,0.04888842026154124,240511,83698,
1,0.0,0,1,0,2,109930,7193,434139,0.0010875475802066342,156813,551,0.09131187832064054,4463,8,8,79,95,12207,0.024494189081567117,2730,0,0,0,0.009693505852155766,0,372,0,97,625,0,1094,275,0.04888842026154124,240511,83698,
11,0.18563603164942177,2,19,-8,32,109930,7193,434139,0.05794260829002059,156813,551,0.09131187832064054,4463,107,67,304,478,12207,0.024494189081567117,2730,8,40,5,0.07397520808643117,14,497,1,192,672,-3,1361,305,0.07144966154352657,240511,83698,
11,0.0031496062992125984,2,19,-8,32,109930,7193,434139,0.05794260829002059,156813,551,0.09131187832064054,4463,51,38,43,132,12207,0.024494189081567117,2730,1,13,1,0.08106740297488813,2,497,0,192,672,0,1361,305,0.07144966154352657,240511,83698,
11,0.0031496062992125984,2,19,-8,32,109930,7193,434139,0.05794260829002059,156813,551,0.09131187832064054,4463,51,38,43,132,12207,0.024494189081567117,2730,1,13,1,0.08106740297488813,2,497,0,192,672,0,1361,305,0.07144966154352657,240511,83698,
11,0.016420361247947456,2,19,-8,32,109930,7193,434139,0.05794260829002059,156813,551,0.09131187832064054,4463,42,26,36,104,12207,0.024494189081567117,2730,5,16,5,0.058464668456981395,10,497,0,192,672,0,1361,305,0.07144966154352657,240511,83698,
11,0.016420361247947456,2,19,-8,32,109930,7193,434139,0.05794260829002059,156813,551,0.09131187832064054,4463,42,26,36,104,12207,0.024494189081567117,2730,5,16,5,0.058464668456981395,10,497,0,192,672,0,1361,305,0.07144966154352657,240511,83698,
11,0.016420361247947456,2,19,-8,32,109930,7193,434139,0.05794260829002059,156813,551,0.09131187832064054,4463,42,26,36,104,12207,0.024494189081567117,2730,5,16,5,0.058464668456981395,10,497,0,192,672,0,1361,305,0.07144966154352657,240511,83698,
11,0.016420361247947456,2,19,-8,32,109930,7193,434139,0.05794260829002059,156813,551,0.09131187832064054,4463,42,26,36,104,12207,0.024494189081567117,2730,5,16,5,0.058464668456981395,10,497,0,192,672,0,1361,305,0.07144966154352657,240511,83698,
11,0.016420361247947456,2,19,-8,32,109930,7193,434139,0.05794260829002059,156813,551,0.09131187832064054,4463,42,26,36,104,12207,0.024494189081567117,2730,5,16,5,0.058464668456981395,10,497,0,192,672,0,1361,305,0.07144966154352657,240511,83698,
11,0.016420361247947456,2,19,-8,32,109930,7193,434139,0.05794260829002059,156813,551,0.09131187832064054,4463,42,26,36,104,12207,0.024494189081567117,2730,5,16,5,0.058464668456981395,10,497,0,192,672,0,1361,305,0.07144966154352657,240511,83698,
11,0.016420361247947456,2,19,-8,32,109930,7193,434139,0.05794260829002059,156813,551,0.09131187832064054,4463,42,26,36,104,12207,0.024494189081567117,2730,5,16,5,0.058464668456981395,10,497,0,192,672,0,1361,305,0.07144966154352657,240511,83698,
11,0.08450704225352113,2,19,-8,32,109930,7193,434139,0.05794260829002059,156813,551,0.09131187832064054,4463,277,38,227,542,12207,0.024494189081567117,2730,5,239,0,0.06498366936208923,6,497,1,192,672,-5,1361,305,0.07144966154352657,240511,83698,
11,0.08450704225352113,2,19,-8,32,109930,7193,434139,0.05794260829002059,156813,551,0.09131187832064054,4463,277,38,227,542,12207,0.024494189081567117,2730,5,239,0,0.06498366936208923,6,497,1,192,672,-5,1361,305,0.07144966154352657,240511,83698,
11,0.08450704225352113,2,19,-8,32,109930,7193,434139,0.05794260829002059,156813,551,0.09131187832064054,4463,277,38,227,542,12207,0.024494189081567117,2730,5,239,0,0.06498366936208923,6,497,1,192,672,-5,1361,305,0.07144966154352657,240511,83698,
35,0.0,0,0,35,35,109930,7193,434139,0.05617977528089888,156813,551,0.09131187832064054,4463,171,22,162,355,12207,0.024494189081567117,2730,0,149,0,0.05170231619310116,0,607,0,63,439,0,1109,544,0.14142363977667308,240511,83698,
35,0.0,0,0,35,35,109930,7193,434139,0.05617977528089888,156813,551,0.09131187832064054,4463,54,3,0,57,12207,0.024494189081567117,2730,0,51,0,0.3478154148257241,0,607,0,63,439,0,1109,544,0.14142363977667308,240511,83698,
11,0.041666666666666664,0,11,0,22,109930,7193,434139,0.014607731124440634,156813,551,0.09131187832064054,4463,642,32,2,676,12207,0.024494189081567117,2730,1,610,1,0.03418394079252708,2,1055,0,86,578,0,1719,969,0.027836362509639896,240511,83698,
11,0.041666666666666664,0,11,0,22,109930,7193,434139,0.014607731124440634,156813,551,0.09131187832064054,4463,642,32,2,676,12207,0.024494189081567117,2730,1,610,1,0.03418394079252708,2,1055,0,86,578,0,1719,969,0.027836362509639896,240511,83698,
11,0.041666666666666664,0,11,0,22,109930,7193,434139,0.014607731124440634,156813,551,0.09131187832064054,4463,642,32,2,676,12207,0.024494189081567117,2730,1,610,1,0.03418394079252708,2,1055,0,86,578,0,1719,969,0.027836362509639896,240511,83698,
89,0.0,8,24,65,121,109930,7193,434139,0.02405157417592045,156813,551,0.09131187832064054,4463,3,5,98,106,12207,0.024494189081567117,2730,0,-2,0,0.06118198875648351,0,3365,0,723,1648,0,5736,2642,0.07796190398810199,240511,83698,
89,0.0,8,24,65,121,109930,7193,434139,0.02405157417592045,156813,551,0.09131187832064054,4463,315,135,15,465,12207,0.024494189081567117,2730,0,180,0,0.16501262612971848,0,3365,0,723,1648,0,5736,2642,0.07796190398810199,240511,83698,
89,0.004559270516717325,8,24,65,121,109930,7193,434139,0.02405157417592045,156813,551,0.09131187832064054,4463,407,90,53,550,12207,0.024494189081567117,2730,2,317,1,0.12554604381880644,3,3365,0,723,1648,-1,5736,2642,0.07796190398810199,240511,83698,
89,0.0,8,24,65,121,109930,7193,434139,0.02405157417592045,156813,551,0.09131187832064054,4463,280,54,1,335,12207,0.024494189081567117,2730,0,226,0,0.17623520930631964,0,3365,0,723,1648,0,5736,2642,0.07796190398810199,240511,83698,
89,0.0,8,24,65,121,109930,7193,434139,0.02405157417592045,156813,551,0.09131187832064054,4463,114,10,3,127,12207,0.024494189081567117,2730,0,104,0,0.056496287001580534,0,3365,0,723,1648,0,5736,2642,0.07796190398810199,240511,83698,
89,0.0,8,24,65,121,109930,7193,434139,0.02405157417592045,156813,551,0.09131187832064054,4463,16,14,205,235,12207,0.024494189081567117,2730,0,2,0,0.029893433697959673,0,3365,0,723,1648,0,5736,2642,0.07796190398810199,240511,83698,
89,0.0,8,24,65,121,109930,7193,434139,0.02405157417592045,156813,551,0.09131187832064054,4463,238,9,5,252,12207,0.024494189081567117,2730,0,229,0,0.01645993595940674,0,3365,0,723,1648,0,5736,2642,0.07796190398810199,240511,83698,
89,0.06,8,24,65,121,109930,7193,434139,0.02405157417592045,156813,551,0.09131187832064054,4463,14,5,83,102,12207,0.024494189081567117,2730,0,9,9,0.016063430148445114,9,3365,0,723,1648,9,5736,2642,0.07796190398810199,240511,83698,
93,0.0,6,80,13,179,109930,7193,434139,0.07842624560743498,156813,551,0.09131187832064054,4463,0,2,0,2,12207,0.024494189081567117,2730,0,-2,0,0.0018535681186283596,0,4667,0,3621,3127,0,11415,1046,0.1116547925798413,240511,83698,
93,0.0,6,80,13,179,109930,7193,434139,0.07842624560743498,156813,551,0.09131187832064054,4463,0,2,0,2,12207,0.024494189081567117,2730,0,-2,0,0.0018535681186283596,0,4667,0,3621,3127,0,11415,1046,0.1116547925798413,240511,83698,
93,0.0,6,80,13,179,109930,7193,434139,0.07842624560743498,156813,551,0.09131187832064054,4463,0,2,0,2,12207,0.024494189081567117,2730,0,-2,0,0.0018535681186283596,0,4667,0,3621,3127,0,11415,1046,0.1116547925798413,240511,83698,
93,0.0,6,80,13,179,109930,7193,434139,0.07842624560743498,156813,551,0.09131187832064054,4463,2445,2140,171,4756,12207,0.024494189081567117,2730,0,305,0,0.2617166499810297,0,4667,0,3621,3127,0,11415,1046,0.1116547925798413,240511,83698,
93,0.0,6,80,13,179,109930,7193,434139,0.07842624560743498,156813,551,0.09131187832064054,4463,2445,2140,171,4756,12207,0.024494189081567117,2730,0,305,0,0.2617166499810297,0,4667,0,3621,3127,0,11415,1046,0.1116547925798413,240511,83698,
93,0.0,6,80,13,179,109930,7193,434139,0.07842624560743498,156813,551,0.09131187832064054,4463,609,935,1221,2765,12207,0.024494189081567117,2730,0,-326,0,0.14354824247605455,0,4667,0,3621,3127,0,11415,1046,0.1116547925798413,240511,83698,
93,0.0,6,80,13,179,109930,7193,434139,0.07842624560743498,156813,551,0.09131187832064054,4463,609,935,1221,2765,12207,0.024494189081567117,2730,0,-326,0,0.14354824247605455,0,4667,0,3621,3127,0,11415,1046,0.1116547925798413,240511,83698,
93,0.0,6,80,13,179,109930,7193,434139,0.07842624560743498,156813,551,0.09131187832064054,4463,609,935,1221,2765,12207,0.024494189081567117,2730,0,-326,0,0.14354824247605455,0,4667,0,3621,3127,0,11415,1046,0.1116547925798413,240511,83698,
93,0.0,6,80,13,179,109930,7193,434139,0.07842624560743498,156813,551,0.09131187832064054,4463,609,935,1221,2765,12207,0.024494189081567117,2730,0,-326,0,0.14354824247605455,0,4667,0,3621,3127,0,11415,1046,0.1116547925798413,240511,83698,
93,0.0,6,80,13,179,109930,7193,434139,0.07842624560743498,156813,551,0.09131187832064054,4463,609,935,1221,2765,12207,0.024494189081567117,2730,0,-326,0,0.14354824247605455,0,4667,0,3621,3127,0,11415,1046,0.1116547925798413,240511,83698,
93,0.0,6,80,13,179,109930,7193,434139,0.07842624560743498,156813,551,0.09131187832064054,4463,609,935,1221,2765,12207,0.024494189081567117,2730,0,-326,0,0.14354824247605455,0,4667,0,3621,3127,0,11415,1046,0.1116547925798413,240511,83698,
93,0.0,6,80,13,179,109930,7193,434139,0.07842624560743498,156813,551,0.09131187832064054,4463,609,935,1221,2765,12207,0.024494189081567117,2730,0,-326,0,0.14354824247605455,0,4667,0,3621,3127,0,11415,1046,0.1116547925798413,240511,83698,
93,0.0,6,80,13,179,109930,7193,434139,0.07842624560743498,156813,551,0.09131187832064054,4463,609,935,1221,2765,12207,0.024494189081567117,2730,0,-326,0,0.14354824247605455,0,4667,0,3621,3127,0,11415,1046,0.1116547925798413,240511,83698,
93,0.012195121951219513,6,80,13,179,109930,7193,434139,0.07842624560743498,156813,551,0.09131187832064054,4463,126,100,9,235,12207,0.024494189081567117,2730,0,26,0,0.07756435793996841,1,4667,1,3621,3127,0,11415,1046,0.1116547925798413,240511,83698,
93,0.0,6,80,13,179,109930,7193,434139,0.07842624560743498,156813,551,0.09131187832064054,4463,16,19,238,273,12207,0.024494189081567117,2730,0,-3,0,0.14933497519063726,0,4667,0,3621,3127,0,11415,1046,0.1116547925798413,240511,83698,
23,0.014545454545454545,1,6,17,30,109930,7193,434139,0.02893994893994894,156813,551,0.09131187832064054,4463,226,6,0,232,12207,0.024494189081567117,2730,2,220,2,0.22591555581808995,4,292,0,32,108,0,432,260,0.1146264377359708,240511,83698,
23,0.014545454545454545,1,6,17,30,109930,7193,434139,0.02893994893994894,156813,551,0.09131187832064054,4463,226,6,0,232,12207,0.024494189081567117,2730,2,220,2,0.22591555581808995,4,292,0,32,108,0,432,260,0.1146264377359708,240511,83698,
23,0.014545454545454545,1,6,17,30,109930,7193,434139,0.02893994893994894,156813,551,0.09131187832064054,4463,226,6,0,232,12207,0.024494189081567117,2730,2,220,2,0.22591555581808995,4,292,0,32,108,0,432,260,0.1146264377359708,240511,83698,
23,0.014545454545454545,1,6,17,30,109930,7193,434139,0.02893994893994894,156813,551,0.09131187832064054,4463,226,6,0,232,12207,0.024494189081567117,2730,2,220,2,0.22591555581808995,4,292,0,32,108,0,432,260,0.1146264377359708,240511,83698,
23,0.014545454545454545,1,6,17,30,109930,7193,434139,0.02893994893994894,156813,551,0.09131187832064054,4463,226,6,0,232,12207,0.024494189081567117,2730,2,220,2,0.22591555581808995,4,292,0,32,108,0,432,260,0.1146264377359708,240511,83698,
23,0.014545454545454545,1,6,17,30,109930,7193,434139,0.02893994893994894,156813,551,0.09131187832064054,4463,226,6,0,232,12207,0.024494189081567117,2730,2,220,2,0.22591555581808995,4,292,0,32,108,0,432,260,0.1146264377359708,240511,83698,
23,0.014545454545454545,1,6,17,30,109930,7193,434139,0.02893994893994894,156813,551,0.09131187832064054,4463,226,6,0,232,12207,0.024494189081567117,2730,2,220,2,0.22591555581808995,4,292,0,32,108,0,432,260,0.1146264377359708,240511,83698,
23,0.014545454545454545,1,6,17,30,109930,7193,434139,0.02893994893994894,156813,551,0.09131187832064054,4463,226,6,0,232,12207,0.024494189081567117,2730,2,220,2,0.22591555581808995,4,292,0,32,108,0,432,260,0.1146264377359708,240511,83698,
23,0.0,1,6,17,30,109930,7193,434139,0.02893994893994894,156813,551,0.09131187832064054,4463,7,6,80,93,12207,0.024494189081567117,2730,0,1,0,0.13537117903930132,0,292,0,32,108,0,432,260,0.1146264377359708,240511,83698,
23,0.0,1,6,17,30,109930,7193,434139,0.02893994893994894,156813,551,0.09131187832064054,4463,7,6,80,93,12207,0.024494189081567117,2730,0,1,0,0.13537117903930132,0,292,0,32,108,0,432,260,0.1146264377359708,240511,83698,
23,0.18803418803418803,1,6,17,30,109930,7193,434139,0.02893994893994894,156813,551,0.09131187832064054,4463,39,14,16,69,12207,0.024494189081567117,2730,4,25,21,0.11884268296127305,26,292,1,32,108,17,432,260,0.1146264377359708,240511,83698,
23,0.18803418803418803,1,6,17,30,109930,7193,434139,0.02893994893994894,156813,551,0.09131187832064054,4463,39,14,16,69,12207,0.024494189081567117,2730,4,25,21,0.11884268296127305,26,292,1,32,108,17,432,260,0.1146264377359708,240511,83698,
23,0.18803418803418803,1,6,17,30,109930,7193,434139,0.02893994893994894,156813,551,0.09131187832064054,4463,39,14,16,69,12207,0.024494189081567117,2730,4,25,21,0.11884268296127305,26,292,1,32,108,17,432,260,0.1146264377359708,240511,83698,
23,0.18803418803418803,1,6,17,30,109930,7193,434139,0.02893994893994894,156813,551,0.09131187832064054,4463,39,14,16,69,12207,0.024494189081567117,2730,4,25,21,0.11884268296127305,26,292,1,32,108,17,432,260,0.1146264377359708,240511,83698,
23,0.18803418803418803,1,6,17,30,109930,7193,434139,0.02893994893994894,156813,551,0.09131187832064054,4463,39,14,16,69,12207,0.024494189081567117,2730,4,25,21,0.11884268296127305,26,292,1,32,108,17,432,260,0.1146264377359708,240511,83698,
23,0.18803418803418803,1,6,17,30,109930,7193,434139,0.02893994893994894,156813,551,0.09131187832064054,4463,39,14,16,69,12207,0.024494189081567117,2730,4,25,21,0.11884268296127305,26,292,1,32,108,17,432,260,0.1146264377359708,240511,83698,
178,0.0,18,26,152,222,109930,7193,434139,0.0686222236158066,156813,551,0.09131187832064054,4463,189,7,0,196,12207,0.024494189081567117,2730,0,182,0,0.3763662028634805,0,2956,0,520,63,0,3539,2436,0.13566124152751652,240511,83698,
178,0.0,18,26,152,222,109930,7193,434139,0.0686222236158066,156813,551,0.09131187832064054,4463,189,7,0,196,12207,0.024494189081567117,2730,0,182,0,0.3763662028634805,0,2956,0,520,63,0,3539,2436,0.13566124152751652,240511,83698,
178,0.0,18,26,152,222,109930,7193,434139,0.0686222236158066,156813,551,0.09131187832064054,4463,189,7,0,196,12207,0.024494189081567117,2730,0,182,0,0.3763662028634805,0,2956,0,520,63,0,3539,2436,0.13566124152751652,240511,83698,
178,0.0,18,26,152,222,109930,7193,434139,0.0686222236158066,156813,551,0.09131187832064054,4463,109,50,0,159,12207,0.024494189081567117,2730,0,59,0,0.21646751601830622,0,2956,0,520,63,0,3539,2436,0.13566124152751652,240511,83698,
178,0.0,18,26,152,222,109930,7193,434139,0.0686222236158066,156813,551,0.09131187832064054,4463,59,8,2,69,12207,0.024494189081567117,2730,0,51,0,0.16186060205500852,0,2956,0,520,63,0,3539,2436,0.13566124152751652,240511,83698,
178,0.23529411764705882,18,26,152,222,109930,7193,434139,0.0686222236158066,156813,551,0.09131187832064054,4463,209,7,0,216,12207,0.024494189081567117,2730,2,202,2,0.16368112957607697,4,2956,0,520,63,0,3539,2436,0.13566124152751652,240511,83698,
178,0.0,18,26,152,222,109930,7193,434139,0.0686222236158066,156813,551,0.09131187832064054,4463,114,0,0,114,12207,0.024494189081567117,2730,0,114,0,0.022128757724949044,0,2956,0,520,63,0,3539,2436,0.13566124152751652,240511,83698,
178,0.0,18,26,152,222,109930,7193,434139,0.0686222236158066,156813,551,0.09131187832064054,4463,114,0,0,114,12207,0.024494189081567117,2730,0,114,0,0.022128757724949044,0,2956,0,520,63,0,3539,2436,0.13566124152751652,240511,83698,
178,0.0,18,26,152,222,109930,7193,434139,0.0686222236158066,156813,551,0.09131187832064054,4463,179,7,3,189,12207,0.024494189081567117,2730,0,172,0,0.07939484368611885,0,2956,0,520,63,0,3539,2436,0.13566124152751652,240511,83698,
178,0.0,18,26,152,222,109930,7193,434139,0.0686222236158066,156813,551,0.09131187832064054,4463,125,4,0,129,12207,0.024494189081567117,2730,0,121,0,0.07163939000655581,0,2956,0,520,63,0,3539,2436,0.13566124152751652,240511,83698,
178,0.0,18,26,152,222,109930,7193,434139,0.0686222236158066,156813,551,0.09131187832064054,4463,125,4,0,129,12207,0.024494189081567117,2730,0,121,0,0.07163939000655581,0,2956,0,520,63,0,3539,2436,0.13566124152751652,240511,83698,
160,0.12601888276947285,0,136,24,296,109930,7193,434139,0.06517896431752128,156813,551,0.09131187832064054,4463,304,89,11,404,12207,0.024494189081567117,2730,24,215,16,0.16426747847891304,40,1820,0,593,1410,-8,3823,1227,0.11079275163844425,240511,83698,
160,0.15490196078431373,0,136,24,296,109930,7193,434139,0.06517896431752128,156813,551,0.09131187832064054,4463,126,107,444,677,12207,0.024494189081567117,2730,4,19,1,0.15559572870560073,5,1820,0,593,1410,-3,3823,1227,0.11079275163844425,240511,83698,
160,0.15490196078431373,0,136,24,296,109930,7193,434139,0.06517896431752128,156813,551,0.09131187832064054,4463,126,107,444,677,12207,0.024494189081567117,2730,4,19,1,0.15559572870560073,5,1820,0,593,1410,-3,3823,1227,0.11079275163844425,240511,83698,
1558,0.21584896584896585,2,199,1359,1759,109930,7193,434139,0.12372836791169721,156813,551,0.09131187832064054,4463,427,118,6,551,12207,0.024494189081567117,2730,70,309,12,0.15498538266459683,84,3045,2,1828,81,-58,4954,1217,0.1232800913637176,240511,83698,
1558,0.25352593266606005,2,199,1359,1759,109930,7193,434139,0.12372836791169721,156813,551,0.09131187832064054,4463,1669,933,37,2639,12207,0.024494189081567117,2730,3,736,1464,0.1059252070922974,1467,3045,0,1828,81,1461,4954,1217,0.1232800913637176,240511,83698,
1558,0.25352593266606005,2,199,1359,1759,109930,7193,434139,0.12372836791169721,156813,551,0.09131187832064054,4463,1669,933,37,2639,12207,0.024494189081567117,2730,3,736,1464,0.1059252070922974,1467,3045,0,1828,81,1461,4954,1217,0.1232800913637176,240511,83698,
1558,0.25352593266606005,2,199,1359,1759,109930,7193,434139,0.12372836791169721,156813,551,0.09131187832064054,4463,1669,933,37,2639,12207,0.024494189081567117,2730,3,736,1464,0.1059252070922974,1467,3045,0,1828,81,1461,4954,1217,0.1232800913637176,240511,83698,
1558,0.25352593266606005,2,199,1359,1759,109930,7193,434139,0.12372836791169721,156813,551,0.09131187832064054,4463,1669,933,37,2639,12207,0.024494189081567117,2730,3,736,1464,0.1059252070922974,1467,3045,0,1828,81,1461,4954,1217,0.1232800913637176,240511,83698,
1558,0.25352593266606005,2,199,1359,1759,109930,7193,434139,0.12372836791169721,156813,551,0.09131187832064054,4463,1669,933,37,2639,12207,0.024494189081567117,2730,3,736,1464,0.1059252070922974,1467,3045,0,1828,81,1461,4954,1217,0.1232800913637176,240511,83698,
1558,0.01904761904761905,2,199,1359,1759,109930,7193,434139,0.12372836791169721,156813,551,0.09131187832064054,4463,329,249,0,578,12207,0.024494189081567117,2730,2,80,0,0.14550800122762558,2,3045,0,1828,81,-2,4954,1217,0.1232800913637176,240511,83698,
231,0.23097826086956522,12,728,-497,971,109930,7193,434139,0.07409760009720173,156813,551,0.09131187832064054,4463,132,47,0,179,12207,0.024494189081567117,2730,41,85,44,0.2820268388999986,85,7290,0,7305,4582,3,19177,-15,0.11668307486935509,240511,83698,
231,0.23097826086956522,12,728,-497,971,109930,7193,434139,0.07409760009720173,156813,551,0.09131187832064054,4463,132,47,0,179,12207,0.024494189081567117,2730,41,85,44,0.2820268388999986,85,7290,0,7305,4582,3,19177,-15,0.11668307486935509,240511,83698,
231,0.13651022196559237,12,728,-497,971,109930,7193,434139,0.07409760009720173,156813,551,0.09131187832064054,4463,788,610,56,1454,12207,0.024494189081567117,2730,39,178,29,0.16603632518053812,76,7290,8,7305,4582,-10,19177,-15,0.11668307486935509,240511,83698,
231,0.13651022196559237,12,728,-497,971,109930,7193,434139,0.07409760009720173,156813,551,0.09131187832064054,4463,788,610,56,1454,12207,0.024494189081567117,2730,39,178,29,0.16603632518053812,76,7290,8,7305,4582,-10,19177,-15,0.11668307486935509,240511,83698,
231,0.13651022196559237,12,728,-497,971,109930,7193,434139,0.07409760009720173,156813,551,0.09131187832064054,4463,788,610,56,1454,12207,0.024494189081567117,2730,39,178,29,0.16603632518053812,76,7290,8,7305,4582,-10,19177,-15,0.11668307486935509,240511,83698,
231,0.13651022196559237,12,728,-497,971,109930,7193,434139,0.07409760009720173,156813,551,0.09131187832064054,4463,788,610,56,1454,12207,0.024494189081567117,2730,39,178,29,0.16603632518053812,76,7290,8,7305,4582,-10,19177,-15,0.11668307486935509,240511,83698,
231,0.022012072434607646,12,728,-497,971,109930,7193,434139,0.07409760009720173,156813,551,0.09131187832064054,4463,57,35,7,99,12207,0.024494189081567117,2730,2,22,2,0.13175498177317552,4,7290,0,7305,4582,0,19177,-15,0.11668307486935509,240511,83698,
231,0.022012072434607646,12,728,-497,971,109930,7193,434139,0.07409760009720173,156813,551,0.09131187832064054,4463,57,35,7,99,12207,0.024494189081567117,2730,2,22,2,0.13175498177317552,4,7290,0,7305,4582,0,19177,-15,0.11668307486935509,240511,83698,
231,0.022012072434607646,12,728,-497,971,109930,7193,434139,0.07409760009720173,156813,551,0.09131187832064054,4463,57,35,7,99,12207,0.024494189081567117,2730,2,22,2,0.13175498177317552,4,7290,0,7305,4582,0,19177,-15,0.11668307486935509,240511,83698,
231,0.031746031746031744,12,728,-497,971,109930,7193,434139,0.07409760009720173,156813,551,0.09131187832064054,4463,9,10,0,19,12207,0.024494189081567117,2730,9,-1,9,0.026984126984126985,18,7290,0,7305,4582,0,19177,-15,0.11668307486935509,240511,83698,
231,0.10934550031466331,12,728,-497,971,109930,7193,434139,0.07409760009720173,156813,551,0.09131187832064054,4463,63,116,31,210,12207,0.024494189081567117,2730,4,-53,8,0.14648555160543877,12,7290,0,7305,4582,4,19177,-15,0.11668307486935509,240511,83698,
231,0.015267175572519083,12,728,-497,971,109930,7193,434139,0.07409760009720173,156813,551,0.09131187832064054,4463,24,13,0,37,12207,0.024494189081567117,2730,2,11,0,0.0913927038815926,2,7290,0,7305,4582,-2,19177,-15,0.11668307486935509,240511,83698,
231,0.015267175572519083,12,728,-497,971,109930,7193,434139,0.07409760009720173,156813,551,0.09131187832064054,4463,24,13,0,37,12207,0.024494189081567117,2730,2,11,0,0.0913927038815926,2,7290,0,7305,4582,-2,19177,-15,0.11668307486935509,240511,83698,
231,0.015267175572519083,12,728,-497,971,109930,7193,434139,0.07409760009720173,156813,551,0.09131187832064054,4463,24,13,0,37,12207,0.024494189081567117,2730,2,11,0,0.0913927038815926,2,7290,0,7305,4582,-2,19177,-15,0.11668307486935509,240511,83698,
231,0.015267175572519083,12,728,-497,971,109930,7193,434139,0.07409760009720173,156813,551,0.09131187832064054,4463,24,13,0,37,12207,0.024494189081567117,2730,2,11,0,0.0913927038815926,2,7290,0,7305,4582,-2,19177,-15,0.11668307486935509,240511,83698,
231,0.015267175572519083,12,728,-497,971,109930,7193,434139,0.07409760009720173,156813,551,0.09131187832064054,4463,24,13,0,37,12207,0.024494189081567117,2730,2,11,0,0.0913927038815926,2,7290,0,7305,4582,-2,19177,-15,0.11668307486935509,240511,83698,
231,0.015267175572519083,12,728,-497,971,109930,7193,434139,0.07409760009720173,156813,551,0.09131187832064054,4463,24,13,0,37,12207,0.024494189081567117,2730,2,11,0,0.0913927038815926,2,7290,0,7305,4582,-2,19177,-15,0.11668307486935509,240511,83698,
231,0.015267175572519083,12,728,-497,971,109930,7193,434139,0.07409760009720173,156813,551,0.09131187832064054,4463,24,13,0,37,12207,0.024494189081567117,2730,2,11,0,0.0913927038815926,2,7290,0,7305,4582,-2,19177,-15,0.11668307486935509,240511,83698,
231,0.015267175572519083,12,728,-497,971,109930,7193,434139,0.07409760009720173,156813,551,0.09131187832064054,4463,24,13,0,37,12207,0.024494189081567117,2730,2,11,0,0.0913927038815926,2,7290,0,7305,4582,-2,19177,-15,0.11668307486935509,240511,83698,
231,0.13276863039413098,12,728,-497,971,109930,7193,434139,0.07409760009720173,156813,551,0.09131187832064054,4463,293,1401,77,1771,12207,0.024494189081567117,2730,31,-1108,6,0.1552757018737984,37,7290,0,7305,4582,-25,19177,-15,0.11668307486935509,240511,83698,
231,0.13276863039413098,12,728,-497,971,109930,7193,434139,0.07409760009720173,156813,551,0.09131187832064054,4463,293,1401,77,1771,12207,0.024494189081567117,2730,31,-1108,6,0.1552757018737984,37,7290,0,7305,4582,-25,19177,-15,0.11668307486935509,240511,83698,
231,0.11030044750234305,12,728,-497,971,109930,7193,434139,0.07409760009720173,156813,551,0.09131187832064054,4463,538,194,9,741,12207,0.024494189081567117,2730,142,344,10,0.1854233399990749,152,7290,0,7305,4582,-132,19177,-15,0.11668307486935509,240511,83698,
231,0.04248803125188338,12,728,-497,971,109930,7193,434139,0.07409760009720173,156813,551,0.09131187832064054,4463,1989,1015,1500,4504,12207,0.024494189081567117,2730,10,974,5,0.14726236454581523,15,7290,0,7305,4582,-5,19177,-15,0.11668307486935509,240511,83698,
231,0.0048134777376654635,12,728,-497,971,109930,7193,434139,0.07409760009720173,156813,551,0.09131187832064054,4463,197,114,631,942,12207,0.024494189081567117,2730,2,83,2,0.13852170630545058,4,7290,0,7305,4582,0,19177,-15,0.11668307486935509,240511,83698,
231,0.0048134777376654635,12,728,-497,971,109930,7193,434139,0.07409760009720173,156813,551,0.09131187832064054,4463,197,114,631,942,12207,0.024494189081567117,2730,2,83,2,0.13852170630545058,4,7290,0,7305,4582,0,19177,-15,0.11668307486935509,240511,83698,
231,0.08333333333333333,12,728,-497,971,109930,7193,434139,0.07409760009720173,156813,551,0.09131187832064054,4463,139,91,21,251,12207,0.024494189081567117,2730,2,48,0,0.0801408908199922,2,7290,0,7305,4582,-2,19177,-15,0.11668307486935509,240511,83698,
231,0.08333333333333333,12,728,-497,971,109930,7193,434139,0.07409760009720173,156813,551,0.09131187832064054,4463,139,91,21,251,12207,0.024494189081567117,2730,2,48,0,0.0801408908199922,2,7290,0,7305,4582,-2,19177,-15,0.11668307486935509,240511,83698,
231,0.08333333333333333,12,728,-497,971,109930,7193,434139,0.07409760009720173,156813,551,0.09131187832064054,4463,139,91,21,251,12207,0.024494189081567117,2730,2,48,0,0.0801408908199922,2,7290,0,7305,4582,-2,19177,-15,0.11668307486935509,240511,83698,
231,0.012987012987012988,12,728,-497,971,109930,7193,434139,0.07409760009720173,156813,551,0.09131187832064054,4463,18,15,5,38,12207,0.024494189081567117,2730,6,3,6,0.14940422670975997,12,7290,0,7305,4582,0,19177,-15,0.11668307486935509,240511,83698,
231,0.06521739130434782,12,728,-497,971,109930,7193,434139,0.07409760009720173,156813,551,0.09131187832064054,4463,56,26,10,92,12207,0.024494189081567117,2730,3,30,0,0.19282343561522752,3,7290,0,7305,4582,-3,19177,-15,0.11668307486935509,240511,83698,
231,0.1016949152542373,12,728,-497,971,109930,7193,434139,0.07409760009720173,156813,551,0.09131187832064054,4463,417,225,613,1255,12207,0.024494189081567117,2730,3,192,3,0.11645837614425272,6,7290,0,7305,4582,0,19177,-15,0.11668307486935509,240511,83698,
231,0.1016949152542373,12,728,-497,971,109930,7193,434139,0.07409760009720173,156813,551,0.09131187832064054,4463,417,225,613,1255,12207,0.024494189081567117,2730,3,192,3,0.11645837614425272,6,7290,0,7305,4582,0,19177,-15,0.11668307486935509,240511,83698,
5,0.0,1,7,-2,13,109930,7193,434139,0.021314444823442177,156813,551,0.09131187832064054,4463,100,11,3,114,12207,0.024494189081567117,2730,0,89,0,0.05867161520197102,0,1135,0,196,521,0,1852,939,0.06041144304186947,240511,83698,
5,0.006872852233676976,1,7,-2,13,109930,7193,434139,0.021314444823442177,156813,551,0.09131187832064054,4463,441,79,257,777,12207,0.024494189081567117,2730,2,362,2,0.1468795560783112,4,1135,0,196,521,0,1852,939,0.06041144304186947,240511,83698,
5,0.0,1,7,-2,13,109930,7193,434139,0.021314444823442177,156813,551,0.09131187832064054,4463,7,12,118,137,12207,0.024494189081567117,2730,0,-5,0,0.051280154822975994,0,1135,0,196,521,0,1852,939,0.06041144304186947,240511,83698,
5,0.0,1,7,-2,13,109930,7193,434139,0.021314444823442177,156813,551,0.09131187832064054,4463,7,12,118,137,12207,0.024494189081567117,2730,0,-5,0,0.051280154822975994,0,1135,0,196,521,0,1852,939,0.06041144304186947,240511,83698,
5,0.0,1,7,-2,13,109930,7193,434139,0.021314444823442177,156813,551,0.09131187832064054,4463,7,12,118,137,12207,0.024494189081567117,2730,0,-5,0,0.051280154822975994,0,1135,0,196,521,0,1852,939,0.06041144304186947,240511,83698,
5,0.0,1,7,-2,13,109930,7193,434139,0.021314444823442177,156813,551,0.09131187832064054,4463,0,21,133,154,12207,0.024494189081567117,2730,0,-21,0,0.10110395744974583,0,1135,0,196,521,0,1852,939,0.06041144304186947,240511,83698,
5,0.0,1,7,-2,13,109930,7193,434139,0.021314444823442177,156813,551,0.09131187832064054,4463,0,21,133,154,12207,0.024494189081567117,2730,0,-21,0,0.10110395744974583,0,1135,0,196,521,0,1852,939,0.06041144304186947,240511,83698,
11,0.0014265335235378032,0,13,-2,24,109930,7193,434139,0.007547812106168623,156813,551,0.09131187832064054,4463,4,7,19,30,12207,0.024494189081567117,2730,1,-3,1,0.06582296837063371,2,629,0,72,24,0,725,557,0.07557816723940979,240511,83698,
11,0.004332011256346989,0,13,-2,24,109930,7193,434139,0.007547812106168623,156813,551,0.09131187832064054,4463,529,46,4,579,12207,0.024494189081567117,2730,1,483,5,0.12128814362656387,6,629,0,72,24,4,725,557,0.07557816723940979,240511,83698,
1,0.37037037037037035,0,14,-13,15,109930,7193,434139,0.11537488708220414,156813,551,0.09131187832064054,4463,288,18,29,335,12207,0.024494189081567117,2730,10,270,0,0.13495318097785086,10,422,0,47,384,-10,853,375,0.06854825818058673,240511,83698,
1,0.37037037037037035,0,14,-13,15,109930,7193,434139,0.11537488708220414,156813,551,0.09131187832064054,4463,288,18,29,335,12207,0.024494189081567117,2730,10,270,0,0.13495318097785086,10,422,0,47,384,-10,853,375,0.06854825818058673,240511,83698,
1,0.37037037037037035,0,14,-13,15,109930,7193,434139,0.11537488708220414,156813,551,0.09131187832064054,4463,288,18,29,335,12207,0.024494189081567117,2730,10,270,0,0.13495318097785086,10,422,0,47,384,-10,853,375,0.06854825818058673,240511,83698,
1,0.0,0,14,-13,15,109930,7193,434139,0.11537488708220414,156813,551,0.09131187832064054,4463,17,3,64,84,12207,0.024494189081567117,2730,0,14,0,0.046577793165655516,0,422,0,47,384,0,853,375,0.06854825818058673,240511,83698,
1,0.07317073170731707,0,14,-13,15,109930,7193,434139,0.11537488708220414,156813,551,0.09131187832064054,4463,14,8,229,251,12207,0.024494189081567117,2730,3,6,0,0.04977852579108235,3,422,0,47,384,-3,853,375,0.06854825818058673,240511,83698,
1,0.07317073170731707,0,14,-13,15,109930,7193,434139,0.11537488708220414,156813,551,0.09131187832064054,4463,14,8,229,251,12207,0.024494189081567117,2730,3,6,0,0.04977852579108235,3,422,0,47,384,-3,853,375,0.06854825818058673,240511,83698,
25,0.0,0,14,11,39,109930,7193,434139,0.024950197363990467,156813,551,0.09131187832064054,4463,336,67,4,407,12207,0.024494189081567117,2730,0,269,0,0.1718993080064693,0,1265,0,241,129,0,1635,1024,0.07792666275142743,240511,83698,
25,0.0,0,14,11,39,109930,7193,434139,0.024950197363990467,156813,551,0.09131187832064054,4463,336,67,4,407,12207,0.024494189081567117,2730,0,269,0,0.1718993080064693,0,1265,0,241,129,0,1635,1024,0.07792666275142743,240511,83698,
25,0.0,0,14,11,39,109930,7193,434139,0.024950197363990467,156813,551,0.09131187832064054,4463,336,67,4,407,12207,0.024494189081567117,2730,0,269,0,0.1718993080064693,0,1265,0,241,129,0,1635,1024,0.07792666275142743,240511,83698,
25,0.0,0,14,11,39,109930,7193,434139,0.024950197363990467,156813,551,0.09131187832064054,4463,336,67,4,407,12207,0.024494189081567117,2730,0,269,0,0.1718993080064693,0,1265,0,241,129,0,1635,1024,0.07792666275142743,240511,83698,
25,0.0,0,14,11,39,109930,7193,434139,0.024950197363990467,156813,551,0.09131187832064054,4463,336,67,4,407,12207,0.024494189081567117,2730,0,269,0,0.1718993080064693,0,1265,0,241,129,0,1635,1024,0.07792666275142743,240511,83698,
25,0.0,0,14,11,39,109930,7193,434139,0.024950197363990467,156813,551,0.09131187832064054,4463,336,67,4,407,12207,0.024494189081567117,2730,0,269,0,0.1718993080064693,0,1265,0,241,129,0,1635,1024,0.07792666275142743,240511,83698,
25,0.0,0,14,11,39,109930,7193,434139,0.024950197363990467,156813,551,0.09131187832064054,4463,336,67,4,407,12207,0.024494189081567117,2730,0,269,0,0.1718993080064693,0,1265,0,241,129,0,1635,1024,0.07792666275142743,240511,83698,
25,0.0,0,14,11,39,109930,7193,434139,0.024950197363990467,156813,551,0.09131187832064054,4463,336,67,4,407,12207,0.024494189081567117,2730,0,269,0,0.1718993080064693,0,1265,0,241,129,0,1635,1024,0.07792666275142743,240511,83698,
25,0.16551066982101464,0,14,11,39,109930,7193,434139,0.024950197363990467,156813,551,0.09131187832064054,4463,595,96,14,705,12207,0.024494189081567117,2730,11,499,25,0.21328051375977858,36,1265,0,241,129,14,1635,1024,0.07792666275142743,240511,83698,
25,0.16551066982101464,0,14,11,39,109930,7193,434139,0.024950197363990467,156813,551,0.09131187832064054,4463,595,96,14,705,12207,0.024494189081567117,2730,11,499,25,0.21328051375977858,36,1265,0,241,129,14,1635,1024,0.07792666275142743,240511,83698,
25,0.16551066982101464,0,14,11,39,109930,7193,434139,0.024950197363990467,156813,551,0.09131187832064054,4463,595,96,14,705,12207,0.024494189081567117,2730,11,499,25,0.21328051375977858,36,1265,0,241,129,14,1635,1024,0.07792666275142743,240511,83698,
25,0.16551066982101464,0,14,11,39,109930,7193,434139,0.024950197363990467,156813,551,0.09131187832064054,4463,595,96,14,705,12207,0.024494189081567117,2730,11,499,25,0.21328051375977858,36,1265,0,241,129,14,1635,1024,0.07792666275142743,240511,83698,
25,0.0,0,14,11,39,109930,7193,434139,0.024950197363990467,156813,551,0.09131187832064054,4463,49,23,16,88,12207,0.024494189081567117,2730,0,26,0,0.06825169038896003,0,1265,0,241,129,0,1635,1024,0.07792666275142743,240511,83698,
33,0.0,0,43,-10,76,109930,7193,434139,0.012014476281576647,156813,551,0.09131187832064054,4463,17,3,25,45,12207,0.024494189081567117,2730,0,14,0,0.013336034281723242,0,5695,0,1874,3409,0,10978,3821,0.08025230434268289,240511,83698,
33,0.041237113402061855,0,43,-10,76,109930,7193,434139,0.012014476281576647,156813,551,0.09131187832064054,4463,65,22,84,171,12207,0.024494189081567117,2730,2,43,2,0.17497593706060002,4,5695,0,1874,3409,0,10978,3821,0.08025230434268289,240511,83698,
33,0.0,0,43,-10,76,109930,7193,434139,0.012014476281576647,156813,551,0.09131187832064054,4463,17,3,25,45,12207,0.024494189081567117,2730,0,14,0,0.009959394491819233,0,5695,0,1874,3409,0,10978,3821,0.08025230434268289,240511,83698,
33,0.0049261083743842365,0,43,-10,76,109930,7193,434139,0.012014476281576647,156813,551,0.09131187832064054,4463,26,9,50,85,12207,0.024494189081567117,2730,1,17,1,0.053670264827476034,2,5695,0,1874,3409,0,10978,3821,0.08025230434268289,240511,83698,
33,0.0049261083743842365,0,43,-10,76,109930,7193,434139,0.012014476281576647,156813,551,0.09131187832064054,4463,26,9,50,85,12207,0.024494189081567117,2730,1,17,1,0.053670264827476034,2,5695,0,1874,3409,0,10978,3821,0.08025230434268289,240511,83698,
33,0.0963855421686747,0,43,-10,76,109930,7193,434139,0.012014476281576647,156813,551,0.09131187832064054,4463,156,58,112,326,12207,0.024494189081567117,2730,8,98,8,0.16040858863670207,16,5695,0,1874,3409,0,10978,3821,0.08025230434268289,240511,83698,
33,0.0963855421686747,0,43,-10,76,109930,7193,434139,0.012014476281576647,156813,551,0.09131187832064054,4463,156,58,112,326,12207,0.024494189081567117,2730,8,98,8,0.16040858863670207,16,5695,0,1874,3409,0,10978,3821,0.08025230434268289,240511,83698,
33,0.0,0,43,-10,76,109930,7193,434139,0.012014476281576647,156813,551,0.09131187832064054,4463,2319,784,897,4000,12207,0.024494189081567117,2730,0,1535,0,0.27382900007713235,0,5695,0,1874,3409,0,10978,3821,0.08025230434268289,240511,83698,
33,0.0,0,43,-10,76,109930,7193,434139,0.012014476281576647,156813,551,0.09131187832064054,4463,2319,784,897,4000,12207,0.024494189081567117,2730,0,1535,0,0.27382900007713235,0,5695,0,1874,3409,0,10978,3821,0.08025230434268289,240511,83698,
33,0.0,0,43,-10,76,109930,7193,434139,0.012014476281576647,156813,551,0.09131187832064054,4463,2319,784,897,4000,12207,0.024494189081567117,2730,0,1535,0,0.27382900007713235,0,5695,0,1874,3409,0,10978,3821,0.08025230434268289,240511,83698,
33,0.0,0,43,-10,76,109930,7193,434139,0.012014476281576647,156813,551,0.09131187832064054,4463,2319,784,897,4000,12207,0.024494189081567117,2730,0,1535,0,0.27382900007713235,0,5695,0,1874,3409,0,10978,3821,0.08025230434268289,240511,83698,
33,0.0,0,43,-10,76,109930,7193,434139,0.012014476281576647,156813,551,0.09131187832064054,4463,2319,784,897,4000,12207,0.024494189081567117,2730,0,1535,0,0.27382900007713235,0,5695,0,1874,3409,0,10978,3821,0.08025230434268289,240511,83698,
33,0.0,0,43,-10,76,109930,7193,434139,0.012014476281576647,156813,551,0.09131187832064054,4463,2319,784,897,4000,12207,0.024494189081567117,2730,0,1535,0,0.27382900007713235,0,5695,0,1874,3409,0,10978,3821,0.08025230434268289,240511,83698,
33,0.0,0,43,-10,76,109930,7193,434139,0.012014476281576647,156813,551,0.09131187832064054,4463,2319,784,897,4000,12207,0.024494189081567117,2730,0,1535,0,0.27382900007713235,0,5695,0,1874,3409,0,10978,3821,0.08025230434268289,240511,83698,
33,0.0,0,43,-10,76,109930,7193,434139,0.012014476281576647,156813,551,0.09131187832064054,4463,2319,784,897,4000,12207,0.024494189081567117,2730,0,1535,0,0.27382900007713235,0,5695,0,1874,3409,0,10978,3821,0.08025230434268289,240511,83698,
33,0.0,0,43,-10,76,109930,7193,434139,0.012014476281576647,156813,551,0.09131187832064054,4463,2319,784,897,4000,12207,0.024494189081567117,2730,0,1535,0,0.27382900007713235,0,5695,0,1874,3409,0,10978,3821,0.08025230434268289,240511,83698,
33,0.0,0,43,-10,76,109930,7193,434139,0.012014476281576647,156813,551,0.09131187832064054,4463,2319,784,897,4000,12207,0.024494189081567117,2730,0,1535,0,0.27382900007713235,0,5695,0,1874,3409,0,10978,3821,0.08025230434268289,240511,83698,
33,0.0,0,43,-10,76,109930,7193,434139,0.012014476281576647,156813,551,0.09131187832064054,4463,2319,784,897,4000,12207,0.024494189081567117,2730,0,1535,0,0.27382900007713235,0,5695,0,1874,3409,0,10978,3821,0.08025230434268289,240511,83698,
33,0.0,0,43,-10,76,109930,7193,434139,0.012014476281576647,156813,551,0.09131187832064054,4463,2319,784,897,4000,12207,0.024494189081567117,2730,0,1535,0,0.27382900007713235,0,5695,0,1874,3409,0,10978,3821,0.08025230434268289,240511,83698,
33,0.0,0,43,-10,76,109930,7193,434139,0.012014476281576647,156813,551,0.09131187832064054,4463,2319,784,897,4000,12207,0.024494189081567117,2730,0,1535,0,0.27382900007713235,0,5695,0,1874,3409,0,10978,3821,0.08025230434268289,240511,83698,
33,0.0,0,43,-10,76,109930,7193,434139,0.012014476281576647,156813,551,0.09131187832064054,4463,2319,784,897,4000,12207,0.024494189081567117,2730,0,1535,0,0.27382900007713235,0,5695,0,1874,3409,0,10978,3821,0.08025230434268289,240511,83698,
33,0.0,0,43,-10,76,109930,7193,434139,0.012014476281576647,156813,551,0.09131187832064054,4463,2319,784,897,4000,12207,0.024494189081567117,2730,0,1535,0,0.27382900007713235,0,5695,0,1874,3409,0,10978,3821,0.08025230434268289,240511,83698,
33,0.0,0,43,-10,76,109930,7193,434139,0.012014476281576647,156813,551,0.09131187832064054,4463,2319,784,897,4000,12207,0.024494189081567117,2730,0,1535,0,0.27382900007713235,0,5695,0,1874,3409,0,10978,3821,0.08025230434268289,240511,83698,
33,0.0,0,43,-10,76,109930,7193,434139,0.012014476281576647,156813,551,0.09131187832064054,4463,2319,784,897,4000,12207,0.024494189081567117,2730,0,1535,0,0.27382900007713235,0,5695,0,1874,3409,0,10978,3821,0.08025230434268289,240511,83698,
33,0.0,0,43,-10,76,109930,7193,434139,0.012014476281576647,156813,551,0.09131187832064054,4463,2319,784,897,4000,12207,0.024494189081567117,2730,0,1535,0,0.27382900007713235,0,5695,0,1874,3409,0,10978,3821,0.08025230434268289,240511,83698,
33,0.0,0,43,-10,76,109930,7193,434139,0.012014476281576647,156813,551,0.09131187832064054,4463,2319,784,897,4000,12207,0.024494189081567117,2730,0,1535,0,0.27382900007713235,0,5695,0,1874,3409,0,10978,3821,0.08025230434268289,240511,83698,
33,0.0,0,43,-10,76,109930,7193,434139,0.012014476281576647,156813,551,0.09131187832064054,4463,2319,784,897,4000,12207,0.024494189081567117,2730,0,1535,0,0.27382900007713235,0,5695,0,1874,3409,0,10978,3821,0.08025230434268289,240511,83698,
33,0.0,0,43,-10,76,109930,7193,434139,0.012014476281576647,156813,551,0.09131187832064054,4463,2319,784,897,4000,12207,0.024494189081567117,2730,0,1535,0,0.27382900007713235,0,5695,0,1874,3409,0,10978,3821,0.08025230434268289,240511,83698,
33,0.0,0,43,-10,76,109930,7193,434139,0.012014476281576647,156813,551,0.09131187832064054,4463,2319,784,897,4000,12207,0.024494189081567117,2730,0,1535,0,0.27382900007713235,0,5695,0,1874,3409,0,10978,3821,0.08025230434268289,240511,83698,
33,0.0,0,43,-10,76,109930,7193,434139,0.012014476281576647,156813,551,0.09131187832064054,4463,2319,784,897,4000,12207,0.024494189081567117,2730,0,1535,0,0.27382900007713235,0,5695,0,1874,3409,0,10978,3821,0.08025230434268289,240511,83698,
33,0.0,0,43,-10,76,109930,7193,434139,0.012014476281576647,156813,551,0.09131187832064054,4463,2319,784,897,4000,12207,0.024494189081567117,2730,0,1535,0,0.27382900007713235,0,5695,0,1874,3409,0,10978,3821,0.08025230434268289,240511,83698,
33,0.0,0,43,-10,76,109930,7193,434139,0.012014476281576647,156813,551,0.09131187832064054,4463,2319,784,897,4000,12207,0.024494189081567117,2730,0,1535,0,0.27382900007713235,0,5695,0,1874,3409,0,10978,3821,0.08025230434268289,240511,83698,
33,0.0,0,43,-10,76,109930,7193,434139,0.012014476281576647,156813,551,0.09131187832064054,4463,2319,784,897,4000,12207,0.024494189081567117,2730,0,1535,0,0.27382900007713235,0,5695,0,1874,3409,0,10978,3821,0.08025230434268289,240511,83698,
33,0.0,0,43,-10,76,109930,7193,434139,0.012014476281576647,156813,551,0.09131187832064054,4463,2319,784,897,4000,12207,0.024494189081567117,2730,0,1535,0,0.27382900007713235,0,5695,0,1874,3409,0,10978,3821,0.08025230434268289,240511,83698,
33,0.0,0,43,-10,76,109930,7193,434139,0.012014476281576647,156813,551,0.09131187832064054,4463,2319,784,897,4000,12207,0.024494189081567117,2730,0,1535,0,0.27382900007713235,0,5695,0,1874,3409,0,10978,3821,0.08025230434268289,240511,83698,
33,0.0,0,43,-10,76,109930,7193,434139,0.012014476281576647,156813,551,0.09131187832064054,4463,2319,784,897,4000,12207,0.024494189081567117,2730,0,1535,0,0.27382900007713235,0,5695,0,1874,3409,0,10978,3821,0.08025230434268289,240511,83698,
33,0.0,0,43,-10,76,109930,7193,434139,0.012014476281576647,156813,551,0.09131187832064054,4463,2319,784,897,4000,12207,0.024494189081567117,2730,0,1535,0,0.27382900007713235,0,5695,0,1874,3409,0,10978,3821,0.08025230434268289,240511,83698,
33,0.0,0,43,-10,76,109930,7193,434139,0.012014476281576647,156813,551,0.09131187832064054,4463,2319,784,897,4000,12207,0.024494189081567117,2730,0,1535,0,0.27382900007713235,0,5695,0,1874,3409,0,10978,3821,0.08025230434268289,240511,83698,
33,0.0,0,43,-10,76,109930,7193,434139,0.012014476281576647,156813,551,0.09131187832064054,4463,2319,784,897,4000,12207,0.024494189081567117,2730,0,1535,0,0.27382900007713235,0,5695,0,1874,3409,0,10978,3821,0.08025230434268289,240511,83698,
33,0.0,0,43,-10,76,109930,7193,434139,0.012014476281576647,156813,551,0.09131187832064054,4463,2319,784,897,4000,12207,0.024494189081567117,2730,0,1535,0,0.27382900007713235,0,5695,0,1874,3409,0,10978,3821,0.08025230434268289,240511,83698,
33,0.0,0,43,-10,76,109930,7193,434139,0.012014476281576647,156813,551,0.09131187832064054,4463,2319,784,897,4000,12207,0.024494189081567117,2730,0,1535,0,0.27382900007713235,0,5695,0,1874,3409,0,10978,3821,0.08025230434268289,240511,83698,
33,0.0,0,43,-10,76,109930,7193,434139,0.012014476281576647,156813,551,0.09131187832064054,4463,2319,784,897,4000,12207,0.024494189081567117,2730,0,1535,0,0.27382900007713235,0,5695,0,1874,3409,0,10978,3821,0.08025230434268289,240511,83698,
33,0.0,0,43,-10,76,109930,7193,434139,0.012014476281576647,156813,551,0.09131187832064054,4463,2319,784,897,4000,12207,0.024494189081567117,2730,0,1535,0,0.27382900007713235,0,5695,0,1874,3409,0,10978,3821,0.08025230434268289,240511,83698,
33,0.0,0,43,-10,76,109930,7193,434139,0.012014476281576647,156813,551,0.09131187832064054,4463,2319,784,897,4000,12207,0.024494189081567117,2730,0,1535,0,0.27382900007713235,0,5695,0,1874,3409,0,10978,3821,0.08025230434268289,240511,83698,
33,0.0,0,43,-10,76,109930,7193,434139,0.012014476281576647,156813,551,0.09131187832064054,4463,2319,784,897,4000,12207,0.024494189081567117,2730,0,1535,0,0.27382900007713235,0,5695,0,1874,3409,0,10978,3821,0.08025230434268289,240511,83698,
33,0.0,0,43,-10,76,109930,7193,434139,0.012014476281576647,156813,551,0.09131187832064054,4463,2319,784,897,4000,12207,0.024494189081567117,2730,0,1535,0,0.27382900007713235,0,5695,0,1874,3409,0,10978,3821,0.08025230434268289,240511,83698,
33,0.0,0,43,-10,76,109930,7193,434139,0.012014476281576647,156813,551,0.09131187832064054,4463,2319,784,897,4000,12207,0.024494189081567117,2730,0,1535,0,0.27382900007713235,0,5695,0,1874,3409,0,10978,3821,0.08025230434268289,240511,83698,
33,0.0,0,43,-10,76,109930,7193,434139,0.012014476281576647,156813,551,0.09131187832064054,4463,2319,784,897,4000,12207,0.024494189081567117,2730,0,1535,0,0.27382900007713235,0,5695,0,1874,3409,0,10978,3821,0.08025230434268289,240511,83698,
33,0.0,0,43,-10,76,109930,7193,434139,0.012014476281576647,156813,551,0.09131187832064054,4463,2319,784,897,4000,12207,0.024494189081567117,2730,0,1535,0,0.27382900007713235,0,5695,0,1874,3409,0,10978,3821,0.08025230434268289,240511,83698,
33,0.0,0,43,-10,76,109930,7193,434139,0.012014476281576647,156813,551,0.09131187832064054,4463,2319,784,897,4000,12207,0.024494189081567117,2730,0,1535,0,0.27382900007713235,0,5695,0,1874,3409,0,10978,3821,0.08025230434268289,240511,83698,
33,0.0,0,43,-10,76,109930,7193,434139,0.012014476281576647,156813,551,0.09131187832064054,4463,180,110,118,408,12207,0.024494189081567117,2730,0,70,0,0.057747158159283184,0,5695,0,1874,3409,0,10978,3821,0.08025230434268289,240511,83698,
33,0.0,0,43,-10,76,109930,7193,434139,0.012014476281576647,156813,551,0.09131187832064054,4463,1117,382,1245,2744,12207,0.024494189081567117,2730,0,735,0,0.0852574094701376,0,5695,0,1874,3409,0,10978,3821,0.08025230434268289,240511,83698,
33,0.0,0,43,-10,76,109930,7193,434139,0.012014476281576647,156813,551,0.09131187832064054,4463,1117,382,1245,2744,12207,0.024494189081567117,2730,0,735,0,0.0852574094701376,0,5695,0,1874,3409,0,10978,3821,0.08025230434268289,240511,83698,
33,0.0,0,43,-10,76,109930,7193,434139,0.012014476281576647,156813,551,0.09131187832064054,4463,1117,382,1245,2744,12207,0.024494189081567117,2730,0,735,0,0.0852574094701376,0,5695,0,1874,3409,0,10978,3821,0.08025230434268289,240511,83698,
33,0.0,0,43,-10,76,109930,7193,434139,0.012014476281576647,156813,551,0.09131187832064054,4463,1117,382,1245,2744,12207,0.024494189081567117,2730,0,735,0,0.0852574094701376,0,5695,0,1874,3409,0,10978,3821,0.08025230434268289,240511,83698,
33,0.0,0,43,-10,76,109930,7193,434139,0.012014476281576647,156813,551,0.09131187832064054,4463,1117,382,1245,2744,12207,0.024494189081567117,2730,0,735,0,0.0852574094701376,0,5695,0,1874,3409,0,10978,3821,0.08025230434268289,240511,83698,
33,0.0,0,43,-10,76,109930,7193,434139,0.012014476281576647,156813,551,0.09131187832064054,4463,1117,382,1245,2744,12207,0.024494189081567117,2730,0,735,0,0.0852574094701376,0,5695,0,1874,3409,0,10978,3821,0.08025230434268289,240511,83698,
33,0.0,0,43,-10,76,109930,7193,434139,0.012014476281576647,156813,551,0.09131187832064054,4463,1117,382,1245,2744,12207,0.024494189081567117,2730,0,735,0,0.0852574094701376,0,5695,0,1874,3409,0,10978,3821,0.08025230434268289,240511,83698,
33,0.0,0,43,-10,76,109930,7193,434139,0.012014476281576647,156813,551,0.09131187832064054,4463,1117,382,1245,2744,12207,0.024494189081567117,2730,0,735,0,0.0852574094701376,0,5695,0,1874,3409,0,10978,3821,0.08025230434268289,240511,83698,
33,0.0,0,43,-10,76,109930,7193,434139,0.012014476281576647,156813,551,0.09131187832064054,4463,1117,382,1245,2744,12207,0.024494189081567117,2730,0,735,0,0.0852574094701376,0,5695,0,1874,3409,0,10978,3821,0.08025230434268289,240511,83698,
33,0.0,0,43,-10,76,109930,7193,434139,0.012014476281576647,156813,551,0.09131187832064054,4463,1117,382,1245,2744,12207,0.024494189081567117,2730,0,735,0,0.0852574094701376,0,5695,0,1874,3409,0,10978,3821,0.08025230434268289,240511,83698,
33,0.0,0,43,-10,76,109930,7193,434139,0.012014476281576647,156813,551,0.09131187832064054,4463,1117,382,1245,2744,12207,0.024494189081567117,2730,0,735,0,0.0852574094701376,0,5695,0,1874,3409,0,10978,3821,0.08025230434268289,240511,83698,
33,0.0,0,43,-10,76,109930,7193,434139,0.012014476281576647,156813,551,0.09131187832064054,4463,1117,382,1245,2744,12207,0.024494189081567117,2730,0,735,0,0.0852574094701376,0,5695,0,1874,3409,0,10978,3821,0.08025230434268289,240511,83698,
33,0.0,0,43,-10,76,109930,7193,434139,0.012014476281576647,156813,551,0.09131187832064054,4463,167,100,0,267,12207,0.024494189081567117,2730,0,67,0,0.029657870830895754,0,5695,0,1874,3409,0,10978,3821,0.08025230434268289,240511,83698,
33,0.13541666666666666,0,43,-10,76,109930,7193,434139,0.012014476281576647,156813,551,0.09131187832064054,4463,213,52,3,268,12207,0.024494189081567117,2730,9,161,4,0.04660111126270373,13,5695,0,1874,3409,-5,10978,3821,0.08025230434268289,240511,83698,
33,0.13541666666666666,0,43,-10,76,109930,7193,434139,0.012014476281576647,156813,551,0.09131187832064054,4463,213,52,3,268,12207,0.024494189081567117,2730,9,161,4,0.04660111126270373,13,5695,0,1874,3409,-5,10978,3821,0.08025230434268289,240511,83698,
33,0.13541666666666666,0,43,-10,76,109930,7193,434139,0.012014476281576647,156813,551,0.09131187832064054,4463,213,52,3,268,12207,0.024494189081567117,2730,9,161,4,0.04660111126270373,13,5695,0,1874,3409,-5,10978,3821,0.08025230434268289,240511,83698,
33,0.0,0,43,-10,76,109930,7193,434139,0.012014476281576647,156813,551,0.09131187832064054,4463,17,2,332,351,12207,0.024494189081567117,2730,0,15,0,0.004052630982822688,0,5695,0,1874,3409,0,10978,3821,0.08025230434268289,240511,83698,
33,0.0,0,43,-10,76,109930,7193,434139,0.012014476281576647,156813,551,0.09131187832064054,4463,17,2,332,351,12207,0.024494189081567117,2730,0,15,0,0.004052630982822688,0,5695,0,1874,3409,0,10978,3821,0.08025230434268289,240511,83698,
33,0.0,0,43,-10,76,109930,7193,434139,0.012014476281576647,156813,551,0.09131187832064054,4463,17,2,332,351,12207,0.024494189081567117,2730,0,15,0,0.004052630982822688,0,5695,0,1874,3409,0,10978,3821,0.08025230434268289,240511,83698,
33,0.0,0,43,-10,76,109930,7193,434139,0.012014476281576647,156813,551,0.09131187832064054,4463,17,2,332,351,12207,0.024494189081567117,2730,0,15,0,0.004052630982822688,0,5695,0,1874,3409,0,10978,3821,0.08025230434268289,240511,83698,
33,0.0,0,43,-10,76,109930,7193,434139,0.012014476281576647,156813,551,0.09131187832064054,4463,17,2,332,351,12207,0.024494189081567117,2730,0,15,0,0.004052630982822688,0,5695,0,1874,3409,0,10978,3821,0.08025230434268289,240511,83698,
33,0.0,0,43,-10,76,109930,7193,434139,0.012014476281576647,156813,551,0.09131187832064054,4463,17,2,332,351,12207,0.024494189081567117,2730,0,15,0,0.004052630982822688,0,5695,0,1874,3409,0,10978,3821,0.08025230434268289,240511,83698,
33,0.0,0,43,-10,76,109930,7193,434139,0.012014476281576647,156813,551,0.09131187832064054,4463,17,2,332,351,12207,0.024494189081567117,2730,0,15,0,0.004052630982822688,0,5695,0,1874,3409,0,10978,3821,0.08025230434268289,240511,83698,
33,0.0,0,43,-10,76,109930,7193,434139,0.012014476281576647,156813,551,0.09131187832064054,4463,17,2,332,351,12207,0.024494189081567117,2730,0,15,0,0.004052630982822688,0,5695,0,1874,3409,0,10978,3821,0.08025230434268289,240511,83698,
33,0.0,0,43,-10,76,109930,7193,434139,0.012014476281576647,156813,551,0.09131187832064054,4463,17,2,332,351,12207,0.024494189081567117,2730,0,15,0,0.004052630982822688,0,5695,0,1874,3409,0,10978,3821,0.08025230434268289,240511,83698,
33,0.0,0,43,-10,76,109930,7193,434139,0.012014476281576647,156813,551,0.09131187832064054,4463,17,2,332,351,12207,0.024494189081567117,2730,0,15,0,0.004052630982822688,0,5695,0,1874,3409,0,10978,3821,0.08025230434268289,240511,83698,
33,0.0,0,43,-10,76,109930,7193,434139,0.012014476281576647,156813,551,0.09131187832064054,4463,17,2,332,351,12207,0.024494189081567117,2730,0,15,0,0.004052630982822688,0,5695,0,1874,3409,0,10978,3821,0.08025230434268289,240511,83698,
33,0.0,0,43,-10,76,109930,7193,434139,0.012014476281576647,156813,551,0.09131187832064054,4463,17,2,332,351,12207,0.024494189081567117,2730,0,15,0,0.004052630982822688,0,5695,0,1874,3409,0,10978,3821,0.08025230434268289,240511,83698,
33,0.0,0,43,-10,76,109930,7193,434139,0.012014476281576647,156813,551,0.09131187832064054,4463,17,2,332,351,12207,0.024494189081567117,2730,0,15,0,0.004052630982822688,0,5695,0,1874,3409,0,10978,3821,0.08025230434268289,240511,83698,
33,0.0,0,43,-10,76,109930,7193,434139,0.012014476281576647,156813,551,0.09131187832064054,4463,17,2,332,351,12207,0.024494189081567117,2730,0,15,0,0.004052630982822688,0,5695,0,1874,3409,0,10978,3821,0.08025230434268289,240511,83698,
33,0.0,0,43,-10,76,109930,7193,434139,0.012014476281576647,156813,551,0.09131187832064054,4463,17,2,332,351,12207,0.024494189081567117,2730,0,15,0,0.004052630982822688,0,5695,0,1874,3409,0,10978,3821,0.08025230434268289,240511,83698,
33,0.0,0,43,-10,76,109930,7193,434139,0.012014476281576647,156813,551,0.09131187832064054,4463,17,2,332,351,12207,0.024494189081567117,2730,0,15,0,0.004052630982822688,0,5695,0,1874,3409,0,10978,3821,0.08025230434268289,240511,83698,
33,0.0,0,43,-10,76,109930,7193,434139,0.012014476281576647,156813,551,0.09131187832064054,4463,17,2,332,351,12207,0.024494189081567117,2730,0,15,0,0.004052630982822688,0,5695,0,1874,3409,0,10978,3821,0.08025230434268289,240511,83698,
33,0.0,0,43,-10,76,109930,7193,434139,0.012014476281576647,156813,551,0.09131187832064054,4463,17,2,332,351,12207,0.024494189081567117,2730,0,15,0,0.004052630982822688,0,5695,0,1874,3409,0,10978,3821,0.08025230434268289,240511,83698,
33,0.0,0,43,-10,76,109930,7193,434139,0.012014476281576647,156813,551,0.09131187832064054,4463,17,2,332,351,12207,0.024494189081567117,2730,0,15,0,0.004052630982822688,0,5695,0,1874,3409,0,10978,3821,0.08025230434268289,240511,83698,
33,0.0,0,43,-10,76,109930,7193,434139,0.012014476281576647,156813,551,0.09131187832064054,4463,17,2,332,351,12207,0.024494189081567117,2730,0,15,0,0.004052630982822688,0,5695,0,1874,3409,0,10978,3821,0.08025230434268289,240511,83698,
33,0.0,0,43,-10,76,109930,7193,434139,0.012014476281576647,156813,551,0.09131187832064054,4463,17,2,332,351,12207,0.024494189081567117,2730,0,15,0,0.004052630982822688,0,5695,0,1874,3409,0,10978,3821,0.08025230434268289,240511,83698,
33,0.0,0,43,-10,76,109930,7193,434139,0.012014476281576647,156813,551,0.09131187832064054,4463,13,25,117,155,12207,0.024494189081567117,2730,0,-12,0,0.0025115168540033967,0,5695,0,1874,3409,0,10978,3821,0.08025230434268289,240511,83698,
4,0.016494845360824743,0,4,0,8,109930,7193,434139,0.005498281786941581,156813,551,0.09131187832064054,4463,245,12,0,257,12207,0.024494189081567117,2730,4,233,4,0.3428843793986436,8,344,0,15,0,0,359,329,0.2860925558078369,240511,83698,
4,0.016494845360824743,0,4,0,8,109930,7193,434139,0.005498281786941581,156813,551,0.09131187832064054,4463,245,12,0,257,12207,0.024494189081567117,2730,4,233,4,0.3428843793986436,8,344,0,15,0,0,359,329,0.2860925558078369,240511,83698,
4,0.0,0,4,0,8,109930,7193,434139,0.005498281786941581,156813,551,0.09131187832064054,4463,58,1,0,59,12207,0.024494189081567117,2730,0,57,0,0.16346346346346347,0,344,0,15,0,0,359,329,0.2860925558078369,240511,83698,
14,0.0,0,6,8,20,109930,7193,434139,0.026265480841160337,156813,551,0.09131187832064054,4463,66,33,1,100,12207,0.024494189081567117,2730,0,33,0,0.09503751318768629,0,265,0,107,157,0,529,158,0.10364969057820561,240511,83698,
14,0.048458149779735685,0,6,8,20,109930,7193,434139,0.026265480841160337,156813,551,0.09131187832064054,4463,134,57,154,345,12207,0.024494189081567117,2730,5,77,6,0.10240968933748157,11,265,0,107,157,1,529,158,0.10364969057820561,240511,83698,
14,0.048458149779735685,0,6,8,20,109930,7193,434139,0.026265480841160337,156813,551,0.09131187832064054,4463,134,57,154,345,12207,0.024494189081567117,2730,5,77,6,0.10240968933748157,11,265,0,107,157,1,529,158,0.10364969057820561,240511,83698,
14,0.048458149779735685,0,6,8,20,109930,7193,434139,0.026265480841160337,156813,551,0.09131187832064054,4463,134,57,154,345,12207,0.024494189081567117,2730,5,77,6,0.10240968933748157,11,265,0,107,157,1,529,158,0.10364969057820561,240511,83698,
14,0.048458149779735685,0,6,8,20,109930,7193,434139,0.026265480841160337,156813,551,0.09131187832064054,4463,134,57,154,345,12207,0.024494189081567117,2730,5,77,6,0.10240968933748157,11,265,0,107,157,1,529,158,0.10364969057820561,240511,83698,
14,0.048458149779735685,0,6,8,20,109930,7193,434139,0.026265480841160337,156813,551,0.09131187832064054,4463,134,57,154,345,12207,0.024494189081567117,2730,5,77,6,0.10240968933748157,11,265,0,107,157,1,529,158,0.10364969057820561,240511,83698,
14,0.048458149779735685,0,6,8,20,109930,7193,434139,0.026265480841160337,156813,551,0.09131187832064054,4463,134,57,154,345,12207,0.024494189081567117,2730,5,77,6,0.10240968933748157,11,265,0,107,157,1,529,158,0.10364969057820561,240511,83698,
12,0.0380952380952381,0,11,1,23,109930,7193,434139,0.06675200546168288,156813,551,0.09131187832064054,4463,1521,246,1231,2998,12207,0.024494189081567117,2730,2,1275,2,0.15425484680589785,4,2495,0,533,2644,0,5672,1962,0.10794116736832125,240511,83698,
12,0.0380952380952381,0,11,1,23,109930,7193,434139,0.06675200546168288,156813,551,0.09131187832064054,4463,1521,246,1231,2998,12207,0.024494189081567117,2730,2,1275,2,0.15425484680589785,4,2495,0,533,2644,0,5672,1962,0.10794116736832125,240511,83698,
12,0.0380952380952381,0,11,1,23,109930,7193,434139,0.06675200546168288,156813,551,0.09131187832064054,4463,1521,246,1231,2998,12207,0.024494189081567117,2730,2,1275,2,0.15425484680589785,4,2495,0,533,2644,0,5672,1962,0.10794116736832125,240511,83698,
12,0.0380952380952381,0,11,1,23,109930,7193,434139,0.06675200546168288,156813,551,0.09131187832064054,4463,1521,246,1231,2998,12207,0.024494189081567117,2730,2,1275,2,0.15425484680589785,4,2495,0,533,2644,0,5672,1962,0.10794116736832125,240511,83698,
12,0.0380952380952381,0,11,1,23,109930,7193,434139,0.06675200546168288,156813,551,0.09131187832064054,4463,1521,246,1231,2998,12207,0.024494189081567117,2730,2,1275,2,0.15425484680589785,4,2495,0,533,2644,0,5672,1962,0.10794116736832125,240511,83698,
12,0.0380952380952381,0,11,1,23,109930,7193,434139,0.06675200546168288,156813,551,0.09131187832064054,4463,1521,246,1231,2998,12207,0.024494189081567117,2730,2,1275,2,0.15425484680589785,4,2495,0,533,2644,0,5672,1962,0.10794116736832125,240511,83698,
12,0.0380952380952381,0,11,1,23,109930,7193,434139,0.06675200546168288,156813,551,0.09131187832064054,4463,1521,246,1231,2998,12207,0.024494189081567117,2730,2,1275,2,0.15425484680589785,4,2495,0,533,2644,0,5672,1962,0.10794116736832125,240511,83698,
12,0.0380952380952381,0,11,1,23,109930,7193,434139,0.06675200546168288,156813,551,0.09131187832064054,4463,1521,246,1231,2998,12207,0.024494189081567117,2730,2,1275,2,0.15425484680589785,4,2495,0,533,2644,0,5672,1962,0.10794116736832125,240511,83698,
12,0.0380952380952381,0,11,1,23,109930,7193,434139,0.06675200546168288,156813,551,0.09131187832064054,4463,1521,246,1231,2998,12207,0.024494189081567117,2730,2,1275,2,0.15425484680589785,4,2495,0,533,2644,0,5672,1962,0.10794116736832125,240511,83698,
12,0.0380952380952381,0,11,1,23,109930,7193,434139,0.06675200546168288,156813,551,0.09131187832064054,4463,1521,246,1231,2998,12207,0.024494189081567117,2730,2,1275,2,0.15425484680589785,4,2495,0,533,2644,0,5672,1962,0.10794116736832125,240511,83698,
12,0.0380952380952381,0,11,1,23,109930,7193,434139,0.06675200546168288,156813,551,0.09131187832064054,4463,1521,246,1231,2998,12207,0.024494189081567117,2730,2,1275,2,0.15425484680589785,4,2495,0,533,2644,0,5672,1962,0.10794116736832125,240511,83698,
12,0.0380952380952381,0,11,1,23,109930,7193,434139,0.06675200546168288,156813,551,0.09131187832064054,4463,1521,246,1231,2998,12207,0.024494189081567117,2730,2,1275,2,0.15425484680589785,4,2495,0,533,2644,0,5672,1962,0.10794116736832125,240511,83698,
12,0.25,0,11,1,23,109930,7193,434139,0.06675200546168288,156813,551,0.09131187832064054,4463,200,186,684,1070,12207,0.024494189081567117,2730,1,14,6,0.21870536671633053,7,2495,0,533,2644,5,5672,1962,0.10794116736832125,240511,83698,
12,0.25,0,11,1,23,109930,7193,434139,0.06675200546168288,156813,551,0.09131187832064054,4463,200,186,684,1070,12207,0.024494189081567117,2730,1,14,6,0.21870536671633053,7,2495,0,533,2644,5,5672,1962,0.10794116736832125,240511,83698,
169,0.10188189487345879,186,221,-52,576,109930,7193,434139,0.07167002926259415,156813,551,0.09131187832064054,4463,401,31,5,437,12207,0.024494189081567117,2730,4,370,4,0.14325375926055445,8,19275,0,2821,5259,0,27355,16454,0.10775499914667602,240511,83698,
169,0.10188189487345879,186,221,-52,576,109930,7193,434139,0.07167002926259415,156813,551,0.09131187832064054,4463,401,31,5,437,12207,0.024494189081567117,2730,4,370,4,0.14325375926055445,8,19275,0,2821,5259,0,27355,16454,0.10775499914667602,240511,83698,
169,0.10188189487345879,186,221,-52,576,109930,7193,434139,0.07167002926259415,156813,551,0.09131187832064054,4463,401,31,5,437,12207,0.024494189081567117,2730,4,370,4,0.14325375926055445,8,19275,0,2821,5259,0,27355,16454,0.10775499914667602,240511,83698,
169,0.10188189487345879,186,221,-52,576,109930,7193,434139,0.07167002926259415,156813,551,0.09131187832064054,4463,401,31,5,437,12207,0.024494189081567117,2730,4,370,4,0.14325375926055445,8,19275,0,2821,5259,0,27355,16454,0.10775499914667602,240511,83698,
169,0.0,186,221,-52,576,109930,7193,434139,0.07167002926259415,156813,551,0.09131187832064054,4463,481,85,23,589,12207,0.024494189081567117,2730,0,396,0,0.14545843038848,0,19275,0,2821,5259,0,27355,16454,0.10775499914667602,240511,83698,
169,0.0,186,221,-52,576,109930,7193,434139,0.07167002926259415,156813,551,0.09131187832064054,4463,481,85,23,589,12207,0.024494189081567117,2730,0,396,0,0.14545843038848,0,19275,0,2821,5259,0,27355,16454,0.10775499914667602,240511,83698,
169,0.0,186,221,-52,576,109930,7193,434139,0.07167002926259415,156813,551,0.09131187832064054,4463,481,85,23,589,12207,0.024494189081567117,2730,0,396,0,0.14545843038848,0,19275,0,2821,5259,0,27355,16454,0.10775499914667602,240511,83698,
169,0.0,186,221,-52,576,109930,7193,434139,0.07167002926259415,156813,551,0.09131187832064054,4463,481,85,23,589,12207,0.024494189081567117,2730,0,396,0,0.14545843038848,0,19275,0,2821,5259,0,27355,16454,0.10775499914667602,240511,83698,
169,0.0,186,221,-52,576,109930,7193,434139,0.07167002926259415,156813,551,0.09131187832064054,4463,481,85,23,589,12207,0.024494189081567117,2730,0,396,0,0.14545843038848,0,19275,0,2821,5259,0,27355,16454,0.10775499914667602,240511,83698,
169,0.0,186,221,-52,576,109930,7193,434139,0.07167002926259415,156813,551,0.09131187832064054,4463,481,85,23,589,12207,0.024494189081567117,2730,0,396,0,0.14545843038848,0,19275,0,2821,5259,0,27355,16454,0.10775499914667602,240511,83698,
169,0.0,186,221,-52,576,109930,7193,434139,0.07167002926259415,156813,551,0.09131187832064054,4463,481,85,23,589,12207,0.024494189081567117,2730,0,396,0,0.14545843038848,0,19275,0,2821,5259,0,27355,16454,0.10775499914667602,240511,83698,
169,0.0,186,221,-52,576,109930,7193,434139,0.07167002926259415,156813,551,0.09131187832064054,4463,481,85,23,589,12207,0.024494189081567117,2730,0,396,0,0.14545843038848,0,19275,0,2821,5259,0,27355,16454,0.10775499914667602,240511,83698,
169,0.0,186,221,-52,576,109930,7193,434139,0.07167002926259415,156813,551,0.09131187832064054,4463,481,85,23,589,12207,0.024494189081567117,2730,0,396,0,0.14545843038848,0,19275,0,2821,5259,0,27355,16454,0.10775499914667602,240511,83698,
169,0.0,186,221,-52,576,109930,7193,434139,0.07167002926259415,156813,551,0.09131187832064054,4463,92,27,6,125,12207,0.024494189081567117,2730,0,65,0,0.10241897057193268,0,19275,0,2821,5259,0,27355,16454,0.10775499914667602,240511,83698,
169,0.0,186,221,-52,576,109930,7193,434139,0.07167002926259415,156813,551,0.09131187832064054,4463,148,7,60,215,12207,0.024494189081567117,2730,0,141,0,0.1037112349628648,0,19275,0,2821,5259,0,27355,16454,0.10775499914667602,240511,83698,
169,0.0,186,221,-52,576,109930,7193,434139,0.07167002926259415,156813,551,0.09131187832064054,4463,148,7,60,215,12207,0.024494189081567117,2730,0,141,0,0.1037112349628648,0,19275,0,2821,5259,0,27355,16454,0.10775499914667602,240511,83698,
169,0.2857142857142857,186,221,-52,576,109930,7193,434139,0.07167002926259415,156813,551,0.09131187832064054,4463,147,67,340,554,12207,0.024494189081567117,2730,0,80,2,0.21035234201937517,8,19275,6,2821,5259,2,27355,16454,0.10775499914667602,240511,83698,
169,0.2857142857142857,186,221,-52,576,109930,7193,434139,0.07167002926259415,156813,551,0.09131187832064054,4463,147,67,340,554,12207,0.024494189081567117,2730,0,80,2,0.21035234201937517,8,19275,6,2821,5259,2,27355,16454,0.10775499914667602,240511,83698,
169,0.5061728395061729,186,221,-52,576,109930,7193,434139,0.07167002926259415,156813,551,0.09131187832064054,4463,4286,397,257,4940,12207,0.024494189081567117,2730,16,3889,52,0.2406328099407255,82,19275,14,2821,5259,36,27355,16454,0.10775499914667602,240511,83698,
169,0.5061728395061729,186,221,-52,576,109930,7193,434139,0.07167002926259415,156813,551,0.09131187832064054,4463,4286,397,257,4940,12207,0.024494189081567117,2730,16,3889,52,0.2406328099407255,82,19275,14,2821,5259,36,27355,16454,0.10775499914667602,240511,83698,
169,0.12121212121212122,186,221,-52,576,109930,7193,434139,0.07167002926259415,156813,551,0.09131187832064054,4463,451,57,34,542,12207,0.024494189081567117,2730,2,394,2,0.1834953298257443,4,19275,0,2821,5259,0,27355,16454,0.10775499914667602,240511,83698,
169,0.12121212121212122,186,221,-52,576,109930,7193,434139,0.07167002926259415,156813,551,0.09131187832064054,4463,451,57,34,542,12207,0.024494189081567117,2730,2,394,2,0.1834953298257443,4,19275,0,2821,5259,0,27355,16454,0.10775499914667602,240511,83698,
169,0.008849557522123894,186,221,-52,576,109930,7193,434139,0.07167002926259415,156813,551,0.09131187832064054,4463,130,22,0,152,12207,0.024494189081567117,2730,1,108,1,0.15701434812120627,2,19275,0,2821,5259,0,27355,16454,0.10775499914667602,240511,83698,
169,0.0,186,221,-52,576,109930,7193,434139,0.07167002926259415,156813,551,0.09131187832064054,4463,709,129,108,946,12207,0.024494189081567117,2730,0,580,0,0.22851765374218874,0,19275,0,2821,5259,0,27355,16454,0.10775499914667602,240511,83698,
169,0.0,186,221,-52,576,109930,7193,434139,0.07167002926259415,156813,551,0.09131187832064054,4463,709,129,108,946,12207,0.024494189081567117,2730,0,580,0,0.22851765374218874,0,19275,0,2821,5259,0,27355,16454,0.10775499914667602,240511,83698,
169,0.0,186,221,-52,576,109930,7193,434139,0.07167002926259415,156813,551,0.09131187832064054,4463,709,129,108,946,12207,0.024494189081567117,2730,0,580,0,0.22851765374218874,0,19275,0,2821,5259,0,27355,16454,0.10775499914667602,240511,83698,
169,0.0390625,186,221,-52,576,109930,7193,434139,0.07167002926259415,156813,551,0.09131187832064054,4463,1381,53,42,1476,12207,0.024494189081567117,2730,0,1328,4,0.11921184343810598,5,19275,1,2821,5259,4,27355,16454,0.10775499914667602,240511,83698,
169,0.0390625,186,221,-52,576,109930,7193,434139,0.07167002926259415,156813,551,0.09131187832064054,4463,1381,53,42,1476,12207,0.024494189081567117,2730,0,1328,4,0.11921184343810598,5,19275,1,2821,5259,4,27355,16454,0.10775499914667602,240511,83698,
169,0.25910756996862666,186,221,-52,576,109930,7193,434139,0.07167002926259415,156813,551,0.09131187832064054,4463,157,132,590,879,12207,0.024494189081567117,2730,67,25,28,0.16924580325710825,97,19275,2,2821,5259,-39,27355,16454,0.10775499914667602,240511,83698,
169,0.07352941176470588,186,221,-52,576,109930,7193,434139,0.07167002926259415,156813,551,0.09131187832064054,4463,508,120,36,664,12207,0.024494189081567117,2730,3,388,2,0.1285120112998775,5,19275,0,2821,5259,-1,27355,16454,0.10775499914667602,240511,83698,
169,0.07352941176470588,186,221,-52,576,109930,7193,434139,0.07167002926259415,156813,551,0.09131187832064054,4463,508,120,36,664,12207,0.024494189081567117,2730,3,388,2,0.1285120112998775,5,19275,0,2821,5259,-1,27355,16454,0.10775499914667602,240511,83698,
169,0.11320754716981132,186,221,-52,576,109930,7193,434139,0.07167002926259415,156813,551,0.09131187832064054,4463,1115,179,33,1327,12207,0.024494189081567117,2730,3,936,3,0.16515468194491875,6,19275,0,2821,5259,0,27355,16454,0.10775499914667602,240511,83698,
169,0.11320754716981132,186,221,-52,576,109930,7193,434139,0.07167002926259415,156813,551,0.09131187832064054,4463,1115,179,33,1327,12207,0.024494189081567117,2730,3,936,3,0.16515468194491875,6,19275,0,2821,5259,0,27355,16454,0.10775499914667602,240511,83698,
169,0.13333333333333333,186,221,-52,576,109930,7193,434139,0.07167002926259415,156813,551,0.09131187832064054,4463,2125,82,2,2209,12207,0.024494189081567117,2730,1,2043,1,0.07100231382344224,2,19275,0,2821,5259,0,27355,16454,0.10775499914667602,240511,83698,
169,0.13333333333333333,186,221,-52,576,109930,7193,434139,0.07167002926259415,156813,551,0.09131187832064054,4463,2125,82,2,2209,12207,0.024494189081567117,2730,1,2043,1,0.07100231382344224,2,19275,0,2821,5259,0,27355,16454,0.10775499914667602,240511,83698,
169,0.13333333333333333,186,221,-52,576,109930,7193,434139,0.07167002926259415,156813,551,0.09131187832064054,4463,2125,82,2,2209,12207,0.024494189081567117,2730,1,2043,1,0.07100231382344224,2,19275,0,2821,5259,0,27355,16454,0.10775499914667602,240511,83698,
169,0.13333333333333333,186,221,-52,576,109930,7193,434139,0.07167002926259415,156813,551,0.09131187832064054,4463,2125,82,2,2209,12207,0.024494189081567117,2730,1,2043,1,0.07100231382344224,2,19275,0,2821,5259,0,27355,16454,0.10775499914667602,240511,83698,
169,0.13333333333333333,186,221,-52,576,109930,7193,434139,0.07167002926259415,156813,551,0.09131187832064054,4463,2125,82,2,2209,12207,0.024494189081567117,2730,1,2043,1,0.07100231382344224,2,19275,0,2821,5259,0,27355,16454,0.10775499914667602,240511,83698,
169,0.13333333333333333,186,221,-52,576,109930,7193,434139,0.07167002926259415,156813,551,0.09131187832064054,4463,2125,82,2,2209,12207,0.024494189081567117,2730,1,2043,1,0.07100231382344224,2,19275,0,2821,5259,0,27355,16454,0.10775499914667602,240511,83698,
169,0.13333333333333333,186,221,-52,576,109930,7193,434139,0.07167002926259415,156813,551,0.09131187832064054,4463,2125,82,2,2209,12207,0.024494189081567117,2730,1,2043,1,0.07100231382344224,2,19275,0,2821,5259,0,27355,16454,0.10775499914667602,240511,83698,
169,0.13333333333333333,186,221,-52,576,109930,7193,434139,0.07167002926259415,156813,551,0.09131187832064054,4463,2125,82,2,2209,12207,0.024494189081567117,2730,1,2043,1,0.07100231382344224,2,19275,0,2821,5259,0,27355,16454,0.10775499914667602,240511,83698,
169,0.13333333333333333,186,221,-52,576,109930,7193,434139,0.07167002926259415,156813,551,0.09131187832064054,4463,2125,82,2,2209,12207,0.024494189081567117,2730,1,2043,1,0.07100231382344224,2,19275,0,2821,5259,0,27355,16454,0.10775499914667602,240511,83698,
169,0.13333333333333333,186,221,-52,576,109930,7193,434139,0.07167002926259415,156813,551,0.09131187832064054,4463,2125,82,2,2209,12207,0.024494189081567117,2730,1,2043,1,0.07100231382344224,2,19275,0,2821,5259,0,27355,16454,0.10775499914667602,240511,83698,
169,0.17296174061850628,186,221,-52,576,109930,7193,434139,0.07167002926259415,156813,551,0.09131187832064054,4463,69,56,564,689,12207,0.024494189081567117,2730,20,13,20,0.12423809491097217,40,19275,0,2821,5259,0,27355,16454,0.10775499914667602,240511,83698,
169,0.17296174061850628,186,221,-52,576,109930,7193,434139,0.07167002926259415,156813,551,0.09131187832064054,4463,69,56,564,689,12207,0.024494189081567117,2730,20,13,20,0.12423809491097217,40,19275,0,2821,5259,0,27355,16454,0.10775499914667602,240511,83698,
169,0.24464361707430848,186,221,-52,576,109930,7193,434139,0.07167002926259415,156813,551,0.09131187832064054,4463,1792,151,37,1980,12207,0.024494189081567117,2730,21,1641,21,0.22184247236131166,62,19275,20,2821,5259,0,27355,16454,0.10775499914667602,240511,83698,
169,0.24464361707430848,186,221,-52,576,109930,7193,434139,0.07167002926259415,156813,551,0.09131187832064054,4463,1792,151,37,1980,12207,0.024494189081567117,2730,21,1641,21,0.22184247236131166,62,19275,20,2821,5259,0,27355,16454,0.10775499914667602,240511,83698,
169,0.24464361707430848,186,221,-52,576,109930,7193,434139,0.07167002926259415,156813,551,0.09131187832064054,4463,1792,151,37,1980,12207,0.024494189081567117,2730,21,1641,21,0.22184247236131166,62,19275,20,2821,5259,0,27355,16454,0.10775499914667602,240511,83698,
169,0.24464361707430848,186,221,-52,576,109930,7193,434139,0.07167002926259415,156813,551,0.09131187832064054,4463,1792,151,37,1980,12207,0.024494189081567117,2730,21,1641,21,0.22184247236131166,62,19275,20,2821,5259,0,27355,16454,0.10775499914667602,240511,83698,
169,0.24464361707430848,186,221,-52,576,109930,7193,434139,0.07167002926259415,156813,551,0.09131187832064054,4463,1792,151,37,1980,12207,0.024494189081567117,2730,21,1641,21,0.22184247236131166,62,19275,20,2821,5259,0,27355,16454,0.10775499914667602,240511,83698,
169,0.24464361707430848,186,221,-52,576,109930,7193,434139,0.07167002926259415,156813,551,0.09131187832064054,4463,1792,151,37,1980,12207,0.024494189081567117,2730,21,1641,21,0.22184247236131166,62,19275,20,2821,5259,0,27355,16454,0.10775499914667602,240511,83698,
169,0.24464361707430848,186,221,-52,576,109930,7193,434139,0.07167002926259415,156813,551,0.09131187832064054,4463,1792,151,37,1980,12207,0.024494189081567117,2730,21,1641,21,0.22184247236131166,62,19275,20,2821,5259,0,27355,16454,0.10775499914667602,240511,83698,
169,0.24464361707430848,186,221,-52,576,109930,7193,434139,0.07167002926259415,156813,551,0.09131187832064054,4463,1792,151,37,1980,12207,0.024494189081567117,2730,21,1641,21,0.22184247236131166,62,19275,20,2821,5259,0,27355,16454,0.10775499914667602,240511,83698,
169,0.24464361707430848,186,221,-52,576,109930,7193,434139,0.07167002926259415,156813,551,0.09131187832064054,4463,1792,151,37,1980,12207,0.024494189081567117,2730,21,1641,21,0.22184247236131166,62,19275,20,2821,5259,0,27355,16454,0.10775499914667602,240511,83698,
169,0.24464361707430848,186,221,-52,576,109930,7193,434139,0.07167002926259415,156813,551,0.09131187832064054,4463,1792,151,37,1980,12207,0.024494189081567117,2730,21,1641,21,0.22184247236131166,62,19275,20,2821,5259,0,27355,16454,0.10775499914667602,240511,83698,
169,0.24464361707430848,186,221,-52,576,109930,7193,434139,0.07167002926259415,156813,551,0.09131187832064054,4463,1792,151,37,1980,12207,0.024494189081567117,2730,21,1641,21,0.22184247236131166,62,19275,20,2821,5259,0,27355,16454,0.10775499914667602,240511,83698,
169,0.24464361707430848,186,221,-52,576,109930,7193,434139,0.07167002926259415,156813,551,0.09131187832064054,4463,1792,151,37,1980,12207,0.024494189081567117,2730,21,1641,21,0.22184247236131166,62,19275,20,2821,5259,0,27355,16454,0.10775499914667602,240511,83698,
169,0.24464361707430848,186,221,-52,576,109930,7193,434139,0.07167002926259415,156813,551,0.09131187832064054,4463,1792,151,37,1980,12207,0.024494189081567117,2730,21,1641,21,0.22184247236131166,62,19275,20,2821,5259,0,27355,16454,0.10775499914667602,240511,83698,
169,0.24464361707430848,186,221,-52,576,109930,7193,434139,0.07167002926259415,156813,551,0.09131187832064054,4463,1792,151,37,1980,12207,0.024494189081567117,2730,21,1641,21,0.22184247236131166,62,19275,20,2821,5259,0,27355,16454,0.10775499914667602,240511,83698,
169,0.24464361707430848,186,221,-52,576,109930,7193,434139,0.07167002926259415,156813,551,0.09131187832064054,4463,1792,151,37,1980,12207,0.024494189081567117,2730,21,1641,21,0.22184247236131166,62,19275,20,2821,5259,0,27355,16454,0.10775499914667602,240511,83698,
169,0.24464361707430848,186,221,-52,576,109930,7193,434139,0.07167002926259415,156813,551,0.09131187832064054,4463,1792,151,37,1980,12207,0.024494189081567117,2730,21,1641,21,0.22184247236131166,62,19275,20,2821,5259,0,27355,16454,0.10775499914667602,240511,83698,
169,0.24464361707430848,186,221,-52,576,109930,7193,434139,0.07167002926259415,156813,551,0.09131187832064054,4463,1792,151,37,1980,12207,0.024494189081567117,2730,21,1641,21,0.22184247236131166,62,19275,20,2821,5259,0,27355,16454,0.10775499914667602,240511,83698,
169,0.24464361707430848,186,221,-52,576,109930,7193,434139,0.07167002926259415,156813,551,0.09131187832064054,4463,1792,151,37,1980,12207,0.024494189081567117,2730,21,1641,21,0.22184247236131166,62,19275,20,2821,5259,0,27355,16454,0.10775499914667602,240511,83698,
169,0.24464361707430848,186,221,-52,576,109930,7193,434139,0.07167002926259415,156813,551,0.09131187832064054,4463,1792,151,37,1980,12207,0.024494189081567117,2730,21,1641,21,0.22184247236131166,62,19275,20,2821,5259,0,27355,16454,0.10775499914667602,240511,83698,
169,0.24464361707430848,186,221,-52,576,109930,7193,434139,0.07167002926259415,156813,551,0.09131187832064054,4463,1792,151,37,1980,12207,0.024494189081567117,2730,21,1641,21,0.22184247236131166,62,19275,20,2821,5259,0,27355,16454,0.10775499914667602,240511,83698,
169,0.0,186,221,-52,576,109930,7193,434139,0.07167002926259415,156813,551,0.09131187832064054,4463,160,39,6,205,12207,0.024494189081567117,2730,0,121,0,0.09756968193067289,0,19275,0,2821,5259,0,27355,16454,0.10775499914667602,240511,83698,
169,0.0,186,221,-52,576,109930,7193,434139,0.07167002926259415,156813,551,0.09131187832064054,4463,160,39,6,205,12207,0.024494189081567117,2730,0,121,0,0.09756968193067289,0,19275,0,2821,5259,0,27355,16454,0.10775499914667602,240511,83698,
169,0.0,186,221,-52,576,109930,7193,434139,0.07167002926259415,156813,551,0.09131187832064054,4463,147,8,3,158,12207,0.024494189081567117,2730,0,139,0,0.011142218549953425,0,19275,0,2821,5259,0,27355,16454,0.10775499914667602,240511,83698,
169,0.00410958904109589,186,221,-52,576,109930,7193,434139,0.07167002926259415,156813,551,0.09131187832064054,4463,15,22,616,653,12207,0.024494189081567117,2730,2,-7,1,0.02594647826436528,3,19275,0,2821,5259,-1,27355,16454,0.10775499914667602,240511,83698,
169,0.00410958904109589,186,221,-52,576,109930,7193,434139,0.07167002926259415,156813,551,0.09131187832064054,4463,15,22,616,653,12207,0.024494189081567117,2730,2,-7,1,0.02594647826436528,3,19275,0,2821,5259,-1,27355,16454,0.10775499914667602,240511,83698,
169,0.2947619047619048,186,221,-52,576,109930,7193,434139,0.07167002926259415,156813,551,0.09131187832064054,4463,676,81,75,832,12207,0.024494189081567117,2730,2,595,8,0.14632333874308778,78,19275,68,2821,5259,6,27355,16454,0.10775499914667602,240511,83698,
169,0.2947619047619048,186,221,-52,576,109930,7193,434139,0.07167002926259415,156813,551,0.09131187832064054,4463,676,81,75,832,12207,0.024494189081567117,2730,2,595,8,0.14632333874308778,78,19275,68,2821,5259,6,27355,16454,0.10775499914667602,240511,83698,
169,0.2947619047619048,186,221,-52,576,109930,7193,434139,0.07167002926259415,156813,551,0.09131187832064054,4463,676,81,75,832,12207,0.024494189081567117,2730,2,595,8,0.14632333874308778,78,19275,68,2821,5259,6,27355,16454,0.10775499914667602,240511,83698,
169,0.2947619047619048,186,221,-52,576,109930,7193,434139,0.07167002926259415,156813,551,0.09131187832064054,4463,676,81,75,832,12207,0.024494189081567117,2730,2,595,8,0.14632333874308778,78,19275,68,2821,5259,6,27355,16454,0.10775499914667602,240511,83698,
169,0.2947619047619048,186,221,-52,576,109930,7193,434139,0.07167002926259415,156813,551,0.09131187832064054,4463,676,81,75,832,12207,0.024494189081567117,2730,2,595,8,0.14632333874308778,78,19275,68,2821,5259,6,27355,16454,0.10775499914667602,240511,83698,
169,0.2947619047619048,186,221,-52,576,109930,7193,434139,0.07167002926259415,156813,551,0.09131187832064054,4463,676,81,75,832,12207,0.024494189081567117,2730,2,595,8,0.14632333874308778,78,19275,68,2821,5259,6,27355,16454,0.10775499914667602,240511,83698,
169,0.3236607142857143,186,221,-52,576,109930,7193,434139,0.07167002926259415,156813,551,0.09131187832064054,4463,765,475,731,1971,12207,0.024494189081567117,2730,9,290,7,0.1657172095641187,91,19275,75,2821,5259,-2,27355,16454,0.10775499914667602,240511,83698,
169,0.3236607142857143,186,221,-52,576,109930,7193,434139,0.07167002926259415,156813,551,0.09131187832064054,4463,765,475,731,1971,12207,0.024494189081567117,2730,9,290,7,0.1657172095641187,91,19275,75,2821,5259,-2,27355,16454,0.10775499914667602,240511,83698,
169,0.0,186,221,-52,576,109930,7193,434139,0.07167002926259415,156813,551,0.09131187832064054,4463,165,79,17,261,12207,0.024494189081567117,2730,0,86,0,0.14120890328250496,0,19275,0,2821,5259,0,27355,16454,0.10775499914667602,240511,83698,
169,0.0,186,221,-52,576,109930,7193,434139,0.07167002926259415,156813,551,0.09131187832064054,4463,165,79,17,261,12207,0.024494189081567117,2730,0,86,0,0.14120890328250496,0,19275,0,2821,5259,0,27355,16454,0.10775499914667602,240511,83698,
169,0.0,186,221,-52,576,109930,7193,434139,0.07167002926259415,156813,551,0.09131187832064054,4463,20,7,81,108,12207,0.024494189081567117,2730,0,13,0,0.06105078421563565,0,19275,0,2821,5259,0,27355,16454,0.10775499914667602,240511,83698,
169,0.04583333333333333,186,221,-52,576,109930,7193,434139,0.07167002926259415,156813,551,0.09131187832064054,4463,1635,159,85,1879,12207,0.024494189081567117,2730,11,1476,0,0.19090329669074294,11,19275,0,2821,5259,-11,27355,16454,0.10775499914667602,240511,83698,
0,0.0,0,0,0,0,109930,7193,434139,0.0,156813,551,0.09131187832064054,4463,125,42,14,181,12207,0.024494189081567117,2730,0,83,0,0.03707829481372263,0,689,0,133,56,0,878,556,0.028728551651535417,240511,83698,
0,0.0,0,0,0,0,109930,7193,434139,0.0,156813,551,0.09131187832064054,4463,125,42,14,181,12207,0.024494189081567117,2730,0,83,0,0.03707829481372263,0,689,0,133,56,0,878,556,0.028728551651535417,240511,83698,
0,0.0,0,0,0,0,109930,7193,434139,0.0,156813,551,0.09131187832064054,4463,125,42,14,181,12207,0.024494189081567117,2730,0,83,0,0.03707829481372263,0,689,0,133,56,0,878,556,0.028728551651535417,240511,83698,
0,0.0,0,0,0,0,109930,7193,434139,0.0,156813,551,0.09131187832064054,4463,125,42,14,181,12207,0.024494189081567117,2730,0,83,0,0.03707829481372263,0,689,0,133,56,0,878,556,0.028728551651535417,240511,83698,
0,0.0,0,0,0,0,109930,7193,434139,0.0,156813,551,0.09131187832064054,4463,10,3,4,17,12207,0.024494189081567117,2730,0,7,0,0.18033033033033033,0,689,0,133,56,0,878,556,0.028728551651535417,240511,83698,
0,0.0,0,0,0,0,109930,7193,434139,0.0,156813,551,0.09131187832064054,4463,10,3,4,17,12207,0.024494189081567117,2730,0,7,0,0.18033033033033033,0,689,0,133,56,0,878,556,0.028728551651535417,240511,83698,
0,0.0,0,0,0,0,109930,7193,434139,0.0,156813,551,0.09131187832064054,4463,10,3,4,17,12207,0.024494189081567117,2730,0,7,0,0.18033033033033033,0,689,0,133,56,0,878,556,0.028728551651535417,240511,83698,
27,0.0,4,32,-5,63,109930,7193,434139,0.02662554790427327,156813,551,0.09131187832064054,4463,24,5,4,33,12207,0.024494189081567117,2730,0,19,0,0.03334507841803778,0,3113,0,306,788,0,4207,2807,0.05428104336755272,240511,83698,
27,0.0,4,32,-5,63,109930,7193,434139,0.02662554790427327,156813,551,0.09131187832064054,4463,81,3,0,84,12207,0.024494189081567117,2730,0,78,0,0.04107987644259927,0,3113,0,306,788,0,4207,2807,0.05428104336755272,240511,83698,
27,0.0,4,32,-5,63,109930,7193,434139,0.02662554790427327,156813,551,0.09131187832064054,4463,88,30,16,134,12207,0.024494189081567117,2730,0,58,0,0.11181129445094938,0,3113,0,306,788,0,4207,2807,0.05428104336755272,240511,83698,
27,0.0,4,32,-5,63,109930,7193,434139,0.02662554790427327,156813,551,0.09131187832064054,4463,88,30,16,134,12207,0.024494189081567117,2730,0,58,0,0.11181129445094938,0,3113,0,306,788,0,4207,2807,0.05428104336755272,240511,83698,
27,0.0,4,32,-5,63,109930,7193,434139,0.02662554790427327,156813,551,0.09131187832064054,4463,88,30,16,134,12207,0.024494189081567117,2730,0,58,0,0.11181129445094938,0,3113,0,306,788,0,4207,2807,0.05428104336755272,240511,83698,
27,0.0,4,32,-5,63,109930,7193,434139,0.02662554790427327,156813,551,0.09131187832064054,4463,8,7,46,61,12207,0.024494189081567117,2730,0,1,0,0.03255976244162707,0,3113,0,306,788,0,4207,2807,0.05428104336755272,240511,83698,
27,0.0,4,32,-5,63,109930,7193,434139,0.02662554790427327,156813,551,0.09131187832064054,4463,964,66,33,1063,12207,0.024494189081567117,2730,0,898,0,0.07872752102562441,0,3113,0,306,788,0,4207,2807,0.05428104336755272,240511,83698,
27,0.0,4,32,-5,63,109930,7193,434139,0.02662554790427327,156813,551,0.09131187832064054,4463,964,66,33,1063,12207,0.024494189081567117,2730,0,898,0,0.07872752102562441,0,3113,0,306,788,0,4207,2807,0.05428104336755272,240511,83698,
27,0.0,4,32,-5,63,109930,7193,434139,0.02662554790427327,156813,551,0.09131187832064054,4463,964,66,33,1063,12207,0.024494189081567117,2730,0,898,0,0.07872752102562441,0,3113,0,306,788,0,4207,2807,0.05428104336755272,240511,83698,
27,0.0,4,32,-5,63,109930,7193,434139,0.02662554790427327,156813,551,0.09131187832064054,4463,964,66,33,1063,12207,0.024494189081567117,2730,0,898,0,0.07872752102562441,0,3113,0,306,788,0,4207,2807,0.05428104336755272,240511,83698,
27,0.0,4,32,-5,63,109930,7193,434139,0.02662554790427327,156813,551,0.09131187832064054,4463,964,66,33,1063,12207,0.024494189081567117,2730,0,898,0,0.07872752102562441,0,3113,0,306,788,0,4207,2807,0.05428104336755272,240511,83698,
27,0.0,4,32,-5,63,109930,7193,434139,0.02662554790427327,156813,551,0.09131187832064054,4463,964,66,33,1063,12207,0.024494189081567117,2730,0,898,0,0.07872752102562441,0,3113,0,306,788,0,4207,2807,0.05428104336755272,240511,83698,
27,0.0,4,32,-5,63,109930,7193,434139,0.02662554790427327,156813,551,0.09131187832064054,4463,964,66,33,1063,12207,0.024494189081567117,2730,0,898,0,0.07872752102562441,0,3113,0,306,788,0,4207,2807,0.05428104336755272,240511,83698,
27,0.0,4,32,-5,63,109930,7193,434139,0.02662554790427327,156813,551,0.09131187832064054,4463,964,66,33,1063,12207,0.024494189081567117,2730,0,898,0,0.07872752102562441,0,3113,0,306,788,0,4207,2807,0.05428104336755272,240511,83698,
27,0.0,4,32,-5,63,109930,7193,434139,0.02662554790427327,156813,551,0.09131187832064054,4463,964,66,33,1063,12207,0.024494189081567117,2730,0,898,0,0.07872752102562441,0,3113,0,306,788,0,4207,2807,0.05428104336755272,240511,83698,
27,0.0,4,32,-5,63,109930,7193,434139,0.02662554790427327,156813,551,0.09131187832064054,4463,964,66,33,1063,12207,0.024494189081567117,2730,0,898,0,0.07872752102562441,0,3113,0,306,788,0,4207,2807,0.05428104336755272,240511,83698,
27,0.0,4,32,-5,63,109930,7193,434139,0.02662554790427327,156813,551,0.09131187832064054,4463,964,66,33,1063,12207,0.024494189081567117,2730,0,898,0,0.07872752102562441,0,3113,0,306,788,0,4207,2807,0.05428104336755272,240511,83698,
27,0.0,4,32,-5,63,109930,7193,434139,0.02662554790427327,156813,551,0.09131187832064054,4463,964,66,33,1063,12207,0.024494189081567117,2730,0,898,0,0.07872752102562441,0,3113,0,306,788,0,4207,2807,0.05428104336755272,240511,83698,
27,0.0,4,32,-5,63,109930,7193,434139,0.02662554790427327,156813,551,0.09131187832064054,4463,964,66,33,1063,12207,0.024494189081567117,2730,0,898,0,0.07872752102562441,0,3113,0,306,788,0,4207,2807,0.05428104336755272,240511,83698,
27,0.0,4,32,-5,63,109930,7193,434139,0.02662554790427327,156813,551,0.09131187832064054,4463,964,66,33,1063,12207,0.024494189081567117,2730,0,898,0,0.07872752102562441,0,3113,0,306,788,0,4207,2807,0.05428104336755272,240511,83698,
27,0.0,4,32,-5,63,109930,7193,434139,0.02662554790427327,156813,551,0.09131187832064054,4463,964,66,33,1063,12207,0.024494189081567117,2730,0,898,0,0.07872752102562441,0,3113,0,306,788,0,4207,2807,0.05428104336755272,240511,83698,
27,0.0,4,32,-5,63,109930,7193,434139,0.02662554790427327,156813,551,0.09131187832064054,4463,964,66,33,1063,12207,0.024494189081567117,2730,0,898,0,0.07872752102562441,0,3113,0,306,788,0,4207,2807,0.05428104336755272,240511,83698,
27,0.0,4,32,-5,63,109930,7193,434139,0.02662554790427327,156813,551,0.09131187832064054,4463,964,66,33,1063,12207,0.024494189081567117,2730,0,898,0,0.07872752102562441,0,3113,0,306,788,0,4207,2807,0.05428104336755272,240511,83698,
27,0.014598540145985401,4,32,-5,63,109930,7193,434139,0.02662554790427327,156813,551,0.09131187832064054,4463,553,23,17,593,12207,0.024494189081567117,2730,3,530,1,0.07064272328340689,4,3113,0,306,788,-2,4207,2807,0.05428104336755272,240511,83698,
27,0.3077956989247312,4,32,-5,63,109930,7193,434139,0.02662554790427327,156813,551,0.09131187832064054,4463,820,51,49,920,12207,0.024494189081567117,2730,25,769,2,0.10331252860701032,31,3113,4,306,788,-23,4207,2807,0.05428104336755272,240511,83698,
27,0.3077956989247312,4,32,-5,63,109930,7193,434139,0.02662554790427327,156813,551,0.09131187832064054,4463,820,51,49,920,12207,0.024494189081567117,2730,25,769,2,0.10331252860701032,31,3113,4,306,788,-23,4207,2807,0.05428104336755272,240511,83698,
27,0.3077956989247312,4,32,-5,63,109930,7193,434139,0.02662554790427327,156813,551,0.09131187832064054,4463,820,51,49,920,12207,0.024494189081567117,2730,25,769,2,0.10331252860701032,31,3113,4,306,788,-23,4207,2807,0.05428104336755272,240511,83698,
27,0.3077956989247312,4,32,-5,63,109930,7193,434139,0.02662554790427327,156813,551,0.09131187832064054,4463,820,51,49,920,12207,0.024494189081567117,2730,25,769,2,0.10331252860701032,31,3113,4,306,788,-23,4207,2807,0.05428104336755272,240511,83698,
27,0.3077956989247312,4,32,-5,63,109930,7193,434139,0.02662554790427327,156813,551,0.09131187832064054,4463,820,51,49,920,12207,0.024494189081567117,2730,25,769,2,0.10331252860701032,31,3113,4,306,788,-23,4207,2807,0.05428104336755272,240511,83698,
27,0.0,4,32,-5,63,109930,7193,434139,0.02662554790427327,156813,551,0.09131187832064054,4463,174,5,7,186,12207,0.024494189081567117,2730,0,169,0,3.741144395999428E-4,0,3113,0,306,788,0,4207,2807,0.05428104336755272,240511,83698,
27,0.0,4,32,-5,63,109930,7193,434139,0.02662554790427327,156813,551,0.09131187832064054,4463,60,7,0,67,12207,0.024494189081567117,2730,0,53,0,0.004919842942909651,0,3113,0,306,788,0,4207,2807,0.05428104336755272,240511,83698,
21,0.0,4,6,15,31,109930,7193,434139,0.08395852870688757,156813,551,0.09131187832064054,4463,361,81,300,742,12207,0.024494189081567117,2730,0,280,0,0.08337584373678737,0,1431,0,236,760,0,2427,1195,0.15956329213651577,240511,83698,
21,0.00437636761487965,4,6,15,31,109930,7193,434139,0.08395852870688757,156813,551,0.09131187832064054,4463,586,77,30,693,12207,0.024494189081567117,2730,1,509,1,0.09249059849837886,2,1431,0,236,760,0,2427,1195,0.15956329213651577,240511,83698,
21,0.00437636761487965,4,6,15,31,109930,7193,434139,0.08395852870688757,156813,551,0.09131187832064054,4463,586,77,30,693,12207,0.024494189081567117,2730,1,509,1,0.09249059849837886,2,1431,0,236,760,0,2427,1195,0.15956329213651577,240511,83698,
21,0.00437636761487965,4,6,15,31,109930,7193,434139,0.08395852870688757,156813,551,0.09131187832064054,4463,586,77,30,693,12207,0.024494189081567117,2730,1,509,1,0.09249059849837886,2,1431,0,236,760,0,2427,1195,0.15956329213651577,240511,83698,
21,0.00437636761487965,4,6,15,31,109930,7193,434139,0.08395852870688757,156813,551,0.09131187832064054,4463,586,77,30,693,12207,0.024494189081567117,2730,1,509,1,0.09249059849837886,2,1431,0,236,760,0,2427,1195,0.15956329213651577,240511,83698,
21,0.45,4,6,15,31,109930,7193,434139,0.08395852870688757,156813,551,0.09131187832064054,4463,324,29,4,357,12207,0.024494189081567117,2730,4,295,19,0.2368431747412747,27,1431,4,236,760,15,2427,1195,0.15956329213651577,240511,83698,
3,0.0,0,5,-2,8,109930,7193,434139,0.0025807066092405915,156813,551,0.09131187832064054,4463,39,49,966,1054,12207,0.024494189081567117,2730,0,-10,0,0.055447612319132505,0,1767,0,442,2888,0,5097,1325,0.039122582523365174,240511,83698,
3,0.0,0,5,-2,8,109930,7193,434139,0.0025807066092405915,156813,551,0.09131187832064054,4463,39,49,966,1054,12207,0.024494189081567117,2730,0,-10,0,0.055447612319132505,0,1767,0,442,2888,0,5097,1325,0.039122582523365174,240511,83698,
3,0.0,0,5,-2,8,109930,7193,434139,0.0025807066092405915,156813,551,0.09131187832064054,4463,39,49,966,1054,12207,0.024494189081567117,2730,0,-10,0,0.055447612319132505,0,1767,0,442,2888,0,5097,1325,0.039122582523365174,240511,83698,
3,0.0,0,5,-2,8,109930,7193,434139,0.0025807066092405915,156813,551,0.09131187832064054,4463,39,49,966,1054,12207,0.024494189081567117,2730,0,-10,0,0.055447612319132505,0,1767,0,442,2888,0,5097,1325,0.039122582523365174,240511,83698,
3,0.0,0,5,-2,8,109930,7193,434139,0.0025807066092405915,156813,551,0.09131187832064054,4463,39,49,966,1054,12207,0.024494189081567117,2730,0,-10,0,0.055447612319132505,0,1767,0,442,2888,0,5097,1325,0.039122582523365174,240511,83698,
3,0.0,0,5,-2,8,109930,7193,434139,0.0025807066092405915,156813,551,0.09131187832064054,4463,1,53,169,223,12207,0.024494189081567117,2730,0,-52,0,0.07049524638664992,0,1767,0,442,2888,0,5097,1325,0.039122582523365174,240511,83698,
59,0.5238095238095238,0,22,37,81,109930,7193,434139,0.14825658451970755,156813,551,0.09131187832064054,4463,61,140,19,220,12207,0.024494189081567117,2730,8,-79,14,0.21150388300313436,22,609,0,293,304,6,1206,316,0.21801298008272874,240511,83698,
59,0.5238095238095238,0,22,37,81,109930,7193,434139,0.14825658451970755,156813,551,0.09131187832064054,4463,61,140,19,220,12207,0.024494189081567117,2730,8,-79,14,0.21150388300313436,22,609,0,293,304,6,1206,316,0.21801298008272874,240511,83698,
59,0.23076923076923078,0,22,37,81,109930,7193,434139,0.14825658451970755,156813,551,0.09131187832064054,4463,119,59,61,239,12207,0.024494189081567117,2730,2,60,4,0.23912250747498282,6,609,0,293,304,2,1206,316,0.21801298008272874,240511,83698,
59,0.23076923076923078,0,22,37,81,109930,7193,434139,0.14825658451970755,156813,551,0.09131187832064054,4463,119,59,61,239,12207,0.024494189081567117,2730,2,60,4,0.23912250747498282,6,609,0,293,304,2,1206,316,0.21801298008272874,240511,83698,
59,0.23076923076923078,0,22,37,81,109930,7193,434139,0.14825658451970755,156813,551,0.09131187832064054,4463,119,59,61,239,12207,0.024494189081567117,2730,2,60,4,0.23912250747498282,6,609,0,293,304,2,1206,316,0.21801298008272874,240511,83698,
59,0.23076923076923078,0,22,37,81,109930,7193,434139,0.14825658451970755,156813,551,0.09131187832064054,4463,119,59,61,239,12207,0.024494189081567117,2730,2,60,4,0.23912250747498282,6,609,0,293,304,2,1206,316,0.21801298008272874,240511,83698,
59,0.0,0,22,37,81,109930,7193,434139,0.14825658451970755,156813,551,0.09131187832064054,4463,88,20,207,315,12207,0.024494189081567117,2730,0,68,0,0.13515020377585793,0,609,0,293,304,0,1206,316,0.21801298008272874,240511,83698,
59,0.0,0,22,37,81,109930,7193,434139,0.14825658451970755,156813,551,0.09131187832064054,4463,88,20,207,315,12207,0.024494189081567117,2730,0,68,0,0.13515020377585793,0,609,0,293,304,0,1206,316,0.21801298008272874,240511,83698,
59,0.0,0,22,37,81,109930,7193,434139,0.14825658451970755,156813,551,0.09131187832064054,4463,88,20,207,315,12207,0.024494189081567117,2730,0,68,0,0.13515020377585793,0,609,0,293,304,0,1206,316,0.21801298008272874,240511,83698,
8,0.3333333333333333,0,9,-1,17,109930,7193,434139,0.16794871794871793,156813,551,0.09131187832064054,4463,158,22,0,180,12207,0.024494189081567117,2730,4,136,3,0.17006281341370072,7,376,0,60,26,-1,462,316,0.08947832051797436,240511,83698,
3,0.0036363636363636364,0,5,-2,8,109930,7193,434139,0.006956312238997751,156813,551,0.09131187832064054,4463,842,55,5,902,12207,0.024494189081567117,2730,2,787,1,0.148013013746052,3,2459,0,391,796,-1,3646,2068,0.039942651725339784,240511,83698,
3,0.0035335689045936395,0,5,-2,8,109930,7193,434139,0.006956312238997751,156813,551,0.09131187832064054,4463,670,58,0,728,12207,0.024494189081567117,2730,2,612,1,0.05607325507049541,3,2459,0,391,796,-1,3646,2068,0.039942651725339784,240511,83698,
3,0.0035335689045936395,0,5,-2,8,109930,7193,434139,0.006956312238997751,156813,551,0.09131187832064054,4463,670,58,0,728,12207,0.024494189081567117,2730,2,612,1,0.05607325507049541,3,2459,0,391,796,-1,3646,2068,0.039942651725339784,240511,83698,
25,0.005509641873278237,0,25,0,50,109930,7193,434139,0.009937809808555177,156813,551,0.09131187832064054,4463,4,4,201,209,12207,0.024494189081567117,2730,1,0,1,0.003326453312293865,2,767,0,221,615,0,1603,546,0.06617766440106616,240511,83698,
25,0.005509641873278237,0,25,0,50,109930,7193,434139,0.009937809808555177,156813,551,0.09131187832064054,4463,4,4,201,209,12207,0.024494189081567117,2730,1,0,1,0.003326453312293865,2,767,0,221,615,0,1603,546,0.06617766440106616,240511,83698,
25,0.005509641873278237,0,25,0,50,109930,7193,434139,0.009937809808555177,156813,551,0.09131187832064054,4463,4,4,201,209,12207,0.024494189081567117,2730,1,0,1,0.003326453312293865,2,767,0,221,615,0,1603,546,0.06617766440106616,240511,83698,
25,0.005509641873278237,0,25,0,50,109930,7193,434139,0.009937809808555177,156813,551,0.09131187832064054,4463,4,4,201,209,12207,0.024494189081567117,2730,1,0,1,0.003326453312293865,2,767,0,221,615,0,1603,546,0.06617766440106616,240511,83698,
25,0.005509641873278237,0,25,0,50,109930,7193,434139,0.009937809808555177,156813,551,0.09131187832064054,4463,4,4,201,209,12207,0.024494189081567117,2730,1,0,1,0.003326453312293865,2,767,0,221,615,0,1603,546,0.06617766440106616,240511,83698,
25,0.005509641873278237,0,25,0,50,109930,7193,434139,0.009937809808555177,156813,551,0.09131187832064054,4463,4,4,201,209,12207,0.024494189081567117,2730,1,0,1,0.003326453312293865,2,767,0,221,615,0,1603,546,0.06617766440106616,240511,83698,
25,0.0,0,25,0,50,109930,7193,434139,0.009937809808555177,156813,551,0.09131187832064054,4463,13,7,111,131,12207,0.024494189081567117,2730,0,6,0,0.016071582898068915,0,767,0,221,615,0,1603,546,0.06617766440106616,240511,83698,
25,0.11374407582938388,0,25,0,50,109930,7193,434139,0.009937809808555177,156813,551,0.09131187832064054,4463,74,29,61,164,12207,0.024494189081567117,2730,24,45,24,0.12446860792953378,48,767,0,221,615,0,1603,546,0.06617766440106616,240511,83698,
25,0.11374407582938388,0,25,0,50,109930,7193,434139,0.009937809808555177,156813,551,0.09131187832064054,4463,74,29,61,164,12207,0.024494189081567117,2730,24,45,24,0.12446860792953378,48,767,0,221,615,0,1603,546,0.06617766440106616,240511,83698,
25,0.11374407582938388,0,25,0,50,109930,7193,434139,0.009937809808555177,156813,551,0.09131187832064054,4463,74,29,61,164,12207,0.024494189081567117,2730,24,45,24,0.12446860792953378,48,767,0,221,615,0,1603,546,0.06617766440106616,240511,83698,
25,0.11374407582938388,0,25,0,50,109930,7193,434139,0.009937809808555177,156813,551,0.09131187832064054,4463,74,29,61,164,12207,0.024494189081567117,2730,24,45,24,0.12446860792953378,48,767,0,221,615,0,1603,546,0.06617766440106616,240511,83698,
0,0.0,0,0,0,0,109930,7193,434139,0.0,156813,551,0.09131187832064054,4463,91,14,2,107,12207,0.024494189081567117,2730,0,77,0,0.05656365204319701,0,91,0,14,2,0,107,77,0.05656365204319701,240511,83698,
0,0.0,0,0,0,0,109930,7193,434139,0.0,156813,551,0.09131187832064054,4463,51,0,0,51,12207,0.024494189081567117,2730,0,51,0,0.5,0,237,0,20,13,0,270,217,0.08851873344784843,240511,83698,
6,0.16041666666666665,0,6,0,12,109930,7193,434139,0.05887345679012345,156813,551,0.09131187832064054,4463,489,25,6,520,12207,0.024494189081567117,2730,2,464,3,0.40402425531328195,5,519,0,43,26,1,588,476,0.22763276931244483,240511,83698,
6,0.0,0,6,0,12,109930,7193,434139,0.05887345679012345,156813,551,0.09131187832064054,4463,25,12,20,57,12207,0.024494189081567117,2730,0,13,0,0.18743886743886745,0,519,0,43,26,0,588,476,0.22763276931244483,240511,83698,
60,0.5533980582524272,1,21,39,82,109930,7193,434139,0.02935615555147079,156813,551,0.09131187832064054,4463,48,10,0,58,12207,0.024494189081567117,2730,9,38,48,0.2959297983569828,57,4576,0,56,2,39,4634,4520,0.044484626774046306,240511,83698,
60,0.5533980582524272,1,21,39,82,109930,7193,434139,0.02935615555147079,156813,551,0.09131187832064054,4463,48,10,0,58,12207,0.024494189081567117,2730,9,38,48,0.2959297983569828,57,4576,0,56,2,39,4634,4520,0.044484626774046306,240511,83698,
60,0.5533980582524272,1,21,39,82,109930,7193,434139,0.02935615555147079,156813,551,0.09131187832064054,4463,48,10,0,58,12207,0.024494189081567117,2730,9,38,48,0.2959297983569828,57,4576,0,56,2,39,4634,4520,0.044484626774046306,240511,83698,
60,0.5533980582524272,1,21,39,82,109930,7193,434139,0.02935615555147079,156813,551,0.09131187832064054,4463,48,10,0,58,12207,0.024494189081567117,2730,9,38,48,0.2959297983569828,57,4576,0,56,2,39,4634,4520,0.044484626774046306,240511,83698,
60,0.0,1,21,39,82,109930,7193,434139,0.02935615555147079,156813,551,0.09131187832064054,4463,0,1,0,1,12207,0.024494189081567117,2730,0,-1,0,0.013513513513513514,0,4576,0,56,2,0,4634,4520,0.044484626774046306,240511,83698,
60,0.0,1,21,39,82,109930,7193,434139,0.02935615555147079,156813,551,0.09131187832064054,4463,0,1,0,1,12207,0.024494189081567117,2730,0,-1,0,0.013513513513513514,0,4576,0,56,2,0,4634,4520,0.044484626774046306,240511,83698,
60,0.0,1,21,39,82,109930,7193,434139,0.02935615555147079,156813,551,0.09131187832064054,4463,894,4,0,898,12207,0.024494189081567117,2730,0,890,0,0.15151049961941676,0,4576,0,56,2,0,4634,4520,0.044484626774046306,240511,83698,
60,0.0,1,21,39,82,109930,7193,434139,0.02935615555147079,156813,551,0.09131187832064054,4463,894,4,0,898,12207,0.024494189081567117,2730,0,890,0,0.15151049961941676,0,4576,0,56,2,0,4634,4520,0.044484626774046306,240511,83698,
60,0.0,1,21,39,82,109930,7193,434139,0.02935615555147079,156813,551,0.09131187832064054,4463,894,4,0,898,12207,0.024494189081567117,2730,0,890,0,0.15151049961941676,0,4576,0,56,2,0,4634,4520,0.044484626774046306,240511,83698,
60,0.0,1,21,39,82,109930,7193,434139,0.02935615555147079,156813,551,0.09131187832064054,4463,894,4,0,898,12207,0.024494189081567117,2730,0,890,0,0.15151049961941676,0,4576,0,56,2,0,4634,4520,0.044484626774046306,240511,83698,
60,0.0,1,21,39,82,109930,7193,434139,0.02935615555147079,156813,551,0.09131187832064054,4463,894,4,0,898,12207,0.024494189081567117,2730,0,890,0,0.15151049961941676,0,4576,0,56,2,0,4634,4520,0.044484626774046306,240511,83698,
60,0.0,1,21,39,82,109930,7193,434139,0.02935615555147079,156813,551,0.09131187832064054,4463,894,4,0,898,12207,0.024494189081567117,2730,0,890,0,0.15151049961941676,0,4576,0,56,2,0,4634,4520,0.044484626774046306,240511,83698,
60,0.0,1,21,39,82,109930,7193,434139,0.02935615555147079,156813,551,0.09131187832064054,4463,894,4,0,898,12207,0.024494189081567117,2730,0,890,0,0.15151049961941676,0,4576,0,56,2,0,4634,4520,0.044484626774046306,240511,83698,
60,0.0,1,21,39,82,109930,7193,434139,0.02935615555147079,156813,551,0.09131187832064054,4463,1055,4,0,1059,12207,0.024494189081567117,2730,0,1051,0,0.09785439227283366,0,4576,0,56,2,0,4634,4520,0.044484626774046306,240511,83698,
60,0.0,1,21,39,82,109930,7193,434139,0.02935615555147079,156813,551,0.09131187832064054,4463,1055,4,0,1059,12207,0.024494189081567117,2730,0,1051,0,0.09785439227283366,0,4576,0,56,2,0,4634,4520,0.044484626774046306,240511,83698,
60,0.0,1,21,39,82,109930,7193,434139,0.02935615555147079,156813,551,0.09131187832064054,4463,482,4,0,486,12207,0.024494189081567117,2730,0,478,0,0.055661078269858194,0,4576,0,56,2,0,4634,4520,0.044484626774046306,240511,83698,
60,0.0,1,21,39,82,109930,7193,434139,0.02935615555147079,156813,551,0.09131187832064054,4463,482,4,0,486,12207,0.024494189081567117,2730,0,478,0,0.055661078269858194,0,4576,0,56,2,0,4634,4520,0.044484626774046306,240511,83698,
60,0.0,1,21,39,82,109930,7193,434139,0.02935615555147079,156813,551,0.09131187832064054,4463,482,4,0,486,12207,0.024494189081567117,2730,0,478,0,0.055661078269858194,0,4576,0,56,2,0,4634,4520,0.044484626774046306,240511,83698,
60,0.0,1,21,39,82,109930,7193,434139,0.02935615555147079,156813,551,0.09131187832064054,4463,482,4,0,486,12207,0.024494189081567117,2730,0,478,0,0.055661078269858194,0,4576,0,56,2,0,4634,4520,0.044484626774046306,240511,83698,
60,0.0,1,21,39,82,109930,7193,434139,0.02935615555147079,156813,551,0.09131187832064054,4463,482,4,0,486,12207,0.024494189081567117,2730,0,478,0,0.055661078269858194,0,4576,0,56,2,0,4634,4520,0.044484626774046306,240511,83698,
60,0.0,1,21,39,82,109930,7193,434139,0.02935615555147079,156813,551,0.09131187832064054,4463,482,4,0,486,12207,0.024494189081567117,2730,0,478,0,0.055661078269858194,0,4576,0,56,2,0,4634,4520,0.044484626774046306,240511,83698,
60,0.0,1,21,39,82,109930,7193,434139,0.02935615555147079,156813,551,0.09131187832064054,4463,482,4,0,486,12207,0.024494189081567117,2730,0,478,0,0.055661078269858194,0,4576,0,56,2,0,4634,4520,0.044484626774046306,240511,83698,
60,0.0,1,21,39,82,109930,7193,434139,0.02935615555147079,156813,551,0.09131187832064054,4463,482,4,0,486,12207,0.024494189081567117,2730,0,478,0,0.055661078269858194,0,4576,0,56,2,0,4634,4520,0.044484626774046306,240511,83698,
60,0.0,1,21,39,82,109930,7193,434139,0.02935615555147079,156813,551,0.09131187832064054,4463,482,4,0,486,12207,0.024494189081567117,2730,0,478,0,0.055661078269858194,0,4576,0,56,2,0,4634,4520,0.044484626774046306,240511,83698,
60,0.0,1,21,39,82,109930,7193,434139,0.02935615555147079,156813,551,0.09131187832064054,4463,482,4,0,486,12207,0.024494189081567117,2730,0,478,0,0.055661078269858194,0,4576,0,56,2,0,4634,4520,0.044484626774046306,240511,83698,
60,0.0,1,21,39,82,109930,7193,434139,0.02935615555147079,156813,551,0.09131187832064054,4463,0,1,1,2,12207,0.024494189081567117,2730,0,-1,0,0.036274509803921565,0,4576,0,56,2,0,4634,4520,0.044484626774046306,240511,83698,
60,0.0,1,21,39,82,109930,7193,434139,0.02935615555147079,156813,551,0.09131187832064054,4463,0,1,1,2,12207,0.024494189081567117,2730,0,-1,0,0.036274509803921565,0,4576,0,56,2,0,4634,4520,0.044484626774046306,240511,83698,
60,0.0,1,21,39,82,109930,7193,434139,0.02935615555147079,156813,551,0.09131187832064054,4463,0,1,1,2,12207,0.024494189081567117,2730,0,-1,0,0.036274509803921565,0,4576,0,56,2,0,4634,4520,0.044484626774046306,240511,83698,
60,0.0,1,21,39,82,109930,7193,434139,0.02935615555147079,156813,551,0.09131187832064054,4463,342,2,0,344,12207,0.024494189081567117,2730,0,340,0,0.02921935790168139,0,4576,0,56,2,0,4634,4520,0.044484626774046306,240511,83698,
60,0.0,1,21,39,82,109930,7193,434139,0.02935615555147079,156813,551,0.09131187832064054,4463,342,2,0,344,12207,0.024494189081567117,2730,0,340,0,0.02921935790168139,0,4576,0,56,2,0,4634,4520,0.044484626774046306,240511,83698,
60,0.0,1,21,39,82,109930,7193,434139,0.02935615555147079,156813,551,0.09131187832064054,4463,342,2,0,344,12207,0.024494189081567117,2730,0,340,0,0.02921935790168139,0,4576,0,56,2,0,4634,4520,0.044484626774046306,240511,83698,
60,0.20833333333333334,1,21,39,82,109930,7193,434139,0.02935615555147079,156813,551,0.09131187832064054,4463,5,6,0,11,12207,0.024494189081567117,2730,5,-1,5,0.10659385113268609,10,4576,0,56,2,0,4634,4520,0.044484626774046306,240511,83698,
60,0.0,1,21,39,82,109930,7193,434139,0.02935615555147079,156813,551,0.09131187832064054,4463,0,1,0,1,12207,0.024494189081567117,2730,0,-1,0,0.004347826086956522,0,4576,0,56,2,0,4634,4520,0.044484626774046306,240511,83698,
60,0.0,1,21,39,82,109930,7193,434139,0.02935615555147079,156813,551,0.09131187832064054,4463,0,1,0,1,12207,0.024494189081567117,2730,0,-1,0,0.004347826086956522,0,4576,0,56,2,0,4634,4520,0.044484626774046306,240511,83698,
60,0.0,1,21,39,82,109930,7193,434139,0.02935615555147079,156813,551,0.09131187832064054,4463,0,1,0,1,12207,0.024494189081567117,2730,0,-1,0,0.004347826086956522,0,4576,0,56,2,0,4634,4520,0.044484626774046306,240511,83698,
60,0.0,1,21,39,82,109930,7193,434139,0.02935615555147079,156813,551,0.09131187832064054,4463,86,0,0,86,12207,0.024494189081567117,2730,0,86,0,0.007433658916068804,0,4576,0,56,2,0,4634,4520,0.044484626774046306,240511,83698,
60,0.0,1,21,39,82,109930,7193,434139,0.02935615555147079,156813,551,0.09131187832064054,4463,86,0,0,86,12207,0.024494189081567117,2730,0,86,0,0.007433658916068804,0,4576,0,56,2,0,4634,4520,0.044484626774046306,240511,83698,
60,0.0,1,21,39,82,109930,7193,434139,0.02935615555147079,156813,551,0.09131187832064054,4463,86,0,0,86,12207,0.024494189081567117,2730,0,86,0,0.007433658916068804,0,4576,0,56,2,0,4634,4520,0.044484626774046306,240511,83698,
0,0.0,0,0,0,0,109930,7193,434139,0.0,156813,551,0.09131187832064054,4463,0,1,0,1,12207,0.024494189081567117,2730,0,-1,0,0.004132231404958678,0,664,0,23,0,0,687,641,0.02190264593942428,240511,83698,
0,0.0,0,0,0,0,109930,7193,434139,0.0,156813,551,0.09131187832064054,4463,0,1,0,1,12207,0.024494189081567117,2730,0,-1,0,0.004132231404958678,0,664,0,23,0,0,687,641,0.02190264593942428,240511,83698,
0,0.0,0,0,0,0,109930,7193,434139,0.0,156813,551,0.09131187832064054,4463,0,1,0,1,12207,0.024494189081567117,2730,0,-1,0,0.004132231404958678,0,664,0,23,0,0,687,641,0.02190264593942428,240511,83698,
0,0.0,0,0,0,0,109930,7193,434139,0.0,156813,551,0.09131187832064054,4463,0,1,0,1,12207,0.024494189081567117,2730,0,-1,0,0.004132231404958678,0,664,0,23,0,0,687,641,0.02190264593942428,240511,83698,
0,0.0,0,0,0,0,109930,7193,434139,0.0,156813,551,0.09131187832064054,4463,0,1,0,1,12207,0.024494189081567117,2730,0,-1,0,0.004132231404958678,0,664,0,23,0,0,687,641,0.02190264593942428,240511,83698,
0,0.0,0,0,0,0,109930,7193,434139,0.0,156813,551,0.09131187832064054,4463,0,1,0,1,12207,0.024494189081567117,2730,0,-1,0,0.004132231404958678,0,664,0,23,0,0,687,641,0.02190264593942428,240511,83698,
0,0.0,0,0,0,0,109930,7193,434139,0.0,156813,551,0.09131187832064054,4463,474,21,0,495,12207,0.024494189081567117,2730,0,453,0,0.0867111281176747,0,664,0,23,0,0,687,641,0.02190264593942428,240511,83698,
0,0.0,0,0,0,0,109930,7193,434139,0.0,156813,551,0.09131187832064054,4463,474,21,0,495,12207,0.024494189081567117,2730,0,453,0,0.0867111281176747,0,664,0,23,0,0,687,641,0.02190264593942428,240511,83698,
0,0.0,0,0,0,0,109930,7193,434139,0.0,156813,551,0.09131187832064054,4463,474,21,0,495,12207,0.024494189081567117,2730,0,453,0,0.0867111281176747,0,664,0,23,0,0,687,641,0.02190264593942428,240511,83698,
0,0.0,0,0,0,0,109930,7193,434139,0.0,156813,551,0.09131187832064054,4463,474,21,0,495,12207,0.024494189081567117,2730,0,453,0,0.0867111281176747,0,664,0,23,0,0,687,641,0.02190264593942428,240511,83698,
0,0.0,0,0,0,0,109930,7193,434139,0.0,156813,551,0.09131187832064054,4463,474,21,0,495,12207,0.024494189081567117,2730,0,453,0,0.0867111281176747,0,664,0,23,0,0,687,641,0.02190264593942428,240511,83698,
0,0.0,0,0,0,0,109930,7193,434139,0.0,156813,551,0.09131187832064054,4463,474,21,0,495,12207,0.024494189081567117,2730,0,453,0,0.0867111281176747,0,664,0,23,0,0,687,641,0.02190264593942428,240511,83698,
0,0.0,0,0,0,0,109930,7193,434139,0.0,156813,551,0.09131187832064054,4463,474,21,0,495,12207,0.024494189081567117,2730,0,453,0,0.0867111281176747,0,664,0,23,0,0,687,641,0.02190264593942428,240511,83698,
0,0.0,0,0,0,0,109930,7193,434139,0.0,156813,551,0.09131187832064054,4463,474,21,0,495,12207,0.024494189081567117,2730,0,453,0,0.0867111281176747,0,664,0,23,0,0,687,641,0.02190264593942428,240511,83698,
10,0.0,0,10,0,20,109930,7193,434139,0.007971303308090873,156813,551,0.09131187832064054,4463,317,2,0,319,12207,0.024494189081567117,2730,0,315,0,0.0177521781457668,0,1556,0,26,0,0,1582,1530,0.020436826836138088,240511,83698,
10,0.0,0,10,0,20,109930,7193,434139,0.007971303308090873,156813,551,0.09131187832064054,4463,317,2,0,319,12207,0.024494189081567117,2730,0,315,0,0.0177521781457668,0,1556,0,26,0,0,1582,1530,0.020436826836138088,240511,83698,
10,0.0,0,10,0,20,109930,7193,434139,0.007971303308090873,156813,551,0.09131187832064054,4463,916,1,0,917,12207,0.024494189081567117,2730,0,915,0,0.09774682971014492,0,1556,0,26,0,0,1582,1530,0.020436826836138088,240511,83698,
10,0.0,0,10,0,20,109930,7193,434139,0.007971303308090873,156813,551,0.09131187832064054,4463,0,1,0,1,12207,0.024494189081567117,2730,0,-1,0,0.0033112582781456954,0,1556,0,26,0,0,1582,1530,0.020436826836138088,240511,83698,
10,0.0,0,10,0,20,109930,7193,434139,0.007971303308090873,156813,551,0.09131187832064054,4463,313,4,0,317,12207,0.024494189081567117,2730,0,309,0,0.02137984381906586,0,1556,0,26,0,0,1582,1530,0.020436826836138088,240511,83698,
10,0.0,0,10,0,20,109930,7193,434139,0.007971303308090873,156813,551,0.09131187832064054,4463,313,4,0,317,12207,0.024494189081567117,2730,0,309,0,0.02137984381906586,0,1556,0,26,0,0,1582,1530,0.020436826836138088,240511,83698,
10,0.0,0,10,0,20,109930,7193,434139,0.007971303308090873,156813,551,0.09131187832064054,4463,0,1,0,1,12207,0.024494189081567117,2730,0,-1,0,0.003067484662576687,0,1556,0,26,0,0,1582,1530,0.020436826836138088,240511,83698,
0,0.0,0,0,0,0,109930,7193,434139,0.0,156813,551,0.09131187832064054,4463,0,2,0,2,12207,0.024494189081567117,2730,0,-2,0,0.003898635477582846,0,166,0,21,0,0,187,145,0.008015651325491932,240511,83698,
0,0.0,0,0,0,0,109930,7193,434139,0.0,156813,551,0.09131187832064054,4463,0,2,0,2,12207,0.024494189081567117,2730,0,-2,0,0.003898635477582846,0,166,0,21,0,0,187,145,0.008015651325491932,240511,83698,
0,0.0,0,0,0,0,109930,7193,434139,0.0,156813,551,0.09131187832064054,4463,0,2,0,2,12207,0.024494189081567117,2730,0,-2,0,0.003898635477582846,0,166,0,21,0,0,187,145,0.008015651325491932,240511,83698,
0,0.0,0,0,0,0,109930,7193,434139,0.0,156813,551,0.09131187832064054,4463,0,2,0,2,12207,0.024494189081567117,2730,0,-2,0,0.003898635477582846,0,166,0,21,0,0,187,145,0.008015651325491932,240511,83698,
0,0.0,0,0,0,0,109930,7193,434139,0.0,156813,551,0.09131187832064054,4463,0,2,0,2,12207,0.024494189081567117,2730,0,-2,0,0.003898635477582846,0,166,0,21,0,0,187,145,0.008015651325491932,240511,83698,
0,0.0,0,0,0,0,109930,7193,434139,0.0,156813,551,0.09131187832064054,4463,0,2,0,2,12207,0.024494189081567117,2730,0,-2,0,0.0038022813688212928,0,166,0,21,0,0,187,145,0.008015651325491932,240511,83698,
48,0.0,2,17,31,67,109930,7193,434139,0.026510069558250485,156813,551,0.09131187832064054,4463,211,4,0,215,12207,0.024494189081567117,2730,0,207,0,0.07761234376139742,0,3679,0,168,8,0,3855,3511,0.05132064202972213,240511,83698,
48,0.017699115044247787,2,17,31,67,109930,7193,434139,0.026510069558250485,156813,551,0.09131187832064054,4463,275,1,0,276,12207,0.024494189081567117,2730,1,274,1,0.01474431248103272,2,3679,0,168,8,0,3855,3511,0.05132064202972213,240511,83698,
48,0.017699115044247787,2,17,31,67,109930,7193,434139,0.026510069558250485,156813,551,0.09131187832064054,4463,275,1,0,276,12207,0.024494189081567117,2730,1,274,1,0.01474431248103272,2,3679,0,168,8,0,3855,3511,0.05132064202972213,240511,83698,
48,0.017699115044247787,2,17,31,67,109930,7193,434139,0.026510069558250485,156813,551,0.09131187832064054,4463,275,1,0,276,12207,0.024494189081567117,2730,1,274,1,0.01474431248103272,2,3679,0,168,8,0,3855,3511,0.05132064202972213,240511,83698,
48,0.0,2,17,31,67,109930,7193,434139,0.026510069558250485,156813,551,0.09131187832064054,4463,28,25,2,55,12207,0.024494189081567117,2730,0,3,0,0.08678082593276472,0,3679,0,168,8,0,3855,3511,0.05132064202972213,240511,83698,
48,0.0,2,17,31,67,109930,7193,434139,0.026510069558250485,156813,551,0.09131187832064054,4463,28,25,2,55,12207,0.024494189081567117,2730,0,3,0,0.08678082593276472,0,3679,0,168,8,0,3855,3511,0.05132064202972213,240511,83698,
48,0.0,2,17,31,67,109930,7193,434139,0.026510069558250485,156813,551,0.09131187832064054,4463,28,25,2,55,12207,0.024494189081567117,2730,0,3,0,0.08678082593276472,0,3679,0,168,8,0,3855,3511,0.05132064202972213,240511,83698,
48,0.0,2,17,31,67,109930,7193,434139,0.026510069558250485,156813,551,0.09131187832064054,4463,28,25,2,55,12207,0.024494189081567117,2730,0,3,0,0.08678082593276472,0,3679,0,168,8,0,3855,3511,0.05132064202972213,240511,83698,
48,0.0,2,17,31,67,109930,7193,434139,0.026510069558250485,156813,551,0.09131187832064054,4463,28,25,2,55,12207,0.024494189081567117,2730,0,3,0,0.08678082593276472,0,3679,0,168,8,0,3855,3511,0.05132064202972213,240511,83698,
48,0.0,2,17,31,67,109930,7193,434139,0.026510069558250485,156813,551,0.09131187832064054,4463,28,25,2,55,12207,0.024494189081567117,2730,0,3,0,0.08678082593276472,0,3679,0,168,8,0,3855,3511,0.05132064202972213,240511,83698,
48,0.0,2,17,31,67,109930,7193,434139,0.026510069558250485,156813,551,0.09131187832064054,4463,28,25,2,55,12207,0.024494189081567117,2730,0,3,0,0.08678082593276472,0,3679,0,168,8,0,3855,3511,0.05132064202972213,240511,83698,
48,0.0,2,17,31,67,109930,7193,434139,0.026510069558250485,156813,551,0.09131187832064054,4463,26,20,2,48,12207,0.024494189081567117,2730,0,6,0,0.05765511647532184,0,3679,0,168,8,0,3855,3511,0.05132064202972213,240511,83698,
48,0.0,2,17,31,67,109930,7193,434139,0.026510069558250485,156813,551,0.09131187832064054,4463,26,20,2,48,12207,0.024494189081567117,2730,0,6,0,0.05765511647532184,0,3679,0,168,8,0,3855,3511,0.05132064202972213,240511,83698,
48,0.0,2,17,31,67,109930,7193,434139,0.026510069558250485,156813,551,0.09131187832064054,4463,392,2,0,394,12207,0.024494189081567117,2730,0,390,0,0.010075557073635492,0,3679,0,168,8,0,3855,3511,0.05132064202972213,240511,83698,
48,0.0,2,17,31,67,109930,7193,434139,0.026510069558250485,156813,551,0.09131187832064054,4463,392,2,0,394,12207,0.024494189081567117,2730,0,390,0,0.010075557073635492,0,3679,0,168,8,0,3855,3511,0.05132064202972213,240511,83698,
0,0.0,0,0,0,0,109930,7193,434139,0.0,156813,551,0.09131187832064054,4463,182,179,1,362,12207,0.024494189081567117,2730,0,3,0,0.270172978802838,0,182,0,179,1,0,362,3,0.270172978802838,240511,83698,
0,0.0,0,0,0,0,109930,7193,434139,0.0,156813,551,0.09131187832064054,4463,182,179,1,362,12207,0.024494189081567117,2730,0,3,0,0.270172978802838,0,182,0,179,1,0,362,3,0.270172978802838,240511,83698,
12,0.0,0,13,-1,25,109930,7193,434139,0.010141332619592285,156813,551,0.09131187832064054,4463,1033,1851,78,2962,12207,0.024494189081567117,2730,0,-818,0,0.23004296242876135,0,5018,0,8692,1030,0,14740,-3674,0.14361777612212243,240511,83698,
12,0.0,0,13,-1,25,109930,7193,434139,0.010141332619592285,156813,551,0.09131187832064054,4463,1033,1851,78,2962,12207,0.024494189081567117,2730,0,-818,0,0.23004296242876135,0,5018,0,8692,1030,0,14740,-3674,0.14361777612212243,240511,83698,
12,0.0,0,13,-1,25,109930,7193,434139,0.010141332619592285,156813,551,0.09131187832064054,4463,1033,1851,78,2962,12207,0.024494189081567117,2730,0,-818,0,0.23004296242876135,0,5018,0,8692,1030,0,14740,-3674,0.14361777612212243,240511,83698,
12,0.0,0,13,-1,25,109930,7193,434139,0.010141332619592285,156813,551,0.09131187832064054,4463,1033,1851,78,2962,12207,0.024494189081567117,2730,0,-818,0,0.23004296242876135,0,5018,0,8692,1030,0,14740,-3674,0.14361777612212243,240511,83698,
12,0.0,0,13,-1,25,109930,7193,434139,0.010141332619592285,156813,551,0.09131187832064054,4463,1033,1851,78,2962,12207,0.024494189081567117,2730,0,-818,0,0.23004296242876135,0,5018,0,8692,1030,0,14740,-3674,0.14361777612212243,240511,83698,
12,0.0,0,13,-1,25,109930,7193,434139,0.010141332619592285,156813,551,0.09131187832064054,4463,1033,1851,78,2962,12207,0.024494189081567117,2730,0,-818,0,0.23004296242876135,0,5018,0,8692,1030,0,14740,-3674,0.14361777612212243,240511,83698,
12,0.0,0,13,-1,25,109930,7193,434139,0.010141332619592285,156813,551,0.09131187832064054,4463,1033,1851,78,2962,12207,0.024494189081567117,2730,0,-818,0,0.23004296242876135,0,5018,0,8692,1030,0,14740,-3674,0.14361777612212243,240511,83698,
12,0.0,0,13,-1,25,109930,7193,434139,0.010141332619592285,156813,551,0.09131187832064054,4463,1033,1851,78,2962,12207,0.024494189081567117,2730,0,-818,0,0.23004296242876135,0,5018,0,8692,1030,0,14740,-3674,0.14361777612212243,240511,83698,
12,0.0,0,13,-1,25,109930,7193,434139,0.010141332619592285,156813,551,0.09131187832064054,4463,1033,1851,78,2962,12207,0.024494189081567117,2730,0,-818,0,0.23004296242876135,0,5018,0,8692,1030,0,14740,-3674,0.14361777612212243,240511,83698,
12,0.0,0,13,-1,25,109930,7193,434139,0.010141332619592285,156813,551,0.09131187832064054,4463,1033,1851,78,2962,12207,0.024494189081567117,2730,0,-818,0,0.23004296242876135,0,5018,0,8692,1030,0,14740,-3674,0.14361777612212243,240511,83698,
12,0.0,0,13,-1,25,109930,7193,434139,0.010141332619592285,156813,551,0.09131187832064054,4463,1033,1851,78,2962,12207,0.024494189081567117,2730,0,-818,0,0.23004296242876135,0,5018,0,8692,1030,0,14740,-3674,0.14361777612212243,240511,83698,
12,0.006309148264984227,0,13,-1,25,109930,7193,434139,0.010141332619592285,156813,551,0.09131187832064054,4463,130,507,11,648,12207,0.024494189081567117,2730,4,-377,4,0.1298385248154158,8,5018,0,8692,1030,0,14740,-3674,0.14361777612212243,240511,83698,
12,0.07142857142857142,0,13,-1,25,109930,7193,434139,0.010141332619592285,156813,551,0.09131187832064054,4463,487,827,22,1336,12207,0.024494189081567117,2730,1,-340,0,0.1658159494648635,1,5018,0,8692,1030,-1,14740,-3674,0.14361777612212243,240511,83698,
12,0.0015408320493066256,0,13,-1,25,109930,7193,434139,0.010141332619592285,156813,551,0.09131187832064054,4463,969,1106,365,2440,12207,0.024494189081567117,2730,1,-137,1,0.1306684978671807,2,5018,0,8692,1030,0,14740,-3674,0.14361777612212243,240511,83698,
12,0.0015408320493066256,0,13,-1,25,109930,7193,434139,0.010141332619592285,156813,551,0.09131187832064054,4463,969,1106,365,2440,12207,0.024494189081567117,2730,1,-137,1,0.1306684978671807,2,5018,0,8692,1030,0,14740,-3674,0.14361777612212243,240511,83698,
12,0.0015408320493066256,0,13,-1,25,109930,7193,434139,0.010141332619592285,156813,551,0.09131187832064054,4463,969,1106,365,2440,12207,0.024494189081567117,2730,1,-137,1,0.1306684978671807,2,5018,0,8692,1030,0,14740,-3674,0.14361777612212243,240511,83698,
12,0.0015408320493066256,0,13,-1,25,109930,7193,434139,0.010141332619592285,156813,551,0.09131187832064054,4463,969,1106,365,2440,12207,0.024494189081567117,2730,1,-137,1,0.1306684978671807,2,5018,0,8692,1030,0,14740,-3674,0.14361777612212243,240511,83698,
12,0.0015255530129672007,0,13,-1,25,109930,7193,434139,0.010141332619592285,156813,551,0.09131187832064054,4463,249,476,11,736,12207,0.024494189081567117,2730,1,-227,1,0.08477537655421752,2,5018,0,8692,1030,0,14740,-3674,0.14361777612212243,240511,83698,
12,0.0015255530129672007,0,13,-1,25,109930,7193,434139,0.010141332619592285,156813,551,0.09131187832064054,4463,249,476,11,736,12207,0.024494189081567117,2730,1,-227,1,0.08477537655421752,2,5018,0,8692,1030,0,14740,-3674,0.14361777612212243,240511,83698,
12,0.0015255530129672007,0,13,-1,25,109930,7193,434139,0.010141332619592285,156813,551,0.09131187832064054,4463,249,476,11,736,12207,0.024494189081567117,2730,1,-227,1,0.08477537655421752,2,5018,0,8692,1030,0,14740,-3674,0.14361777612212243,240511,83698,
12,0.0015255530129672007,0,13,-1,25,109930,7193,434139,0.010141332619592285,156813,551,0.09131187832064054,4463,249,476,11,736,12207,0.024494189081567117,2730,1,-227,1,0.08477537655421752,2,5018,0,8692,1030,0,14740,-3674,0.14361777612212243,240511,83698,
12,0.003000750187546887,0,13,-1,25,109930,7193,434139,0.010141332619592285,156813,551,0.09131187832064054,4463,76,245,41,362,12207,0.024494189081567117,2730,2,-169,2,0.0986525161931618,4,5018,0,8692,1030,0,14740,-3674,0.14361777612212243,240511,83698,
12,0.0014858841010401188,0,13,-1,25,109930,7193,434139,0.010141332619592285,156813,551,0.09131187832064054,4463,508,483,5,996,12207,0.024494189081567117,2730,1,25,1,0.20118074364001975,2,5018,0,8692,1030,0,14740,-3674,0.14361777612212243,240511,83698,
12,0.0014858841010401188,0,13,-1,25,109930,7193,434139,0.010141332619592285,156813,551,0.09131187832064054,4463,508,483,5,996,12207,0.024494189081567117,2730,1,25,1,0.20118074364001975,2,5018,0,8692,1030,0,14740,-3674,0.14361777612212243,240511,83698,
12,0.0014858841010401188,0,13,-1,25,109930,7193,434139,0.010141332619592285,156813,551,0.09131187832064054,4463,508,483,5,996,12207,0.024494189081567117,2730,1,25,1,0.20118074364001975,2,5018,0,8692,1030,0,14740,-3674,0.14361777612212243,240511,83698,
12,0.0014858841010401188,0,13,-1,25,109930,7193,434139,0.010141332619592285,156813,551,0.09131187832064054,4463,508,483,5,996,12207,0.024494189081567117,2730,1,25,1,0.20118074364001975,2,5018,0,8692,1030,0,14740,-3674,0.14361777612212243,240511,83698,
12,0.0,0,13,-1,25,109930,7193,434139,0.010141332619592285,156813,551,0.09131187832064054,4463,692,1325,92,2109,12207,0.024494189081567117,2730,0,-633,0,0.13374682218911035,0,5018,0,8692,1030,0,14740,-3674,0.14361777612212243,240511,83698,
12,0.0,0,13,-1,25,109930,7193,434139,0.010141332619592285,156813,551,0.09131187832064054,4463,692,1325,92,2109,12207,0.024494189081567117,2730,0,-633,0,0.13374682218911035,0,5018,0,8692,1030,0,14740,-3674,0.14361777612212243,240511,83698,
12,0.0,0,13,-1,25,109930,7193,434139,0.010141332619592285,156813,551,0.09131187832064054,4463,692,1325,92,2109,12207,0.024494189081567117,2730,0,-633,0,0.13374682218911035,0,5018,0,8692,1030,0,14740,-3674,0.14361777612212243,240511,83698,
12,0.0,0,13,-1,25,109930,7193,434139,0.010141332619592285,156813,551,0.09131187832064054,4463,692,1325,92,2109,12207,0.024494189081567117,2730,0,-633,0,0.13374682218911035,0,5018,0,8692,1030,0,14740,-3674,0.14361777612212243,240511,83698,
12,0.029850746268656716,0,13,-1,25,109930,7193,434139,0.010141332619592285,156813,551,0.09131187832064054,4463,581,864,267,1712,12207,0.024494189081567117,2730,1,-283,1,0.10841830023347498,2,5018,0,8692,1030,0,14740,-3674,0.14361777612212243,240511,83698,
12,0.029850746268656716,0,13,-1,25,109930,7193,434139,0.010141332619592285,156813,551,0.09131187832064054,4463,581,864,267,1712,12207,0.024494189081567117,2730,1,-283,1,0.10841830023347498,2,5018,0,8692,1030,0,14740,-3674,0.14361777612212243,240511,83698,
12,0.029850746268656716,0,13,-1,25,109930,7193,434139,0.010141332619592285,156813,551,0.09131187832064054,4463,581,864,267,1712,12207,0.024494189081567117,2730,1,-283,1,0.10841830023347498,2,5018,0,8692,1030,0,14740,-3674,0.14361777612212243,240511,83698,
12,0.029850746268656716,0,13,-1,25,109930,7193,434139,0.010141332619592285,156813,551,0.09131187832064054,4463,581,864,267,1712,12207,0.024494189081567117,2730,1,-283,1,0.10841830023347498,2,5018,0,8692,1030,0,14740,-3674,0.14361777612212243,240511,83698,
12,0.029850746268656716,0,13,-1,25,109930,7193,434139,0.010141332619592285,156813,551,0.09131187832064054,4463,581,864,267,1712,12207,0.024494189081567117,2730,1,-283,1,0.10841830023347498,2,5018,0,8692,1030,0,14740,-3674,0.14361777612212243,240511,83698,
12,0.0,0,13,-1,25,109930,7193,434139,0.010141332619592285,156813,551,0.09131187832064054,4463,63,2,61,126,12207,0.024494189081567117,2730,0,61,0,0.23104331639583436,0,5018,0,8692,1030,0,14740,-3674,0.14361777612212243,240511,83698,
12,0.0,0,13,-1,25,109930,7193,434139,0.010141332619592285,156813,551,0.09131187832064054,4463,7,30,0,37,12207,0.024494189081567117,2730,0,-23,0,0.1625874460032876,0,5018,0,8692,1030,0,14740,-3674,0.14361777612212243,240511,83698,
0,0.0,0,0,0,0,109930,7193,434139,0.0,156813,551,0.09131187832064054,4463,61,123,0,184,12207,0.024494189081567117,2730,0,-62,0,0.10046775983354087,0,902,0,2118,237,0,3257,-1216,0.09799757685557905,240511,83698,
0,0.0,0,0,0,0,109930,7193,434139,0.0,156813,551,0.09131187832064054,4463,61,123,0,184,12207,0.024494189081567117,2730,0,-62,0,0.10046775983354087,0,902,0,2118,237,0,3257,-1216,0.09799757685557905,240511,83698,
0,0.0,0,0,0,0,109930,7193,434139,0.0,156813,551,0.09131187832064054,4463,20,245,1,266,12207,0.024494189081567117,2730,0,-225,0,0.05555085510088957,0,902,0,2118,237,0,3257,-1216,0.09799757685557905,240511,83698,
0,0.0,0,0,0,0,109930,7193,434139,0.0,156813,551,0.09131187832064054,4463,79,197,0,276,12207,0.024494189081567117,2730,0,-118,0,0.059627471769205215,0,902,0,2118,237,0,3257,-1216,0.09799757685557905,240511,83698,
0,0.0,0,0,0,0,109930,7193,434139,0.0,156813,551,0.09131187832064054,4463,211,631,180,1022,12207,0.024494189081567117,2730,0,-420,0,0.10911995870419153,0,902,0,2118,237,0,3257,-1216,0.09799757685557905,240511,83698,
0,0.0,0,0,0,0,109930,7193,434139,0.0,156813,551,0.09131187832064054,4463,211,631,180,1022,12207,0.024494189081567117,2730,0,-420,0,0.10911995870419153,0,902,0,2118,237,0,3257,-1216,0.09799757685557905,240511,83698,
0,0.0,0,0,0,0,109930,7193,434139,0.0,156813,551,0.09131187832064054,4463,211,631,180,1022,12207,0.024494189081567117,2730,0,-420,0,0.10911995870419153,0,902,0,2118,237,0,3257,-1216,0.09799757685557905,240511,83698,
0,0.0,0,0,0,0,109930,7193,434139,0.0,156813,551,0.09131187832064054,4463,211,631,180,1022,12207,0.024494189081567117,2730,0,-420,0,0.10911995870419153,0,902,0,2118,237,0,3257,-1216,0.09799757685557905,240511,83698,
0,0.0,0,0,0,0,109930,7193,434139,0.0,156813,551,0.09131187832064054,4463,211,631,180,1022,12207,0.024494189081567117,2730,0,-420,0,0.10911995870419153,0,902,0,2118,237,0,3257,-1216,0.09799757685557905,240511,83698,
0,0.0,0,0,0,0,109930,7193,434139,0.0,156813,551,0.09131187832064054,4463,211,631,180,1022,12207,0.024494189081567117,2730,0,-420,0,0.10911995870419153,0,902,0,2118,237,0,3257,-1216,0.09799757685557905,240511,83698,
0,0.0,0,0,0,0,109930,7193,434139,0.0,156813,551,0.09131187832064054,4463,211,631,180,1022,12207,0.024494189081567117,2730,0,-420,0,0.10911995870419153,0,902,0,2118,237,0,3257,-1216,0.09799757685557905,240511,83698,
0,0.0,0,0,0,0,109930,7193,434139,0.0,156813,551,0.09131187832064054,4463,41,240,19,300,12207,0.024494189081567117,2730,0,-199,0,0.045783905447900806,0,902,0,2118,237,0,3257,-1216,0.09799757685557905,240511,83698,
0,0.0,0,0,0,0,109930,7193,434139,0.0,156813,551,0.09131187832064054,4463,41,240,19,300,12207,0.024494189081567117,2730,0,-199,0,0.045783905447900806,0,902,0,2118,237,0,3257,-1216,0.09799757685557905,240511,83698,
0,0.0,0,0,0,0,109930,7193,434139,0.0,156813,551,0.09131187832064054,4463,41,240,19,300,12207,0.024494189081567117,2730,0,-199,0,0.045783905447900806,0,902,0,2118,237,0,3257,-1216,0.09799757685557905,240511,83698,
0,0.0,0,0,0,0,109930,7193,434139,0.0,156813,551,0.09131187832064054,4463,86,271,19,376,12207,0.024494189081567117,2730,0,-185,0,0.09704754965141668,0,902,0,2118,237,0,3257,-1216,0.09799757685557905,240511,83698,
0,0.0,0,0,0,0,109930,7193,434139,0.0,156813,551,0.09131187832064054,4463,86,271,19,376,12207,0.024494189081567117,2730,0,-185,0,0.09704754965141668,0,902,0,2118,237,0,3257,-1216,0.09799757685557905,240511,83698,
0,0.0,0,0,0,0,109930,7193,434139,0.0,156813,551,0.09131187832064054,4463,86,271,19,376,12207,0.024494189081567117,2730,0,-185,0,0.09704754965141668,0,902,0,2118,237,0,3257,-1216,0.09799757685557905,240511,83698,
0,0.0,0,0,0,0,109930,7193,434139,0.0,156813,551,0.09131187832064054,4463,86,271,19,376,12207,0.024494189081567117,2730,0,-185,0,0.09704754965141668,0,902,0,2118,237,0,3257,-1216,0.09799757685557905,240511,83698,
0,0.0,0,0,0,0,109930,7193,434139,0.0,156813,551,0.09131187832064054,4463,86,271,19,376,12207,0.024494189081567117,2730,0,-185,0,0.09704754965141668,0,902,0,2118,237,0,3257,-1216,0.09799757685557905,240511,83698,
0,0.0,0,0,0,0,109930,7193,434139,0.0,156813,551,0.09131187832064054,4463,86,271,19,376,12207,0.024494189081567117,2730,0,-185,0,0.09704754965141668,0,902,0,2118,237,0,3257,-1216,0.09799757685557905,240511,83698,
0,0.0,0,0,0,0,109930,7193,434139,0.0,156813,551,0.09131187832064054,4463,259,254,11,524,12207,0.024494189081567117,2730,0,5,0,0.14513028083563878,0,902,0,2118,237,0,3257,-1216,0.09799757685557905,240511,83698,
0,0.0,0,0,0,0,109930,7193,434139,0.0,156813,551,0.09131187832064054,4463,259,254,11,524,12207,0.024494189081567117,2730,0,5,0,0.14513028083563878,0,902,0,2118,237,0,3257,-1216,0.09799757685557905,240511,83698,
0,0.0,0,0,0,0,109930,7193,434139,0.0,156813,551,0.09131187832064054,4463,259,254,11,524,12207,0.024494189081567117,2730,0,5,0,0.14513028083563878,0,902,0,2118,237,0,3257,-1216,0.09799757685557905,240511,83698,
0,0.0,0,0,0,0,109930,7193,434139,0.0,156813,551,0.09131187832064054,4463,259,254,11,524,12207,0.024494189081567117,2730,0,5,0,0.14513028083563878,0,902,0,2118,237,0,3257,-1216,0.09799757685557905,240511,83698,
0,0.0,0,0,0,0,109930,7193,434139,0.0,156813,551,0.09131187832064054,4463,259,254,11,524,12207,0.024494189081567117,2730,0,5,0,0.14513028083563878,0,902,0,2118,237,0,3257,-1216,0.09799757685557905,240511,83698,
0,0.0,0,0,0,0,109930,7193,434139,0.0,156813,551,0.09131187832064054,4463,46,69,7,122,12207,0.024494189081567117,2730,0,-23,0,0.0955858615490685,0,902,0,2118,237,0,3257,-1216,0.09799757685557905,240511,83698,
74,0.03296703296703297,0,64,10,138,109930,7193,434139,0.02633572821191866,156813,551,0.09131187832064054,4463,220,12,0,232,12207,0.024494189081567117,2730,2,208,1,0.12171007838639453,3,2967,0,238,1966,-1,5171,2729,0.048150140793961925,240511,83698,
74,0.03296703296703297,0,64,10,138,109930,7193,434139,0.02633572821191866,156813,551,0.09131187832064054,4463,220,12,0,232,12207,0.024494189081567117,2730,2,208,1,0.12171007838639453,3,2967,0,238,1966,-1,5171,2729,0.048150140793961925,240511,83698,
74,0.03296703296703297,0,64,10,138,109930,7193,434139,0.02633572821191866,156813,551,0.09131187832064054,4463,220,12,0,232,12207,0.024494189081567117,2730,2,208,1,0.12171007838639453,3,2967,0,238,1966,-1,5171,2729,0.048150140793961925,240511,83698,
74,0.03296703296703297,0,64,10,138,109930,7193,434139,0.02633572821191866,156813,551,0.09131187832064054,4463,220,12,0,232,12207,0.024494189081567117,2730,2,208,1,0.12171007838639453,3,2967,0,238,1966,-1,5171,2729,0.048150140793961925,240511,83698,
74,0.03296703296703297,0,64,10,138,109930,7193,434139,0.02633572821191866,156813,551,0.09131187832064054,4463,220,12,0,232,12207,0.024494189081567117,2730,2,208,1,0.12171007838639453,3,2967,0,238,1966,-1,5171,2729,0.048150140793961925,240511,83698,
74,0.03296703296703297,0,64,10,138,109930,7193,434139,0.02633572821191866,156813,551,0.09131187832064054,4463,220,12,0,232,12207,0.024494189081567117,2730,2,208,1,0.12171007838639453,3,2967,0,238,1966,-1,5171,2729,0.048150140793961925,240511,83698,
74,0.03296703296703297,0,64,10,138,109930,7193,434139,0.02633572821191866,156813,551,0.09131187832064054,4463,220,12,0,232,12207,0.024494189081567117,2730,2,208,1,0.12171007838639453,3,2967,0,238,1966,-1,5171,2729,0.048150140793961925,240511,83698,
74,0.03296703296703297,0,64,10,138,109930,7193,434139,0.02633572821191866,156813,551,0.09131187832064054,4463,220,12,0,232,12207,0.024494189081567117,2730,2,208,1,0.12171007838639453,3,2967,0,238,1966,-1,5171,2729,0.048150140793961925,240511,83698,
74,0.03296703296703297,0,64,10,138,109930,7193,434139,0.02633572821191866,156813,551,0.09131187832064054,4463,220,12,0,232,12207,0.024494189081567117,2730,2,208,1,0.12171007838639453,3,2967,0,238,1966,-1,5171,2729,0.048150140793961925,240511,83698,
74,0.03296703296703297,0,64,10,138,109930,7193,434139,0.02633572821191866,156813,551,0.09131187832064054,4463,220,12,0,232,12207,0.024494189081567117,2730,2,208,1,0.12171007838639453,3,2967,0,238,1966,-1,5171,2729,0.048150140793961925,240511,83698,
74,0.03296703296703297,0,64,10,138,109930,7193,434139,0.02633572821191866,156813,551,0.09131187832064054,4463,220,12,0,232,12207,0.024494189081567117,2730,2,208,1,0.12171007838639453,3,2967,0,238,1966,-1,5171,2729,0.048150140793961925,240511,83698,
74,0.03296703296703297,0,64,10,138,109930,7193,434139,0.02633572821191866,156813,551,0.09131187832064054,4463,220,12,0,232,12207,0.024494189081567117,2730,2,208,1,0.12171007838639453,3,2967,0,238,1966,-1,5171,2729,0.048150140793961925,240511,83698,
74,0.03296703296703297,0,64,10,138,109930,7193,434139,0.02633572821191866,156813,551,0.09131187832064054,4463,220,12,0,232,12207,0.024494189081567117,2730,2,208,1,0.12171007838639453,3,2967,0,238,1966,-1,5171,2729,0.048150140793961925,240511,83698,
74,0.03296703296703297,0,64,10,138,109930,7193,434139,0.02633572821191866,156813,551,0.09131187832064054,4463,220,12,0,232,12207,0.024494189081567117,2730,2,208,1,0.12171007838639453,3,2967,0,238,1966,-1,5171,2729,0.048150140793961925,240511,83698,
74,0.03296703296703297,0,64,10,138,109930,7193,434139,0.02633572821191866,156813,551,0.09131187832064054,4463,220,12,0,232,12207,0.024494189081567117,2730,2,208,1,0.12171007838639453,3,2967,0,238,1966,-1,5171,2729,0.048150140793961925,240511,83698,
74,0.03296703296703297,0,64,10,138,109930,7193,434139,0.02633572821191866,156813,551,0.09131187832064054,4463,220,12,0,232,12207,0.024494189081567117,2730,2,208,1,0.12171007838639453,3,2967,0,238,1966,-1,5171,2729,0.048150140793961925,240511,83698,
74,0.03296703296703297,0,64,10,138,109930,7193,434139,0.02633572821191866,156813,551,0.09131187832064054,4463,220,12,0,232,12207,0.024494189081567117,2730,2,208,1,0.12171007838639453,3,2967,0,238,1966,-1,5171,2729,0.048150140793961925,240511,83698,
74,0.03296703296703297,0,64,10,138,109930,7193,434139,0.02633572821191866,156813,551,0.09131187832064054,4463,220,12,0,232,12207,0.024494189081567117,2730,2,208,1,0.12171007838639453,3,2967,0,238,1966,-1,5171,2729,0.048150140793961925,240511,83698,
74,0.03296703296703297,0,64,10,138,109930,7193,434139,0.02633572821191866,156813,551,0.09131187832064054,4463,220,12,0,232,12207,0.024494189081567117,2730,2,208,1,0.12171007838639453,3,2967,0,238,1966,-1,5171,2729,0.048150140793961925,240511,83698,
74,0.03296703296703297,0,64,10,138,109930,7193,434139,0.02633572821191866,156813,551,0.09131187832064054,4463,220,12,0,232,12207,0.024494189081567117,2730,2,208,1,0.12171007838639453,3,2967,0,238,1966,-1,5171,2729,0.048150140793961925,240511,83698,
74,0.03296703296703297,0,64,10,138,109930,7193,434139,0.02633572821191866,156813,551,0.09131187832064054,4463,220,12,0,232,12207,0.024494189081567117,2730,2,208,1,0.12171007838639453,3,2967,0,238,1966,-1,5171,2729,0.048150140793961925,240511,83698,
74,0.03296703296703297,0,64,10,138,109930,7193,434139,0.02633572821191866,156813,551,0.09131187832064054,4463,220,12,0,232,12207,0.024494189081567117,2730,2,208,1,0.12171007838639453,3,2967,0,238,1966,-1,5171,2729,0.048150140793961925,240511,83698,
74,0.03296703296703297,0,64,10,138,109930,7193,434139,0.02633572821191866,156813,551,0.09131187832064054,4463,220,12,0,232,12207,0.024494189081567117,2730,2,208,1,0.12171007838639453,3,2967,0,238,1966,-1,5171,2729,0.048150140793961925,240511,83698,
74,0.03296703296703297,0,64,10,138,109930,7193,434139,0.02633572821191866,156813,551,0.09131187832064054,4463,220,12,0,232,12207,0.024494189081567117,2730,2,208,1,0.12171007838639453,3,2967,0,238,1966,-1,5171,2729,0.048150140793961925,240511,83698,
74,0.03296703296703297,0,64,10,138,109930,7193,434139,0.02633572821191866,156813,551,0.09131187832064054,4463,220,12,0,232,12207,0.024494189081567117,2730,2,208,1,0.12171007838639453,3,2967,0,238,1966,-1,5171,2729,0.048150140793961925,240511,83698,
74,0.03296703296703297,0,64,10,138,109930,7193,434139,0.02633572821191866,156813,551,0.09131187832064054,4463,220,12,0,232,12207,0.024494189081567117,2730,2,208,1,0.12171007838639453,3,2967,0,238,1966,-1,5171,2729,0.048150140793961925,240511,83698,
74,0.03296703296703297,0,64,10,138,109930,7193,434139,0.02633572821191866,156813,551,0.09131187832064054,4463,220,12,0,232,12207,0.024494189081567117,2730,2,208,1,0.12171007838639453,3,2967,0,238,1966,-1,5171,2729,0.048150140793961925,240511,83698,
74,0.03296703296703297,0,64,10,138,109930,7193,434139,0.02633572821191866,156813,551,0.09131187832064054,4463,220,12,0,232,12207,0.024494189081567117,2730,2,208,1,0.12171007838639453,3,2967,0,238,1966,-1,5171,2729,0.048150140793961925,240511,83698,
74,0.03296703296703297,0,64,10,138,109930,7193,434139,0.02633572821191866,156813,551,0.09131187832064054,4463,220,12,0,232,12207,0.024494189081567117,2730,2,208,1,0.12171007838639453,3,2967,0,238,1966,-1,5171,2729,0.048150140793961925,240511,83698,
74,0.03296703296703297,0,64,10,138,109930,7193,434139,0.02633572821191866,156813,551,0.09131187832064054,4463,220,12,0,232,12207,0.024494189081567117,2730,2,208,1,0.12171007838639453,3,2967,0,238,1966,-1,5171,2729,0.048150140793961925,240511,83698,
856,0.19593763686263313,24,264,592,1144,109930,7193,434139,0.03988400734856707,156813,551,0.09131187832064054,4463,1798,1217,1843,4858,12207,0.024494189081567117,2730,34,581,166,0.19353897540897405,204,8704,4,3324,5743,132,17771,5380,0.07210793682769204,240511,83698,
856,0.19593763686263313,24,264,592,1144,109930,7193,434139,0.03988400734856707,156813,551,0.09131187832064054,4463,1798,1217,1843,4858,12207,0.024494189081567117,2730,34,581,166,0.19353897540897405,204,8704,4,3324,5743,132,17771,5380,0.07210793682769204,240511,83698,
5,0.0,0,1,4,6,109930,7193,434139,0.029850746268656716,156813,551,0.09131187832064054,4463,818,22,1,841,12207,0.024494189081567117,2730,0,796,0,0.31167867070719796,0,1980,0,40,58,0,2078,1940,0.16233814803906702,240511,83698,
5,0.0,0,1,4,6,109930,7193,434139,0.029850746268656716,156813,551,0.09131187832064054,4463,818,22,1,841,12207,0.024494189081567117,2730,0,796,0,0.31167867070719796,0,1980,0,40,58,0,2078,1940,0.16233814803906702,240511,83698,
5,0.0,0,1,4,6,109930,7193,434139,0.029850746268656716,156813,551,0.09131187832064054,4463,818,22,1,841,12207,0.024494189081567117,2730,0,796,0,0.31167867070719796,0,1980,0,40,58,0,2078,1940,0.16233814803906702,240511,83698,
5,0.0,0,1,4,6,109930,7193,434139,0.029850746268656716,156813,551,0.09131187832064054,4463,818,22,1,841,12207,0.024494189081567117,2730,0,796,0,0.31167867070719796,0,1980,0,40,58,0,2078,1940,0.16233814803906702,240511,83698,
5,0.0,0,1,4,6,109930,7193,434139,0.029850746268656716,156813,551,0.09131187832064054,4463,818,22,1,841,12207,0.024494189081567117,2730,0,796,0,0.31167867070719796,0,1980,0,40,58,0,2078,1940,0.16233814803906702,240511,83698,
5,0.08955223880597014,0,1,4,6,109930,7193,434139,0.029850746268656716,156813,551,0.09131187832064054,4463,1161,17,51,1229,12207,0.024494189081567117,2730,1,1144,5,0.17097134351365836,6,1980,0,40,58,4,2078,1940,0.16233814803906702,240511,83698,
5,0.08955223880597014,0,1,4,6,109930,7193,434139,0.029850746268656716,156813,551,0.09131187832064054,4463,1161,17,51,1229,12207,0.024494189081567117,2730,1,1144,5,0.17097134351365836,6,1980,0,40,58,4,2078,1940,0.16233814803906702,240511,83698,
5,0.08955223880597014,0,1,4,6,109930,7193,434139,0.029850746268656716,156813,551,0.09131187832064054,4463,1161,17,51,1229,12207,0.024494189081567117,2730,1,1144,5,0.17097134351365836,6,1980,0,40,58,4,2078,1940,0.16233814803906702,240511,83698,
5,0.08955223880597014,0,1,4,6,109930,7193,434139,0.029850746268656716,156813,551,0.09131187832064054,4463,1161,17,51,1229,12207,0.024494189081567117,2730,1,1144,5,0.17097134351365836,6,1980,0,40,58,4,2078,1940,0.16233814803906702,240511,83698,
5,0.08955223880597014,0,1,4,6,109930,7193,434139,0.029850746268656716,156813,551,0.09131187832064054,4463,1161,17,51,1229,12207,0.024494189081567117,2730,1,1144,5,0.17097134351365836,6,1980,0,40,58,4,2078,1940,0.16233814803906702,240511,83698,
5,0.08955223880597014,0,1,4,6,109930,7193,434139,0.029850746268656716,156813,551,0.09131187832064054,4463,1161,17,51,1229,12207,0.024494189081567117,2730,1,1144,5,0.17097134351365836,6,1980,0,40,58,4,2078,1940,0.16233814803906702,240511,83698,
5,0.08955223880597014,0,1,4,6,109930,7193,434139,0.029850746268656716,156813,551,0.09131187832064054,4463,1161,17,51,1229,12207,0.024494189081567117,2730,1,1144,5,0.17097134351365836,6,1980,0,40,58,4,2078,1940,0.16233814803906702,240511,83698,
5,0.08955223880597014,0,1,4,6,109930,7193,434139,0.029850746268656716,156813,551,0.09131187832064054,4463,1161,17,51,1229,12207,0.024494189081567117,2730,1,1144,5,0.17097134351365836,6,1980,0,40,58,4,2078,1940,0.16233814803906702,240511,83698,
5,0.08955223880597014,0,1,4,6,109930,7193,434139,0.029850746268656716,156813,551,0.09131187832064054,4463,1161,17,51,1229,12207,0.024494189081567117,2730,1,1144,5,0.17097134351365836,6,1980,0,40,58,4,2078,1940,0.16233814803906702,240511,83698,
5,0.08955223880597014,0,1,4,6,109930,7193,434139,0.029850746268656716,156813,551,0.09131187832064054,4463,1161,17,51,1229,12207,0.024494189081567117,2730,1,1144,5,0.17097134351365836,6,1980,0,40,58,4,2078,1940,0.16233814803906702,240511,83698,
5,0.08955223880597014,0,1,4,6,109930,7193,434139,0.029850746268656716,156813,551,0.09131187832064054,4463,1161,17,51,1229,12207,0.024494189081567117,2730,1,1144,5,0.17097134351365836,6,1980,0,40,58,4,2078,1940,0.16233814803906702,240511,83698,
5,0.0,0,1,4,6,109930,7193,434139,0.029850746268656716,156813,551,0.09131187832064054,4463,1,1,6,8,12207,0.024494189081567117,2730,0,0,0,0.00436442989634479,0,1980,0,40,58,0,2078,1940,0.16233814803906702,240511,83698,
0,0.0,0,0,0,0,109930,7193,434139,0.0,156813,551,0.09131187832064054,4463,159,15,0,174,12207,0.024494189081567117,2730,0,144,0,0.22570371622256022,0,1097,0,139,65,0,1301,958,0.08574638031880223,240511,83698,
0,0.0,0,0,0,0,109930,7193,434139,0.0,156813,551,0.09131187832064054,4463,19,8,0,27,12207,0.024494189081567117,2730,0,11,0,0.13523289097059588,0,1097,0,139,65,0,1301,958,0.08574638031880223,240511,83698,
0,0.0,0,0,0,0,109930,7193,434139,0.0,156813,551,0.09131187832064054,4463,19,8,0,27,12207,0.024494189081567117,2730,0,11,0,0.13523289097059588,0,1097,0,139,65,0,1301,958,0.08574638031880223,240511,83698,
0,0.0,0,0,0,0,109930,7193,434139,0.0,156813,551,0.09131187832064054,4463,117,4,1,122,12207,0.024494189081567117,2730,0,113,0,0.05167082811852668,0,1097,0,139,65,0,1301,958,0.08574638031880223,240511,83698,
0,0.0,0,0,0,0,109930,7193,434139,0.0,156813,551,0.09131187832064054,4463,667,79,32,778,12207,0.024494189081567117,2730,0,588,0,0.11125513466649609,0,1097,0,139,65,0,1301,958,0.08574638031880223,240511,83698,
0,0.0,0,0,0,0,109930,7193,434139,0.0,156813,551,0.09131187832064054,4463,667,79,32,778,12207,0.024494189081567117,2730,0,588,0,0.11125513466649609,0,1097,0,139,65,0,1301,958,0.08574638031880223,240511,83698,
0,0.0,0,0,0,0,109930,7193,434139,0.0,156813,551,0.09131187832064054,4463,667,79,32,778,12207,0.024494189081567117,2730,0,588,0,0.11125513466649609,0,1097,0,139,65,0,1301,958,0.08574638031880223,240511,83698,
0,0.0,0,0,0,0,109930,7193,434139,0.0,156813,551,0.09131187832064054,4463,82,13,16,111,12207,0.024494189081567117,2730,0,69,0,0.05032240440816205,0,1097,0,139,65,0,1301,958,0.08574638031880223,240511,83698,
0,0.0,0,0,0,0,109930,7193,434139,0.0,156813,551,0.09131187832064054,4463,82,13,16,111,12207,0.024494189081567117,2730,0,69,0,0.05032240440816205,0,1097,0,139,65,0,1301,958,0.08574638031880223,240511,83698,
0,0.0,0,0,0,0,109930,7193,434139,0.0,156813,551,0.09131187832064054,4463,82,13,16,111,12207,0.024494189081567117,2730,0,69,0,0.05032240440816205,0,1097,0,139,65,0,1301,958,0.08574638031880223,240511,83698,
0,0.0,0,0,0,0,109930,7193,434139,0.0,156813,551,0.09131187832064054,4463,4,8,16,28,12207,0.024494189081567117,2730,0,-4,0,0.012096978374014251,0,1097,0,139,65,0,1301,958,0.08574638031880223,240511,83698,
0,0.0,0,0,0,0,109930,7193,434139,0.0,156813,551,0.09131187832064054,4463,82,13,16,111,12207,0.024494189081567117,2730,0,69,0,0.05032240440816205,0,1097,0,139,65,0,1301,958,0.08574638031880223,240511,83698,
0,0.0,0,0,0,0,109930,7193,434139,0.0,156813,551,0.09131187832064054,4463,82,13,16,111,12207,0.024494189081567117,2730,0,69,0,0.05032240440816205,0,1097,0,139,65,0,1301,958,0.08574638031880223,240511,83698,
0,0.0,0,0,0,0,109930,7193,434139,0.0,156813,551,0.09131187832064054,4463,82,13,16,111,12207,0.024494189081567117,2730,0,69,0,0.05032240440816205,0,1097,0,139,65,0,1301,958,0.08574638031880223,240511,83698,
0,0.0,0,0,0,0,109930,7193,434139,0.0,156813,551,0.09131187832064054,4463,49,12,0,61,12207,0.024494189081567117,2730,0,37,0,0.013942709471260396,0,1097,0,139,65,0,1301,958,0.08574638031880223,240511,83698,
0,0.0,0,0,0,0,109930,7193,434139,0.0,156813,551,0.09131187832064054,4463,49,12,0,61,12207,0.024494189081567117,2730,0,37,0,0.013942709471260396,0,1097,0,139,65,0,1301,958,0.08574638031880223,240511,83698,
0,0.0,0,0,0,0,109930,7193,434139,0.0,156813,551,0.09131187832064054,4463,49,12,0,61,12207,0.024494189081567117,2730,0,37,0,0.013942709471260396,0,1097,0,139,65,0,1301,958,0.08574638031880223,240511,83698,
0,0.0,0,0,0,0,109930,7193,434139,0.0,156813,551,0.09131187832064054,4463,49,12,0,61,12207,0.024494189081567117,2730,0,37,0,0.013942709471260396,0,1097,0,139,65,0,1301,958,0.08574638031880223,240511,83698,
0,0.0,0,0,0,0,109930,7193,434139,0.0,156813,551,0.09131187832064054,4463,49,12,0,61,12207,0.024494189081567117,2730,0,37,0,0.013942709471260396,0,1097,0,139,65,0,1301,958,0.08574638031880223,240511,83698,
0,0.0,0,0,0,0,109930,7193,434139,0.0,156813,551,0.09131187832064054,4463,49,12,0,61,12207,0.024494189081567117,2730,0,37,0,0.013942709471260396,0,1097,0,139,65,0,1301,958,0.08574638031880223,240511,83698,
0,0.0,0,0,0,0,109930,7193,434139,0.0,156813,551,0.09131187832064054,4463,49,12,0,61,12207,0.024494189081567117,2730,0,37,0,0.013942709471260396,0,1097,0,139,65,0,1301,958,0.08574638031880223,240511,83698,
0,0.0,0,0,0,0,109930,7193,434139,0.0,156813,551,0.09131187832064054,4463,4,8,16,28,12207,0.024494189081567117,2730,0,-4,0,0.012096978374014251,0,1097,0,139,65,0,1301,958,0.08574638031880223,240511,83698,
2,0.0033519553072625698,0,4,-2,6,109930,7193,434139,0.002264107426579878,156813,551,0.09131187832064054,4463,126,565,890,1581,12207,0.024494189081567117,2730,2,-439,1,0.2589142551410437,3,613,0,580,895,-1,2088,33,0.2181625008978411,240511,83698,
2,0.0033519553072625698,0,4,-2,6,109930,7193,434139,0.002264107426579878,156813,551,0.09131187832064054,4463,126,565,890,1581,12207,0.024494189081567117,2730,2,-439,1,0.2589142551410437,3,613,0,580,895,-1,2088,33,0.2181625008978411,240511,83698,
2,0.0033519553072625698,0,4,-2,6,109930,7193,434139,0.002264107426579878,156813,551,0.09131187832064054,4463,126,565,890,1581,12207,0.024494189081567117,2730,2,-439,1,0.2589142551410437,3,613,0,580,895,-1,2088,33,0.2181625008978411,240511,83698,
2,0.0033519553072625698,0,4,-2,6,109930,7193,434139,0.002264107426579878,156813,551,0.09131187832064054,4463,126,565,890,1581,12207,0.024494189081567117,2730,2,-439,1,0.2589142551410437,3,613,0,580,895,-1,2088,33,0.2181625008978411,240511,83698,
2,0.0033519553072625698,0,4,-2,6,109930,7193,434139,0.002264107426579878,156813,551,0.09131187832064054,4463,126,565,890,1581,12207,0.024494189081567117,2730,2,-439,1,0.2589142551410437,3,613,0,580,895,-1,2088,33,0.2181625008978411,240511,83698,
2,0.0033519553072625698,0,4,-2,6,109930,7193,434139,0.002264107426579878,156813,551,0.09131187832064054,4463,126,565,890,1581,12207,0.024494189081567117,2730,2,-439,1,0.2589142551410437,3,613,0,580,895,-1,2088,33,0.2181625008978411,240511,83698,
0,0.0,0,0,0,0,109930,7193,434139,0.0,156813,551,0.09131187832064054,4463,54,933,2,989,12207,0.024494189081567117,2730,0,-879,0,0.3329362274336021,0,54,0,933,2,0,989,-879,0.16646811371680106,240511,83698,
1,0.0,0,1,0,2,109930,7193,434139,0.0038095238095238095,156813,551,0.09131187832064054,4463,121,71,1,193,12207,0.024494189081567117,2730,0,50,0,0.10203622087862631,0,2874,0,1987,105,0,4966,887,0.06961836250108105,240511,83698,
1,0.0,0,1,0,2,109930,7193,434139,0.0038095238095238095,156813,551,0.09131187832064054,4463,24,45,0,69,12207,0.024494189081567117,2730,0,-21,0,0.16325503295803742,0,2874,0,1987,105,0,4966,887,0.06961836250108105,240511,83698,
1,0.0,0,1,0,2,109930,7193,434139,0.0038095238095238095,156813,551,0.09131187832064054,4463,916,174,26,1116,12207,0.024494189081567117,2730,0,742,0,0.0712350412159767,0,2874,0,1987,105,0,4966,887,0.06961836250108105,240511,83698,
1,0.0,0,1,0,2,109930,7193,434139,0.0038095238095238095,156813,551,0.09131187832064054,4463,916,174,26,1116,12207,0.024494189081567117,2730,0,742,0,0.0712350412159767,0,2874,0,1987,105,0,4966,887,0.06961836250108105,240511,83698,
37,0.1875,0,12,25,49,109930,7193,434139,0.035262148096019096,156813,551,0.09131187832064054,4463,219,105,449,773,12207,0.024494189081567117,2730,2,114,1,0.16732978249898153,3,2841,0,1334,1290,-1,5465,1507,0.13825522467402868,240511,83698,
37,0.1875,0,12,25,49,109930,7193,434139,0.035262148096019096,156813,551,0.09131187832064054,4463,219,105,449,773,12207,0.024494189081567117,2730,2,114,1,0.16732978249898153,3,2841,0,1334,1290,-1,5465,1507,0.13825522467402868,240511,83698,
37,0.1875,0,12,25,49,109930,7193,434139,0.035262148096019096,156813,551,0.09131187832064054,4463,219,105,449,773,12207,0.024494189081567117,2730,2,114,1,0.16732978249898153,3,2841,0,1334,1290,-1,5465,1507,0.13825522467402868,240511,83698,
37,0.1875,0,12,25,49,109930,7193,434139,0.035262148096019096,156813,551,0.09131187832064054,4463,219,105,449,773,12207,0.024494189081567117,2730,2,114,1,0.16732978249898153,3,2841,0,1334,1290,-1,5465,1507,0.13825522467402868,240511,83698,
37,0.0,0,12,25,49,109930,7193,434139,0.035262148096019096,156813,551,0.09131187832064054,4463,676,128,9,813,12207,0.024494189081567117,2730,0,548,0,0.06707002050040517,0,2841,0,1334,1290,0,5465,1507,0.13825522467402868,240511,83698,
37,0.0,0,12,25,49,109930,7193,434139,0.035262148096019096,156813,551,0.09131187832064054,4463,676,128,9,813,12207,0.024494189081567117,2730,0,548,0,0.06707002050040517,0,2841,0,1334,1290,0,5465,1507,0.13825522467402868,240511,83698,
37,0.0,0,12,25,49,109930,7193,434139,0.035262148096019096,156813,551,0.09131187832064054,4463,676,128,9,813,12207,0.024494189081567117,2730,0,548,0,0.06707002050040517,0,2841,0,1334,1290,0,5465,1507,0.13825522467402868,240511,83698,
37,0.13333333333333333,0,12,25,49,109930,7193,434139,0.035262148096019096,156813,551,0.09131187832064054,4463,41,67,93,201,12207,0.024494189081567117,2730,1,-26,1,0.1744164370470659,2,2841,0,1334,1290,0,5465,1507,0.13825522467402868,240511,83698,
37,0.21787439613526569,0,12,25,49,109930,7193,434139,0.035262148096019096,156813,551,0.09131187832064054,4463,52,175,414,641,12207,0.024494189081567117,2730,6,-123,33,0.07654451556977585,39,2841,0,1334,1290,27,5465,1507,0.13825522467402868,240511,83698,
37,0.21787439613526569,0,12,25,49,109930,7193,434139,0.035262148096019096,156813,551,0.09131187832064054,4463,52,175,414,641,12207,0.024494189081567117,2730,6,-123,33,0.07654451556977585,39,2841,0,1334,1290,27,5465,1507,0.13825522467402868,240511,83698,
37,0.21787439613526569,0,12,25,49,109930,7193,434139,0.035262148096019096,156813,551,0.09131187832064054,4463,52,175,414,641,12207,0.024494189081567117,2730,6,-123,33,0.07654451556977585,39,2841,0,1334,1290,27,5465,1507,0.13825522467402868,240511,83698,
37,0.003264417845484222,0,12,25,49,109930,7193,434139,0.035262148096019096,156813,551,0.09131187832064054,4463,630,58,1,689,12207,0.024494189081567117,2730,2,572,1,0.0771895258046543,3,2841,0,1334,1290,-1,5465,1507,0.13825522467402868,240511,83698,
37,0.003264417845484222,0,12,25,49,109930,7193,434139,0.035262148096019096,156813,551,0.09131187832064054,4463,630,58,1,689,12207,0.024494189081567117,2730,2,572,1,0.0771895258046543,3,2841,0,1334,1290,-1,5465,1507,0.13825522467402868,240511,83698,
37,0.003264417845484222,0,12,25,49,109930,7193,434139,0.035262148096019096,156813,551,0.09131187832064054,4463,630,58,1,689,12207,0.024494189081567117,2730,2,572,1,0.0771895258046543,3,2841,0,1334,1290,-1,5465,1507,0.13825522467402868,240511,83698,
37,0.003264417845484222,0,12,25,49,109930,7193,434139,0.035262148096019096,156813,551,0.09131187832064054,4463,630,58,1,689,12207,0.024494189081567117,2730,2,572,1,0.0771895258046543,3,2841,0,1334,1290,-1,5465,1507,0.13825522467402868,240511,83698,
37,0.003264417845484222,0,12,25,49,109930,7193,434139,0.035262148096019096,156813,551,0.09131187832064054,4463,630,58,1,689,12207,0.024494189081567117,2730,2,572,1,0.0771895258046543,3,2841,0,1334,1290,-1,5465,1507,0.13825522467402868,240511,83698,
37,0.003264417845484222,0,12,25,49,109930,7193,434139,0.035262148096019096,156813,551,0.09131187832064054,4463,630,58,1,689,12207,0.024494189081567117,2730,2,572,1,0.0771895258046543,3,2841,0,1334,1290,-1,5465,1507,0.13825522467402868,240511,83698,
37,0.003264417845484222,0,12,25,49,109930,7193,434139,0.035262148096019096,156813,551,0.09131187832064054,4463,630,58,1,689,12207,0.024494189081567117,2730,2,572,1,0.0771895258046543,3,2841,0,1334,1290,-1,5465,1507,0.13825522467402868,240511,83698,
37,0.003264417845484222,0,12,25,49,109930,7193,434139,0.035262148096019096,156813,551,0.09131187832064054,4463,630,58,1,689,12207,0.024494189081567117,2730,2,572,1,0.0771895258046543,3,2841,0,1334,1290,-1,5465,1507,0.13825522467402868,240511,83698,
37,0.003264417845484222,0,12,25,49,109930,7193,434139,0.035262148096019096,156813,551,0.09131187832064054,4463,630,58,1,689,12207,0.024494189081567117,2730,2,572,1,0.0771895258046543,3,2841,0,1334,1290,-1,5465,1507,0.13825522467402868,240511,83698,
37,0.003264417845484222,0,12,25,49,109930,7193,434139,0.035262148096019096,156813,551,0.09131187832064054,4463,630,58,1,689,12207,0.024494189081567117,2730,2,572,1,0.0771895258046543,3,2841,0,1334,1290,-1,5465,1507,0.13825522467402868,240511,83698,
37,0.003264417845484222,0,12,25,49,109930,7193,434139,0.035262148096019096,156813,551,0.09131187832064054,4463,630,58,1,689,12207,0.024494189081567117,2730,2,572,1,0.0771895258046543,3,2841,0,1334,1290,-1,5465,1507,0.13825522467402868,240511,83698,
37,0.003264417845484222,0,12,25,49,109930,7193,434139,0.035262148096019096,156813,551,0.09131187832064054,4463,630,58,1,689,12207,0.024494189081567117,2730,2,572,1,0.0771895258046543,3,2841,0,1334,1290,-1,5465,1507,0.13825522467402868,240511,83698,
37,0.003264417845484222,0,12,25,49,109930,7193,434139,0.035262148096019096,156813,551,0.09131187832064054,4463,630,58,1,689,12207,0.024494189081567117,2730,2,572,1,0.0771895258046543,3,2841,0,1334,1290,-1,5465,1507,0.13825522467402868,240511,83698,
37,0.003264417845484222,0,12,25,49,109930,7193,434139,0.035262148096019096,156813,551,0.09131187832064054,4463,630,58,1,689,12207,0.024494189081567117,2730,2,572,1,0.0771895258046543,3,2841,0,1334,1290,-1,5465,1507,0.13825522467402868,240511,83698,
37,0.003264417845484222,0,12,25,49,109930,7193,434139,0.035262148096019096,156813,551,0.09131187832064054,4463,630,58,1,689,12207,0.024494189081567117,2730,2,572,1,0.0771895258046543,3,2841,0,1334,1290,-1,5465,1507,0.13825522467402868,240511,83698,
37,0.003264417845484222,0,12,25,49,109930,7193,434139,0.035262148096019096,156813,551,0.09131187832064054,4463,630,58,1,689,12207,0.024494189081567117,2730,2,572,1,0.0771895258046543,3,2841,0,1334,1290,-1,5465,1507,0.13825522467402868,240511,83698,
37,0.003264417845484222,0,12,25,49,109930,7193,434139,0.035262148096019096,156813,551,0.09131187832064054,4463,630,58,1,689,12207,0.024494189081567117,2730,2,572,1,0.0771895258046543,3,2841,0,1334,1290,-1,5465,1507,0.13825522467402868,240511,83698,
37,0.003264417845484222,0,12,25,49,109930,7193,434139,0.035262148096019096,156813,551,0.09131187832064054,4463,630,58,1,689,12207,0.024494189081567117,2730,2,572,1,0.0771895258046543,3,2841,0,1334,1290,-1,5465,1507,0.13825522467402868,240511,83698,
37,0.003264417845484222,0,12,25,49,109930,7193,434139,0.035262148096019096,156813,551,0.09131187832064054,4463,630,58,1,689,12207,0.024494189081567117,2730,2,572,1,0.0771895258046543,3,2841,0,1334,1290,-1,5465,1507,0.13825522467402868,240511,83698,
37,0.003264417845484222,0,12,25,49,109930,7193,434139,0.035262148096019096,156813,551,0.09131187832064054,4463,630,58,1,689,12207,0.024494189081567117,2730,2,572,1,0.0771895258046543,3,2841,0,1334,1290,-1,5465,1507,0.13825522467402868,240511,83698,
37,0.003264417845484222,0,12,25,49,109930,7193,434139,0.035262148096019096,156813,551,0.09131187832064054,4463,630,58,1,689,12207,0.024494189081567117,2730,2,572,1,0.0771895258046543,3,2841,0,1334,1290,-1,5465,1507,0.13825522467402868,240511,83698,
37,0.003264417845484222,0,12,25,49,109930,7193,434139,0.035262148096019096,156813,551,0.09131187832064054,4463,630,58,1,689,12207,0.024494189081567117,2730,2,572,1,0.0771895258046543,3,2841,0,1334,1290,-1,5465,1507,0.13825522467402868,240511,83698,
37,0.022222222222222223,0,12,25,49,109930,7193,434139,0.035262148096019096,156813,551,0.09131187832064054,4463,391,58,4,453,12207,0.024494189081567117,2730,1,333,1,0.159092035083679,2,2841,0,1334,1290,0,5465,1507,0.13825522467402868,240511,83698,
37,0.022222222222222223,0,12,25,49,109930,7193,434139,0.035262148096019096,156813,551,0.09131187832064054,4463,391,58,4,453,12207,0.024494189081567117,2730,1,333,1,0.159092035083679,2,2841,0,1334,1290,0,5465,1507,0.13825522467402868,240511,83698,
37,0.022222222222222223,0,12,25,49,109930,7193,434139,0.035262148096019096,156813,551,0.09131187832064054,4463,391,58,4,453,12207,0.024494189081567117,2730,1,333,1,0.159092035083679,2,2841,0,1334,1290,0,5465,1507,0.13825522467402868,240511,83698,
37,0.0,0,12,25,49,109930,7193,434139,0.035262148096019096,156813,551,0.09131187832064054,4463,56,73,94,223,12207,0.024494189081567117,2730,0,-17,0,0.04548636372213654,0,2841,0,1334,1290,0,5465,1507,0.13825522467402868,240511,83698,
0,0.0,0,0,0,0,109930,7193,434139,0.0,156813,551,0.09131187832064054,4463,31,12,0,43,12207,0.024494189081567117,2730,0,19,0,0.20022909507445588,0,120,0,36,1,0,157,84,0.17322040299421726,240511,83698,
0,0.0,0,0,0,0,109930,7193,434139,0.0,156813,551,0.09131187832064054,4463,76,1,0,77,12207,0.024494189081567117,2730,0,75,0,0.025913595389677392,0,120,0,36,1,0,157,84,0.17322040299421726,240511,83698,
0,0.0,0,0,0,0,109930,7193,434139,0.0,156813,551,0.09131187832064054,4463,3,2,0,5,12207,0.024494189081567117,2730,0,1,0,0.009429963975418522,0,130,0,4,0,0,134,126,0.2427156596712622,240511,83698,
0,0.0,0,0,0,0,109930,7193,434139,0.0,156813,551,0.09131187832064054,4463,110,10,0,120,12207,0.024494189081567117,2730,0,100,0,0.3592356987009984,0,210,0,86,0,0,296,124,0.272031398229024,240511,83698,
2,0.0,0,2,0,4,109930,7193,434139,0.01834215167548501,156813,551,0.09131187832064054,4463,37,0,0,37,12207,0.024494189081567117,2730,0,37,0,0.19786096256684493,0,423,0,36,0,0,459,387,0.13435561114483574,240511,83698,
2,0.031746031746031744,0,2,0,4,109930,7193,434139,0.01834215167548501,156813,551,0.09131187832064054,4463,119,3,0,122,12207,0.024494189081567117,2730,1,116,1,0.10758689036678273,2,423,0,36,0,0,459,387,0.13435561114483574,240511,83698,
2,0.031746031746031744,0,2,0,4,109930,7193,434139,0.01834215167548501,156813,551,0.09131187832064054,4463,119,3,0,122,12207,0.024494189081567117,2730,1,116,1,0.10758689036678273,2,423,0,36,0,0,459,387,0.13435561114483574,240511,83698,
2,0.0,0,2,0,4,109930,7193,434139,0.01834215167548501,156813,551,0.09131187832064054,4463,53,2,0,55,12207,0.024494189081567117,2730,0,51,0,0.09598643154923742,0,423,0,36,0,0,459,387,0.13435561114483574,240511,83698,
2,0.0,0,2,0,4,109930,7193,434139,0.01834215167548501,156813,551,0.09131187832064054,4463,53,2,0,55,12207,0.024494189081567117,2730,0,51,0,0.09598643154923742,0,423,0,36,0,0,459,387,0.13435561114483574,240511,83698,
7,0.0,0,20,-13,27,109930,7193,434139,0.018229053829599783,156813,551,0.09131187832064054,4463,0,1,0,1,12207,0.024494189081567117,2730,0,-1,0,0.01,0,2221,0,62,263,0,2546,2159,0.047592429621470665,240511,83698,
7,0.0,0,20,-13,27,109930,7193,434139,0.018229053829599783,156813,551,0.09131187832064054,4463,0,1,0,1,12207,0.024494189081567117,2730,0,-1,0,0.01,0,2221,0,62,263,0,2546,2159,0.047592429621470665,240511,83698,
7,0.0,0,20,-13,27,109930,7193,434139,0.018229053829599783,156813,551,0.09131187832064054,4463,0,1,0,1,12207,0.024494189081567117,2730,0,-1,0,0.00641025641025641,0,2221,0,62,263,0,2546,2159,0.047592429621470665,240511,83698,
7,0.0,0,20,-13,27,109930,7193,434139,0.018229053829599783,156813,551,0.09131187832064054,4463,0,1,0,1,12207,0.024494189081567117,2730,0,-1,0,0.00641025641025641,0,2221,0,62,263,0,2546,2159,0.047592429621470665,240511,83698,
7,0.0,0,20,-13,27,109930,7193,434139,0.018229053829599783,156813,551,0.09131187832064054,4463,0,1,0,1,12207,0.024494189081567117,2730,0,-1,0,0.00641025641025641,0,2221,0,62,263,0,2546,2159,0.047592429621470665,240511,83698,
7,0.0,0,20,-13,27,109930,7193,434139,0.018229053829599783,156813,551,0.09131187832064054,4463,0,1,0,1,12207,0.024494189081567117,2730,0,-1,0,0.00641025641025641,0,2221,0,62,263,0,2546,2159,0.047592429621470665,240511,83698,
7,0.0,0,20,-13,27,109930,7193,434139,0.018229053829599783,156813,551,0.09131187832064054,4463,0,1,0,1,12207,0.024494189081567117,2730,0,-1,0,0.00641025641025641,0,2221,0,62,263,0,2546,2159,0.047592429621470665,240511,83698,
7,0.0,0,20,-13,27,109930,7193,434139,0.018229053829599783,156813,551,0.09131187832064054,4463,0,1,0,1,12207,0.024494189081567117,2730,0,-1,0,0.00641025641025641,0,2221,0,62,263,0,2546,2159,0.047592429621470665,240511,83698,
7,0.0,0,20,-13,27,109930,7193,434139,0.018229053829599783,156813,551,0.09131187832064054,4463,0,1,0,1,12207,0.024494189081567117,2730,0,-1,0,0.00641025641025641,0,2221,0,62,263,0,2546,2159,0.047592429621470665,240511,83698,
7,0.0,0,20,-13,27,109930,7193,434139,0.018229053829599783,156813,551,0.09131187832064054,4463,0,1,0,1,12207,0.024494189081567117,2730,0,-1,0,0.00641025641025641,0,2221,0,62,263,0,2546,2159,0.047592429621470665,240511,83698,
7,0.0,0,20,-13,27,109930,7193,434139,0.018229053829599783,156813,551,0.09131187832064054,4463,0,1,0,1,12207,0.024494189081567117,2730,0,-1,0,0.004273504273504274,0,2221,0,62,263,0,2546,2159,0.047592429621470665,240511,83698,
7,0.0,0,20,-13,27,109930,7193,434139,0.018229053829599783,156813,551,0.09131187832064054,4463,0,1,0,1,12207,0.024494189081567117,2730,0,-1,0,0.004273504273504274,0,2221,0,62,263,0,2546,2159,0.047592429621470665,240511,83698,
7,0.0,0,20,-13,27,109930,7193,434139,0.018229053829599783,156813,551,0.09131187832064054,4463,0,1,0,1,12207,0.024494189081567117,2730,0,-1,0,0.004273504273504274,0,2221,0,62,263,0,2546,2159,0.047592429621470665,240511,83698,
7,0.0,0,20,-13,27,109930,7193,434139,0.018229053829599783,156813,551,0.09131187832064054,4463,0,1,0,1,12207,0.024494189081567117,2730,0,-1,0,0.004032258064516129,0,2221,0,62,263,0,2546,2159,0.047592429621470665,240511,83698,
7,0.0,0,20,-13,27,109930,7193,434139,0.018229053829599783,156813,551,0.09131187832064054,4463,0,1,0,1,12207,0.024494189081567117,2730,0,-1,0,0.004032258064516129,0,2221,0,62,263,0,2546,2159,0.047592429621470665,240511,83698,
4,0.0,0,5,-1,9,109930,7193,434139,0.007901493930905695,156813,551,0.09131187832064054,4463,86,61,0,147,12207,0.024494189081567117,2730,0,25,0,0.1470720937580896,0,1730,0,1443,3003,0,6176,287,0.04619980550282602,240511,83698,
4,0.0,0,5,-1,9,109930,7193,434139,0.007901493930905695,156813,551,0.09131187832064054,4463,86,61,0,147,12207,0.024494189081567117,2730,0,25,0,0.1470720937580896,0,1730,0,1443,3003,0,6176,287,0.04619980550282602,240511,83698,
4,0.047058823529411764,0,5,-1,9,109930,7193,434139,0.007901493930905695,156813,551,0.09131187832064054,4463,139,797,2202,3138,12207,0.024494189081567117,2730,2,-658,2,0.2347727571506081,4,1730,0,1443,3003,0,6176,287,0.04619980550282602,240511,83698,
4,0.047058823529411764,0,5,-1,9,109930,7193,434139,0.007901493930905695,156813,551,0.09131187832064054,4463,139,797,2202,3138,12207,0.024494189081567117,2730,2,-658,2,0.2347727571506081,4,1730,0,1443,3003,0,6176,287,0.04619980550282602,240511,83698,
4,0.047058823529411764,0,5,-1,9,109930,7193,434139,0.007901493930905695,156813,551,0.09131187832064054,4463,139,797,2202,3138,12207,0.024494189081567117,2730,2,-658,2,0.2347727571506081,4,1730,0,1443,3003,0,6176,287,0.04619980550282602,240511,83698,
65,0.0,0,45,20,110,109930,7193,434139,0.039071338799835056,156813,551,0.09131187832064054,4463,80,0,0,80,12207,0.024494189081567117,2730,0,80,0,0.6153846153846154,0,7464,0,2515,4967,0,14946,4949,0.10126312838610864,240511,83698,
338,0.0,2,259,79,599,109930,7193,434139,0.13521618101041308,156813,551,0.09131187832064054,4463,22,21,168,211,12207,0.024494189081567117,2730,0,1,0,0.06805966316431021,0,1574,0,1122,815,0,3511,452,0.2102874598717646,240511,83698,
338,0.0,2,259,79,599,109930,7193,434139,0.13521618101041308,156813,551,0.09131187832064054,4463,22,21,168,211,12207,0.024494189081567117,2730,0,1,0,0.06805966316431021,0,1574,0,1122,815,0,3511,452,0.2102874598717646,240511,83698,
338,0.3138950808853371,2,259,79,599,109930,7193,434139,0.13521618101041308,156813,551,0.09131187832064054,4463,262,19,6,287,12207,0.024494189081567117,2730,12,243,222,0.27924301035477134,234,1574,0,1122,815,210,3511,452,0.2102874598717646,240511,83698,
338,0.0031088082901554403,2,259,79,599,109930,7193,434139,0.13521618101041308,156813,551,0.09131187832064054,4463,146,362,235,743,12207,0.024494189081567117,2730,2,-216,1,0.1879501012809097,3,1574,0,1122,815,-1,3511,452,0.2102874598717646,240511,83698,
338,0.0031088082901554403,2,259,79,599,109930,7193,434139,0.13521618101041308,156813,551,0.09131187832064054,4463,146,362,235,743,12207,0.024494189081567117,2730,2,-216,1,0.1879501012809097,3,1574,0,1122,815,-1,3511,452,0.2102874598717646,240511,83698,
1,0.0,0,1,0,2,109930,7193,434139,7.558578987150415E-4,156813,551,0.09131187832064054,4463,279,5,0,284,12207,0.024494189081567117,2730,0,274,0,0.27148783025958256,0,3811,0,727,178,0,4716,3084,0.07870711527961807,240511,83698,
1,0.0,0,1,0,2,109930,7193,434139,7.558578987150415E-4,156813,551,0.09131187832064054,4463,231,27,4,262,12207,0.024494189081567117,2730,0,204,0,0.0659298552881395,0,3811,0,727,178,0,4716,3084,0.07870711527961807,240511,83698,
1,0.0,0,1,0,2,109930,7193,434139,7.558578987150415E-4,156813,551,0.09131187832064054,4463,231,27,4,262,12207,0.024494189081567117,2730,0,204,0,0.0659298552881395,0,3811,0,727,178,0,4716,3084,0.07870711527961807,240511,83698,
1,0.0,0,1,0,2,109930,7193,434139,7.558578987150415E-4,156813,551,0.09131187832064054,4463,1513,382,71,1966,12207,0.024494189081567117,2730,0,1131,0,0.2015127251935173,0,3811,0,727,178,0,4716,3084,0.07870711527961807,240511,83698,
1,0.0,0,1,0,2,109930,7193,434139,7.558578987150415E-4,156813,551,0.09131187832064054,4463,1513,382,71,1966,12207,0.024494189081567117,2730,0,1131,0,0.2015127251935173,0,3811,0,727,178,0,4716,3084,0.07870711527961807,240511,83698,
1,0.0,0,1,0,2,109930,7193,434139,7.558578987150415E-4,156813,551,0.09131187832064054,4463,1513,382,71,1966,12207,0.024494189081567117,2730,0,1131,0,0.2015127251935173,0,3811,0,727,178,0,4716,3084,0.07870711527961807,240511,83698,
1,0.0,0,1,0,2,109930,7193,434139,7.558578987150415E-4,156813,551,0.09131187832064054,4463,1513,382,71,1966,12207,0.024494189081567117,2730,0,1131,0,0.2015127251935173,0,3811,0,727,178,0,4716,3084,0.07870711527961807,240511,83698,
1,0.0,0,1,0,2,109930,7193,434139,7.558578987150415E-4,156813,551,0.09131187832064054,4463,1513,382,71,1966,12207,0.024494189081567117,2730,0,1131,0,0.2015127251935173,0,3811,0,727,178,0,4716,3084,0.07870711527961807,240511,83698,
1,0.0,0,1,0,2,109930,7193,434139,7.558578987150415E-4,156813,551,0.09131187832064054,4463,1513,382,71,1966,12207,0.024494189081567117,2730,0,1131,0,0.2015127251935173,0,3811,0,727,178,0,4716,3084,0.07870711527961807,240511,83698,
1,0.015873015873015872,0,1,0,2,109930,7193,434139,7.558578987150415E-4,156813,551,0.09131187832064054,4463,849,97,3,949,12207,0.024494189081567117,2730,1,752,1,0.079305407154329,2,3811,0,727,178,0,4716,3084,0.07870711527961807,240511,83698,
1,0.015873015873015872,0,1,0,2,109930,7193,434139,7.558578987150415E-4,156813,551,0.09131187832064054,4463,849,97,3,949,12207,0.024494189081567117,2730,1,752,1,0.079305407154329,2,3811,0,727,178,0,4716,3084,0.07870711527961807,240511,83698,
1,0.015873015873015872,0,1,0,2,109930,7193,434139,7.558578987150415E-4,156813,551,0.09131187832064054,4463,849,97,3,949,12207,0.024494189081567117,2730,1,752,1,0.079305407154329,2,3811,0,727,178,0,4716,3084,0.07870711527961807,240511,83698,
1,0.015873015873015872,0,1,0,2,109930,7193,434139,7.558578987150415E-4,156813,551,0.09131187832064054,4463,849,97,3,949,12207,0.024494189081567117,2730,1,752,1,0.079305407154329,2,3811,0,727,178,0,4716,3084,0.07870711527961807,240511,83698,
1,0.015873015873015872,0,1,0,2,109930,7193,434139,7.558578987150415E-4,156813,551,0.09131187832064054,4463,849,97,3,949,12207,0.024494189081567117,2730,1,752,1,0.079305407154329,2,3811,0,727,178,0,4716,3084,0.07870711527961807,240511,83698,
1,0.015873015873015872,0,1,0,2,109930,7193,434139,7.558578987150415E-4,156813,551,0.09131187832064054,4463,849,97,3,949,12207,0.024494189081567117,2730,1,752,1,0.079305407154329,2,3811,0,727,178,0,4716,3084,0.07870711527961807,240511,83698,
1,0.0,0,1,0,2,109930,7193,434139,7.558578987150415E-4,156813,551,0.09131187832064054,4463,46,49,6,101,12207,0.024494189081567117,2730,0,-3,0,0.08994473754138105,0,3811,0,727,178,0,4716,3084,0.07870711527961807,240511,83698,
0,0.0,0,0,0,0,109930,7193,434139,0.0,156813,551,0.09131187832064054,4463,27,83,1,111,12207,0.024494189081567117,2730,0,-56,0,0.11833145721046541,0,101,0,106,1,0,208,-5,0.17039821935355715,240511,83698,
0,0.0,0,0,0,0,109930,7193,434139,0.0,156813,551,0.09131187832064054,4463,27,83,1,111,12207,0.024494189081567117,2730,0,-56,0,0.11833145721046541,0,101,0,106,1,0,208,-5,0.17039821935355715,240511,83698,
0,0.0,0,0,0,0,109930,7193,434139,0.0,156813,551,0.09131187832064054,4463,27,83,1,111,12207,0.024494189081567117,2730,0,-56,0,0.11833145721046541,0,101,0,106,1,0,208,-5,0.17039821935355715,240511,83698,
0,0.0,0,0,0,0,109930,7193,434139,0.0,156813,551,0.09131187832064054,4463,27,83,1,111,12207,0.024494189081567117,2730,0,-56,0,0.11833145721046541,0,101,0,106,1,0,208,-5,0.17039821935355715,240511,83698,
0,0.0,0,0,0,0,109930,7193,434139,0.0,156813,551,0.09131187832064054,4463,193,51,0,244,12207,0.024494189081567117,2730,0,142,0,0.061567853083044854,0,362,0,61,0,0,423,301,0.025127024970636513,240511,83698,
0,0.0,0,0,0,0,109930,7193,434139,0.0,156813,551,0.09131187832064054,4463,242,12,0,254,12207,0.024494189081567117,2730,0,230,0,0.1145912633918918,0,295,0,17,1,0,313,278,0.05237632122344902,240511,83698,
1,0.0018365472910927456,0,1,0,2,109930,7193,434139,2.623638987275351E-4,156813,551,0.09131187832064054,4463,247,12,4,263,12207,0.024494189081567117,2730,1,235,1,0.36717736343932517,2,962,0,311,55,0,1328,651,0.21657325570884609,240511,83698,
1,0.0018365472910927456,0,1,0,2,109930,7193,434139,2.623638987275351E-4,156813,551,0.09131187832064054,4463,247,12,4,263,12207,0.024494189081567117,2730,1,235,1,0.36717736343932517,2,962,0,311,55,0,1328,651,0.21657325570884609,240511,83698,
1,0.0,0,1,0,2,109930,7193,434139,2.623638987275351E-4,156813,551,0.09131187832064054,4463,397,282,51,730,12207,0.024494189081567117,2730,0,115,0,0.21392362186169622,0,962,0,311,55,0,1328,651,0.21657325570884609,240511,83698,
1,0.0,0,1,0,2,109930,7193,434139,2.623638987275351E-4,156813,551,0.09131187832064054,4463,397,282,51,730,12207,0.024494189081567117,2730,0,115,0,0.21392362186169622,0,962,0,311,55,0,1328,651,0.21657325570884609,240511,83698,
1,0.0,0,1,0,2,109930,7193,434139,2.623638987275351E-4,156813,551,0.09131187832064054,4463,397,282,51,730,12207,0.024494189081567117,2730,0,115,0,0.21392362186169622,0,962,0,311,55,0,1328,651,0.21657325570884609,240511,83698,
1,0.0,0,1,0,2,109930,7193,434139,2.623638987275351E-4,156813,551,0.09131187832064054,4463,397,282,51,730,12207,0.024494189081567117,2730,0,115,0,0.21392362186169622,0,962,0,311,55,0,1328,651,0.21657325570884609,240511,83698,
1,0.0,0,1,0,2,109930,7193,434139,2.623638987275351E-4,156813,551,0.09131187832064054,4463,397,282,51,730,12207,0.024494189081567117,2730,0,115,0,0.21392362186169622,0,962,0,311,55,0,1328,651,0.21657325570884609,240511,83698,
0,0.0,0,0,0,0,109930,7193,434139,0.0,156813,551,0.09131187832064054,4463,2,2,33,37,12207,0.024494189081567117,2730,0,0,0,0.08003168634740912,0,345,0,14,33,0,392,331,0.09766843076027788,240511,83698,
0,0.0,0,0,0,0,109930,7193,434139,0.0,156813,551,0.09131187832064054,4463,2,2,33,37,12207,0.024494189081567117,2730,0,0,0,0.08003168634740912,0,345,0,14,33,0,392,331,0.09766843076027788,240511,83698,
0,0.0,0,0,0,0,109930,7193,434139,0.0,156813,551,0.09131187832064054,4463,217,11,0,228,12207,0.024494189081567117,2730,0,206,0,0.03053260111231315,0,345,0,14,33,0,392,331,0.09766843076027788,240511,83698,
1,0.0,0,5,-4,6,109930,7193,434139,0.0034965034965034965,156813,551,0.09131187832064054,4463,16,139,4,159,12207,0.024494189081567117,2730,0,-123,0,0.13104641580476878,0,2202,0,1021,1296,0,4519,1181,0.07472047160486765,240511,83698,
1,0.04195804195804196,0,5,-4,6,109930,7193,434139,0.0034965034965034965,156813,551,0.09131187832064054,4463,63,373,25,461,12207,0.024494189081567117,2730,5,-310,1,0.09199982842716521,6,2202,0,1021,1296,-4,4519,1181,0.07472047160486765,240511,83698,
1,0.04195804195804196,0,5,-4,6,109930,7193,434139,0.0034965034965034965,156813,551,0.09131187832064054,4463,63,373,25,461,12207,0.024494189081567117,2730,5,-310,1,0.09199982842716521,6,2202,0,1021,1296,-4,4519,1181,0.07472047160486765,240511,83698,
1,0.04195804195804196,0,5,-4,6,109930,7193,434139,0.0034965034965034965,156813,551,0.09131187832064054,4463,63,373,25,461,12207,0.024494189081567117,2730,5,-310,1,0.09199982842716521,6,2202,0,1021,1296,-4,4519,1181,0.07472047160486765,240511,83698,
1,0.04195804195804196,0,5,-4,6,109930,7193,434139,0.0034965034965034965,156813,551,0.09131187832064054,4463,63,373,25,461,12207,0.024494189081567117,2730,5,-310,1,0.09199982842716521,6,2202,0,1021,1296,-4,4519,1181,0.07472047160486765,240511,83698,
1,0.04195804195804196,0,5,-4,6,109930,7193,434139,0.0034965034965034965,156813,551,0.09131187832064054,4463,63,373,25,461,12207,0.024494189081567117,2730,5,-310,1,0.09199982842716521,6,2202,0,1021,1296,-4,4519,1181,0.07472047160486765,240511,83698,
1,0.04195804195804196,0,5,-4,6,109930,7193,434139,0.0034965034965034965,156813,551,0.09131187832064054,4463,63,373,25,461,12207,0.024494189081567117,2730,5,-310,1,0.09199982842716521,6,2202,0,1021,1296,-4,4519,1181,0.07472047160486765,240511,83698,
1,0.0,0,5,-4,6,109930,7193,434139,0.0034965034965034965,156813,551,0.09131187832064054,4463,451,112,550,1113,12207,0.024494189081567117,2730,0,339,0,0.09936020786677931,0,2202,0,1021,1296,0,4519,1181,0.07472047160486765,240511,83698,
1,0.0,0,5,-4,6,109930,7193,434139,0.0034965034965034965,156813,551,0.09131187832064054,4463,451,112,550,1113,12207,0.024494189081567117,2730,0,339,0,0.09936020786677931,0,2202,0,1021,1296,0,4519,1181,0.07472047160486765,240511,83698,
1,0.0,0,5,-4,6,109930,7193,434139,0.0034965034965034965,156813,551,0.09131187832064054,4463,451,112,550,1113,12207,0.024494189081567117,2730,0,339,0,0.09936020786677931,0,2202,0,1021,1296,0,4519,1181,0.07472047160486765,240511,83698,
1,0.0,0,5,-4,6,109930,7193,434139,0.0034965034965034965,156813,551,0.09131187832064054,4463,451,112,550,1113,12207,0.024494189081567117,2730,0,339,0,0.09936020786677931,0,2202,0,1021,1296,0,4519,1181,0.07472047160486765,240511,83698,
1,0.0,0,5,-4,6,109930,7193,434139,0.0034965034965034965,156813,551,0.09131187832064054,4463,184,0,123,307,12207,0.024494189081567117,2730,0,184,0,0.009777354407956403,0,2202,0,1021,1296,0,4519,1181,0.07472047160486765,240511,83698,
1,0.0,0,5,-4,6,109930,7193,434139,0.0034965034965034965,156813,551,0.09131187832064054,4463,107,3,40,150,12207,0.024494189081567117,2730,0,104,0,0.007582441538885399,0,2202,0,1021,1296,0,4519,1181,0.07472047160486765,240511,83698,
1,0.0,0,5,-4,6,109930,7193,434139,0.0034965034965034965,156813,551,0.09131187832064054,4463,1047,283,81,1411,12207,0.024494189081567117,2730,0,764,0,0.15772077606377466,0,2202,0,1021,1296,0,4519,1181,0.07472047160486765,240511,83698,
1,0.0,0,5,-4,6,109930,7193,434139,0.0034965034965034965,156813,551,0.09131187832064054,4463,1047,283,81,1411,12207,0.024494189081567117,2730,0,764,0,0.15772077606377466,0,2202,0,1021,1296,0,4519,1181,0.07472047160486765,240511,83698,
1,0.0,0,5,-4,6,109930,7193,434139,0.0034965034965034965,156813,551,0.09131187832064054,4463,1047,283,81,1411,12207,0.024494189081567117,2730,0,764,0,0.15772077606377466,0,2202,0,1021,1296,0,4519,1181,0.07472047160486765,240511,83698,
1,0.0,0,5,-4,6,109930,7193,434139,0.0034965034965034965,156813,551,0.09131187832064054,4463,1047,283,81,1411,12207,0.024494189081567117,2730,0,764,0,0.15772077606377466,0,2202,0,1021,1296,0,4519,1181,0.07472047160486765,240511,83698,
1,0.0,0,5,-4,6,109930,7193,434139,0.0034965034965034965,156813,551,0.09131187832064054,4463,1047,283,81,1411,12207,0.024494189081567117,2730,0,764,0,0.15772077606377466,0,2202,0,1021,1296,0,4519,1181,0.07472047160486765,240511,83698,
1,0.0,0,5,-4,6,109930,7193,434139,0.0034965034965034965,156813,551,0.09131187832064054,4463,1047,283,81,1411,12207,0.024494189081567117,2730,0,764,0,0.15772077606377466,0,2202,0,1021,1296,0,4519,1181,0.07472047160486765,240511,83698,
1,0.0,0,5,-4,6,109930,7193,434139,0.0034965034965034965,156813,551,0.09131187832064054,4463,1047,283,81,1411,12207,0.024494189081567117,2730,0,764,0,0.15772077606377466,0,2202,0,1021,1296,0,4519,1181,0.07472047160486765,240511,83698,
0,0.0,0,0,0,0,109930,7193,434139,0.0,156813,551,0.09131187832064054,4463,199,85,10,294,12207,0.024494189081567117,2730,0,114,0,0.11098852695074768,0,319,0,227,20,0,566,92,0.10409686257891458,240511,83698,
0,0.0,0,0,0,0,109930,7193,434139,0.0,156813,551,0.09131187832064054,4463,51,86,0,137,12207,0.024494189081567117,2730,0,-35,0,0.07575605195871744,0,319,0,227,20,0,566,92,0.10409686257891458,240511,83698,
856,0.10178005958627917,24,264,592,1144,109930,7193,434139,0.03988400734856707,156813,551,0.09131187832064054,4463,583,131,35,749,12207,0.024494189081567117,2730,7,452,33,0.1649587519937049,41,8704,1,3324,5743,26,17771,5380,0.07210793682769204,240511,83698,
856,0.10178005958627917,24,264,592,1144,109930,7193,434139,0.03988400734856707,156813,551,0.09131187832064054,4463,583,131,35,749,12207,0.024494189081567117,2730,7,452,33,0.1649587519937049,41,8704,1,3324,5743,26,17771,5380,0.07210793682769204,240511,83698,
856,0.19593763686263313,24,264,592,1144,109930,7193,434139,0.03988400734856707,156813,551,0.09131187832064054,4463,1798,1217,1843,4858,12207,0.024494189081567117,2730,34,581,166,0.19353897540897405,204,8704,4,3324,5743,132,17771,5380,0.07210793682769204,240511,83698,
856,0.19593763686263313,24,264,592,1144,109930,7193,434139,0.03988400734856707,156813,551,0.09131187832064054,4463,1798,1217,1843,4858,12207,0.024494189081567117,2730,34,581,166,0.19353897540897405,204,8704,4,3324,5743,132,17771,5380,0.07210793682769204,240511,83698,
856,0.19593763686263313,24,264,592,1144,109930,7193,434139,0.03988400734856707,156813,551,0.09131187832064054,4463,1798,1217,1843,4858,12207,0.024494189081567117,2730,34,581,166,0.19353897540897405,204,8704,4,3324,5743,132,17771,5380,0.07210793682769204,240511,83698,
856,0.19593763686263313,24,264,592,1144,109930,7193,434139,0.03988400734856707,156813,551,0.09131187832064054,4463,1798,1217,1843,4858,12207,0.024494189081567117,2730,34,581,166,0.19353897540897405,204,8704,4,3324,5743,132,17771,5380,0.07210793682769204,240511,83698,
856,0.19593763686263313,24,264,592,1144,109930,7193,434139,0.03988400734856707,156813,551,0.09131187832064054,4463,1798,1217,1843,4858,12207,0.024494189081567117,2730,34,581,166,0.19353897540897405,204,8704,4,3324,5743,132,17771,5380,0.07210793682769204,240511,83698,
856,0.19593763686263313,24,264,592,1144,109930,7193,434139,0.03988400734856707,156813,551,0.09131187832064054,4463,1798,1217,1843,4858,12207,0.024494189081567117,2730,34,581,166,0.19353897540897405,204,8704,4,3324,5743,132,17771,5380,0.07210793682769204,240511,83698,
856,0.19593763686263313,24,264,592,1144,109930,7193,434139,0.03988400734856707,156813,551,0.09131187832064054,4463,1798,1217,1843,4858,12207,0.024494189081567117,2730,34,581,166,0.19353897540897405,204,8704,4,3324,5743,132,17771,5380,0.07210793682769204,240511,83698,
856,0.19593763686263313,24,264,592,1144,109930,7193,434139,0.03988400734856707,156813,551,0.09131187832064054,4463,1798,1217,1843,4858,12207,0.024494189081567117,2730,34,581,166,0.19353897540897405,204,8704,4,3324,5743,132,17771,5380,0.07210793682769204,240511,83698,
856,0.19593763686263313,24,264,592,1144,109930,7193,434139,0.03988400734856707,156813,551,0.09131187832064054,4463,1798,1217,1843,4858,12207,0.024494189081567117,2730,34,581,166,0.19353897540897405,204,8704,4,3324,5743,132,17771,5380,0.07210793682769204,240511,83698,
856,0.19593763686263313,24,264,592,1144,109930,7193,434139,0.03988400734856707,156813,551,0.09131187832064054,4463,1798,1217,1843,4858,12207,0.024494189081567117,2730,34,581,166,0.19353897540897405,204,8704,4,3324,5743,132,17771,5380,0.07210793682769204,240511,83698,
856,0.19593763686263313,24,264,592,1144,109930,7193,434139,0.03988400734856707,156813,551,0.09131187832064054,4463,1798,1217,1843,4858,12207,0.024494189081567117,2730,34,581,166,0.19353897540897405,204,8704,4,3324,5743,132,17771,5380,0.07210793682769204,240511,83698,
856,0.19593763686263313,24,264,592,1144,109930,7193,434139,0.03988400734856707,156813,551,0.09131187832064054,4463,1798,1217,1843,4858,12207,0.024494189081567117,2730,34,581,166,0.19353897540897405,204,8704,4,3324,5743,132,17771,5380,0.07210793682769204,240511,83698,
856,0.19593763686263313,24,264,592,1144,109930,7193,434139,0.03988400734856707,156813,551,0.09131187832064054,4463,1798,1217,1843,4858,12207,0.024494189081567117,2730,34,581,166,0.19353897540897405,204,8704,4,3324,5743,132,17771,5380,0.07210793682769204,240511,83698,
856,0.19593763686263313,24,264,592,1144,109930,7193,434139,0.03988400734856707,156813,551,0.09131187832064054,4463,1798,1217,1843,4858,12207,0.024494189081567117,2730,34,581,166,0.19353897540897405,204,8704,4,3324,5743,132,17771,5380,0.07210793682769204,240511,83698,
856,0.19593763686263313,24,264,592,1144,109930,7193,434139,0.03988400734856707,156813,551,0.09131187832064054,4463,1798,1217,1843,4858,12207,0.024494189081567117,2730,34,581,166,0.19353897540897405,204,8704,4,3324,5743,132,17771,5380,0.07210793682769204,240511,83698,
856,0.19593763686263313,24,264,592,1144,109930,7193,434139,0.03988400734856707,156813,551,0.09131187832064054,4463,1798,1217,1843,4858,12207,0.024494189081567117,2730,34,581,166,0.19353897540897405,204,8704,4,3324,5743,132,17771,5380,0.07210793682769204,240511,83698,
856,0.19593763686263313,24,264,592,1144,109930,7193,434139,0.03988400734856707,156813,551,0.09131187832064054,4463,1798,1217,1843,4858,12207,0.024494189081567117,2730,34,581,166,0.19353897540897405,204,8704,4,3324,5743,132,17771,5380,0.07210793682769204,240511,83698,
856,0.19593763686263313,24,264,592,1144,109930,7193,434139,0.03988400734856707,156813,551,0.09131187832064054,4463,1798,1217,1843,4858,12207,0.024494189081567117,2730,34,581,166,0.19353897540897405,204,8704,4,3324,5743,132,17771,5380,0.07210793682769204,240511,83698,
856,0.19593763686263313,24,264,592,1144,109930,7193,434139,0.03988400734856707,156813,551,0.09131187832064054,4463,1798,1217,1843,4858,12207,0.024494189081567117,2730,34,581,166,0.19353897540897405,204,8704,4,3324,5743,132,17771,5380,0.07210793682769204,240511,83698,
856,0.19593763686263313,24,264,592,1144,109930,7193,434139,0.03988400734856707,156813,551,0.09131187832064054,4463,1798,1217,1843,4858,12207,0.024494189081567117,2730,34,581,166,0.19353897540897405,204,8704,4,3324,5743,132,17771,5380,0.07210793682769204,240511,83698,
856,0.19593763686263313,24,264,592,1144,109930,7193,434139,0.03988400734856707,156813,551,0.09131187832064054,4463,1798,1217,1843,4858,12207,0.024494189081567117,2730,34,581,166,0.19353897540897405,204,8704,4,3324,5743,132,17771,5380,0.07210793682769204,240511,83698,
856,0.19593763686263313,24,264,592,1144,109930,7193,434139,0.03988400734856707,156813,551,0.09131187832064054,4463,1798,1217,1843,4858,12207,0.024494189081567117,2730,34,581,166,0.19353897540897405,204,8704,4,3324,5743,132,17771,5380,0.07210793682769204,240511,83698,
856,0.19593763686263313,24,264,592,1144,109930,7193,434139,0.03988400734856707,156813,551,0.09131187832064054,4463,1798,1217,1843,4858,12207,0.024494189081567117,2730,34,581,166,0.19353897540897405,204,8704,4,3324,5743,132,17771,5380,0.07210793682769204,240511,83698,
856,0.19593763686263313,24,264,592,1144,109930,7193,434139,0.03988400734856707,156813,551,0.09131187832064054,4463,1798,1217,1843,4858,12207,0.024494189081567117,2730,34,581,166,0.19353897540897405,204,8704,4,3324,5743,132,17771,5380,0.07210793682769204,240511,83698,
856,0.19593763686263313,24,264,592,1144,109930,7193,434139,0.03988400734856707,156813,551,0.09131187832064054,4463,1798,1217,1843,4858,12207,0.024494189081567117,2730,34,581,166,0.19353897540897405,204,8704,4,3324,5743,132,17771,5380,0.07210793682769204,240511,83698,
856,0.19593763686263313,24,264,592,1144,109930,7193,434139,0.03988400734856707,156813,551,0.09131187832064054,4463,1798,1217,1843,4858,12207,0.024494189081567117,2730,34,581,166,0.19353897540897405,204,8704,4,3324,5743,132,17771,5380,0.07210793682769204,240511,83698,
856,0.19593763686263313,24,264,592,1144,109930,7193,434139,0.03988400734856707,156813,551,0.09131187832064054,4463,1798,1217,1843,4858,12207,0.024494189081567117,2730,34,581,166,0.19353897540897405,204,8704,4,3324,5743,132,17771,5380,0.07210793682769204,240511,83698,
856,0.19593763686263313,24,264,592,1144,109930,7193,434139,0.03988400734856707,156813,551,0.09131187832064054,4463,1798,1217,1843,4858,12207,0.024494189081567117,2730,34,581,166,0.19353897540897405,204,8704,4,3324,5743,132,17771,5380,0.07210793682769204,240511,83698,
856,0.0037735849056603774,24,264,592,1144,109930,7193,434139,0.03988400734856707,156813,551,0.09131187832064054,4463,174,7,0,181,12207,0.024494189081567117,2730,3,167,3,0.0617582074318513,6,8704,0,3324,5743,0,17771,5380,0.07210793682769204,240511,83698,
856,0.11967080417394656,24,264,592,1144,109930,7193,434139,0.03988400734856707,156813,551,0.09131187832064054,4463,492,170,93,755,12207,0.024494189081567117,2730,54,322,331,0.18579949229621764,385,8704,0,3324,5743,277,17771,5380,0.07210793682769204,240511,83698,
856,0.11967080417394656,24,264,592,1144,109930,7193,434139,0.03988400734856707,156813,551,0.09131187832064054,4463,492,170,93,755,12207,0.024494189081567117,2730,54,322,331,0.18579949229621764,385,8704,0,3324,5743,277,17771,5380,0.07210793682769204,240511,83698,
856,0.11967080417394656,24,264,592,1144,109930,7193,434139,0.03988400734856707,156813,551,0.09131187832064054,4463,492,170,93,755,12207,0.024494189081567117,2730,54,322,331,0.18579949229621764,385,8704,0,3324,5743,277,17771,5380,0.07210793682769204,240511,83698,
856,0.11967080417394656,24,264,592,1144,109930,7193,434139,0.03988400734856707,156813,551,0.09131187832064054,4463,492,170,93,755,12207,0.024494189081567117,2730,54,322,331,0.18579949229621764,385,8704,0,3324,5743,277,17771,5380,0.07210793682769204,240511,83698,
856,0.11967080417394656,24,264,592,1144,109930,7193,434139,0.03988400734856707,156813,551,0.09131187832064054,4463,492,170,93,755,12207,0.024494189081567117,2730,54,322,331,0.18579949229621764,385,8704,0,3324,5743,277,17771,5380,0.07210793682769204,240511,83698,
856,0.11967080417394656,24,264,592,1144,109930,7193,434139,0.03988400734856707,156813,551,0.09131187832064054,4463,492,170,93,755,12207,0.024494189081567117,2730,54,322,331,0.18579949229621764,385,8704,0,3324,5743,277,17771,5380,0.07210793682769204,240511,83698,
856,0.11967080417394656,24,264,592,1144,109930,7193,434139,0.03988400734856707,156813,551,0.09131187832064054,4463,492,170,93,755,12207,0.024494189081567117,2730,54,322,331,0.18579949229621764,385,8704,0,3324,5743,277,17771,5380,0.07210793682769204,240511,83698,
856,0.11967080417394656,24,264,592,1144,109930,7193,434139,0.03988400734856707,156813,551,0.09131187832064054,4463,492,170,93,755,12207,0.024494189081567117,2730,54,322,331,0.18579949229621764,385,8704,0,3324,5743,277,17771,5380,0.07210793682769204,240511,83698,
856,0.11967080417394656,24,264,592,1144,109930,7193,434139,0.03988400734856707,156813,551,0.09131187832064054,4463,492,170,93,755,12207,0.024494189081567117,2730,54,322,331,0.18579949229621764,385,8704,0,3324,5743,277,17771,5380,0.07210793682769204,240511,83698,
856,0.11967080417394656,24,264,592,1144,109930,7193,434139,0.03988400734856707,156813,551,0.09131187832064054,4463,492,170,93,755,12207,0.024494189081567117,2730,54,322,331,0.18579949229621764,385,8704,0,3324,5743,277,17771,5380,0.07210793682769204,240511,83698,
856,0.11967080417394656,24,264,592,1144,109930,7193,434139,0.03988400734856707,156813,551,0.09131187832064054,4463,492,170,93,755,12207,0.024494189081567117,2730,54,322,331,0.18579949229621764,385,8704,0,3324,5743,277,17771,5380,0.07210793682769204,240511,83698,
856,0.11967080417394656,24,264,592,1144,109930,7193,434139,0.03988400734856707,156813,551,0.09131187832064054,4463,492,170,93,755,12207,0.024494189081567117,2730,54,322,331,0.18579949229621764,385,8704,0,3324,5743,277,17771,5380,0.07210793682769204,240511,83698,
856,0.11967080417394656,24,264,592,1144,109930,7193,434139,0.03988400734856707,156813,551,0.09131187832064054,4463,492,170,93,755,12207,0.024494189081567117,2730,54,322,331,0.18579949229621764,385,8704,0,3324,5743,277,17771,5380,0.07210793682769204,240511,83698,
856,0.11967080417394656,24,264,592,1144,109930,7193,434139,0.03988400734856707,156813,551,0.09131187832064054,4463,492,170,93,755,12207,0.024494189081567117,2730,54,322,331,0.18579949229621764,385,8704,0,3324,5743,277,17771,5380,0.07210793682769204,240511,83698,
856,0.006752954417557681,24,264,592,1144,109930,7193,434139,0.03988400734856707,156813,551,0.09131187832064054,4463,241,79,153,473,12207,0.024494189081567117,2730,6,162,6,0.1444161883094317,12,8704,0,3324,5743,0,17771,5380,0.07210793682769204,240511,83698,
856,0.006752954417557681,24,264,592,1144,109930,7193,434139,0.03988400734856707,156813,551,0.09131187832064054,4463,241,79,153,473,12207,0.024494189081567117,2730,6,162,6,0.1444161883094317,12,8704,0,3324,5743,0,17771,5380,0.07210793682769204,240511,83698,
856,0.006752954417557681,24,264,592,1144,109930,7193,434139,0.03988400734856707,156813,551,0.09131187832064054,4463,241,79,153,473,12207,0.024494189081567117,2730,6,162,6,0.1444161883094317,12,8704,0,3324,5743,0,17771,5380,0.07210793682769204,240511,83698,
856,0.006752954417557681,24,264,592,1144,109930,7193,434139,0.03988400734856707,156813,551,0.09131187832064054,4463,241,79,153,473,12207,0.024494189081567117,2730,6,162,6,0.1444161883094317,12,8704,0,3324,5743,0,17771,5380,0.07210793682769204,240511,83698,
856,0.006752954417557681,24,264,592,1144,109930,7193,434139,0.03988400734856707,156813,551,0.09131187832064054,4463,241,79,153,473,12207,0.024494189081567117,2730,6,162,6,0.1444161883094317,12,8704,0,3324,5743,0,17771,5380,0.07210793682769204,240511,83698,
856,0.006752954417557681,24,264,592,1144,109930,7193,434139,0.03988400734856707,156813,551,0.09131187832064054,4463,241,79,153,473,12207,0.024494189081567117,2730,6,162,6,0.1444161883094317,12,8704,0,3324,5743,0,17771,5380,0.07210793682769204,240511,83698,
856,0.02070902070902071,24,264,592,1144,109930,7193,434139,0.03988400734856707,156813,551,0.09131187832064054,4463,193,59,7,259,12207,0.024494189081567117,2730,2,134,2,0.11718816302522639,4,8704,0,3324,5743,0,17771,5380,0.07210793682769204,240511,83698,
856,0.155310394286756,24,264,592,1144,109930,7193,434139,0.03988400734856707,156813,551,0.09131187832064054,4463,3099,1120,2782,7001,12207,0.024494189081567117,2730,112,1979,281,0.17184781120773338,407,8704,14,3324,5743,169,17771,5380,0.07210793682769204,240511,83698,
856,0.155310394286756,24,264,592,1144,109930,7193,434139,0.03988400734856707,156813,551,0.09131187832064054,4463,3099,1120,2782,7001,12207,0.024494189081567117,2730,112,1979,281,0.17184781120773338,407,8704,14,3324,5743,169,17771,5380,0.07210793682769204,240511,83698,
856,0.155310394286756,24,264,592,1144,109930,7193,434139,0.03988400734856707,156813,551,0.09131187832064054,4463,3099,1120,2782,7001,12207,0.024494189081567117,2730,112,1979,281,0.17184781120773338,407,8704,14,3324,5743,169,17771,5380,0.07210793682769204,240511,83698,
856,0.155310394286756,24,264,592,1144,109930,7193,434139,0.03988400734856707,156813,551,0.09131187832064054,4463,3099,1120,2782,7001,12207,0.024494189081567117,2730,112,1979,281,0.17184781120773338,407,8704,14,3324,5743,169,17771,5380,0.07210793682769204,240511,83698,
856,0.155310394286756,24,264,592,1144,109930,7193,434139,0.03988400734856707,156813,551,0.09131187832064054,4463,3099,1120,2782,7001,12207,0.024494189081567117,2730,112,1979,281,0.17184781120773338,407,8704,14,3324,5743,169,17771,5380,0.07210793682769204,240511,83698,
856,0.155310394286756,24,264,592,1144,109930,7193,434139,0.03988400734856707,156813,551,0.09131187832064054,4463,3099,1120,2782,7001,12207,0.024494189081567117,2730,112,1979,281,0.17184781120773338,407,8704,14,3324,5743,169,17771,5380,0.07210793682769204,240511,83698,
856,0.155310394286756,24,264,592,1144,109930,7193,434139,0.03988400734856707,156813,551,0.09131187832064054,4463,3099,1120,2782,7001,12207,0.024494189081567117,2730,112,1979,281,0.17184781120773338,407,8704,14,3324,5743,169,17771,5380,0.07210793682769204,240511,83698,
856,0.155310394286756,24,264,592,1144,109930,7193,434139,0.03988400734856707,156813,551,0.09131187832064054,4463,3099,1120,2782,7001,12207,0.024494189081567117,2730,112,1979,281,0.17184781120773338,407,8704,14,3324,5743,169,17771,5380,0.07210793682769204,240511,83698,
856,0.155310394286756,24,264,592,1144,109930,7193,434139,0.03988400734856707,156813,551,0.09131187832064054,4463,3099,1120,2782,7001,12207,0.024494189081567117,2730,112,1979,281,0.17184781120773338,407,8704,14,3324,5743,169,17771,5380,0.07210793682769204,240511,83698,
856,0.155310394286756,24,264,592,1144,109930,7193,434139,0.03988400734856707,156813,551,0.09131187832064054,4463,3099,1120,2782,7001,12207,0.024494189081567117,2730,112,1979,281,0.17184781120773338,407,8704,14,3324,5743,169,17771,5380,0.07210793682769204,240511,83698,
856,0.155310394286756,24,264,592,1144,109930,7193,434139,0.03988400734856707,156813,551,0.09131187832064054,4463,3099,1120,2782,7001,12207,0.024494189081567117,2730,112,1979,281,0.17184781120773338,407,8704,14,3324,5743,169,17771,5380,0.07210793682769204,240511,83698,
856,0.155310394286756,24,264,592,1144,109930,7193,434139,0.03988400734856707,156813,551,0.09131187832064054,4463,3099,1120,2782,7001,12207,0.024494189081567117,2730,112,1979,281,0.17184781120773338,407,8704,14,3324,5743,169,17771,5380,0.07210793682769204,240511,83698,
856,0.2903225806451613,24,264,592,1144,109930,7193,434139,0.03988400734856707,156813,551,0.09131187832064054,4463,117,11,1,129,12207,0.024494189081567117,2730,4,106,5,0.07902190528940423,9,8704,0,3324,5743,1,17771,5380,0.07210793682769204,240511,83698,
856,0.007159763313609468,24,264,592,1144,109930,7193,434139,0.03988400734856707,156813,551,0.09131187832064054,4463,186,71,29,286,12207,0.024494189081567117,2730,3,115,4,0.16533976495970584,7,8704,0,3324,5743,1,17771,5380,0.07210793682769204,240511,83698,
856,0.007159763313609468,24,264,592,1144,109930,7193,434139,0.03988400734856707,156813,551,0.09131187832064054,4463,186,71,29,286,12207,0.024494189081567117,2730,3,115,4,0.16533976495970584,7,8704,0,3324,5743,1,17771,5380,0.07210793682769204,240511,83698,
856,0.007159763313609468,24,264,592,1144,109930,7193,434139,0.03988400734856707,156813,551,0.09131187832064054,4463,186,71,29,286,12207,0.024494189081567117,2730,3,115,4,0.16533976495970584,7,8704,0,3324,5743,1,17771,5380,0.07210793682769204,240511,83698,
856,0.007159763313609468,24,264,592,1144,109930,7193,434139,0.03988400734856707,156813,551,0.09131187832064054,4463,186,71,29,286,12207,0.024494189081567117,2730,3,115,4,0.16533976495970584,7,8704,0,3324,5743,1,17771,5380,0.07210793682769204,240511,83698,
856,0.007159763313609468,24,264,592,1144,109930,7193,434139,0.03988400734856707,156813,551,0.09131187832064054,4463,186,71,29,286,12207,0.024494189081567117,2730,3,115,4,0.16533976495970584,7,8704,0,3324,5743,1,17771,5380,0.07210793682769204,240511,83698,
856,0.007159763313609468,24,264,592,1144,109930,7193,434139,0.03988400734856707,156813,551,0.09131187832064054,4463,186,71,29,286,12207,0.024494189081567117,2730,3,115,4,0.16533976495970584,7,8704,0,3324,5743,1,17771,5380,0.07210793682769204,240511,83698,
856,0.016086651288737337,24,264,592,1144,109930,7193,434139,0.03988400734856707,156813,551,0.09131187832064054,4463,492,120,2,614,12207,0.024494189081567117,2730,6,372,1,0.12001010054088825,8,8704,1,3324,5743,-5,17771,5380,0.07210793682769204,240511,83698,
856,0.016086651288737337,24,264,592,1144,109930,7193,434139,0.03988400734856707,156813,551,0.09131187832064054,4463,492,120,2,614,12207,0.024494189081567117,2730,6,372,1,0.12001010054088825,8,8704,1,3324,5743,-5,17771,5380,0.07210793682769204,240511,83698,
856,0.016086651288737337,24,264,592,1144,109930,7193,434139,0.03988400734856707,156813,551,0.09131187832064054,4463,492,120,2,614,12207,0.024494189081567117,2730,6,372,1,0.12001010054088825,8,8704,1,3324,5743,-5,17771,5380,0.07210793682769204,240511,83698,
856,0.01098901098901099,24,264,592,1144,109930,7193,434139,0.03988400734856707,156813,551,0.09131187832064054,4463,274,142,778,1194,12207,0.024494189081567117,2730,1,132,1,0.14920486678864722,2,8704,0,3324,5743,0,17771,5380,0.07210793682769204,240511,83698,
856,0.0616701918866715,24,264,592,1144,109930,7193,434139,0.03988400734856707,156813,551,0.09131187832064054,4463,20,8,1,29,12207,0.024494189081567117,2730,8,12,20,0.0616701918866715,29,8704,1,3324,5743,12,17771,5380,0.07210793682769204,240511,83698,
856,0.0616701918866715,24,264,592,1144,109930,7193,434139,0.03988400734856707,156813,551,0.09131187832064054,4463,20,8,1,29,12207,0.024494189081567117,2730,8,12,20,0.0616701918866715,29,8704,1,3324,5743,12,17771,5380,0.07210793682769204,240511,83698,
856,0.0616701918866715,24,264,592,1144,109930,7193,434139,0.03988400734856707,156813,551,0.09131187832064054,4463,20,8,1,29,12207,0.024494189081567117,2730,8,12,20,0.0616701918866715,29,8704,1,3324,5743,12,17771,5380,0.07210793682769204,240511,83698,
856,0.020100502512562814,24,264,592,1144,109930,7193,434139,0.03988400734856707,156813,551,0.09131187832064054,4463,604,90,1,695,12207,0.024494189081567117,2730,2,514,2,0.14120658731146857,4,8704,0,3324,5743,0,17771,5380,0.07210793682769204,240511,83698,
4,0.063496007158255,1,82,-78,87,109930,7193,434139,0.02089707652636499,156813,551,0.09131187832064054,4463,583,443,61,1087,12207,0.024494189081567117,2730,67,140,3,0.18363331090615306,71,830,1,486,395,-64,1711,344,0.07744440827231028,240511,83698,
4,0.063496007158255,1,82,-78,87,109930,7193,434139,0.02089707652636499,156813,551,0.09131187832064054,4463,583,443,61,1087,12207,0.024494189081567117,2730,67,140,3,0.18363331090615306,71,830,1,486,395,-64,1711,344,0.07744440827231028,240511,83698,
4,0.063496007158255,1,82,-78,87,109930,7193,434139,0.02089707652636499,156813,551,0.09131187832064054,4463,583,443,61,1087,12207,0.024494189081567117,2730,67,140,3,0.18363331090615306,71,830,1,486,395,-64,1711,344,0.07744440827231028,240511,83698,
4,0.063496007158255,1,82,-78,87,109930,7193,434139,0.02089707652636499,156813,551,0.09131187832064054,4463,583,443,61,1087,12207,0.024494189081567117,2730,67,140,3,0.18363331090615306,71,830,1,486,395,-64,1711,344,0.07744440827231028,240511,83698,
4,0.063496007158255,1,82,-78,87,109930,7193,434139,0.02089707652636499,156813,551,0.09131187832064054,4463,583,443,61,1087,12207,0.024494189081567117,2730,67,140,3,0.18363331090615306,71,830,1,486,395,-64,1711,344,0.07744440827231028,240511,83698,
4,0.07089371980676329,1,82,-78,87,109930,7193,434139,0.02089707652636499,156813,551,0.09131187832064054,4463,156,21,173,350,12207,0.024494189081567117,2730,7,135,1,0.10993425408831482,8,830,0,486,395,-6,1711,344,0.07744440827231028,240511,83698,
4,0.07089371980676329,1,82,-78,87,109930,7193,434139,0.02089707652636499,156813,551,0.09131187832064054,4463,156,21,173,350,12207,0.024494189081567117,2730,7,135,1,0.10993425408831482,8,830,0,486,395,-6,1711,344,0.07744440827231028,240511,83698,
4,0.07089371980676329,1,82,-78,87,109930,7193,434139,0.02089707652636499,156813,551,0.09131187832064054,4463,156,21,173,350,12207,0.024494189081567117,2730,7,135,1,0.10993425408831482,8,830,0,486,395,-6,1711,344,0.07744440827231028,240511,83698,
4,0.07089371980676329,1,82,-78,87,109930,7193,434139,0.02089707652636499,156813,551,0.09131187832064054,4463,156,21,173,350,12207,0.024494189081567117,2730,7,135,1,0.10993425408831482,8,830,0,486,395,-6,1711,344,0.07744440827231028,240511,83698,
7,0.19719827586206895,0,8,-1,15,109930,7193,434139,0.019719827586206894,156813,551,0.09131187832064054,4463,136,88,20,244,12207,0.024494189081567117,2730,8,48,7,0.16858993773722591,15,444,0,122,63,-1,629,322,0.10500738631121864,240511,83698,
7,0.19719827586206895,0,8,-1,15,109930,7193,434139,0.019719827586206894,156813,551,0.09131187832064054,4463,136,88,20,244,12207,0.024494189081567117,2730,8,48,7,0.16858993773722591,15,444,0,122,63,-1,629,322,0.10500738631121864,240511,83698,
7,0.19719827586206895,0,8,-1,15,109930,7193,434139,0.019719827586206894,156813,551,0.09131187832064054,4463,136,88,20,244,12207,0.024494189081567117,2730,8,48,7,0.16858993773722591,15,444,0,122,63,-1,629,322,0.10500738631121864,240511,83698,
0,0.0,0,0,0,0,109930,7193,434139,0.0,156813,551,0.09131187832064054,4463,133,0,1,134,12207,0.024494189081567117,2730,0,133,0,0.1562815191681171,0,400,0,58,16,0,474,342,0.18236922210014228,240511,83698,
0,0.0,0,0,0,0,109930,7193,434139,0.0,156813,551,0.09131187832064054,4463,160,28,7,195,12207,0.024494189081567117,2730,0,132,0,0.1989422063354126,0,400,0,58,16,0,474,342,0.18236922210014228,240511,83698,
0,0.0,0,0,0,0,109930,7193,434139,0.0,156813,551,0.09131187832064054,4463,160,28,7,195,12207,0.024494189081567117,2730,0,132,0,0.1989422063354126,0,400,0,58,16,0,474,342,0.18236922210014228,240511,83698,
368,0.0,83,91,277,542,109930,7193,434139,0.08509874493410104,156813,551,0.09131187832064054,4463,66,44,0,110,12207,0.024494189081567117,2730,0,22,0,0.22168041209677294,0,4046,0,944,281,0,5271,3102,0.2563330903167407,240511,83698,
368,0.0,83,91,277,542,109930,7193,434139,0.08509874493410104,156813,551,0.09131187832064054,4463,66,44,0,110,12207,0.024494189081567117,2730,0,22,0,0.22168041209677294,0,4046,0,944,281,0,5271,3102,0.2563330903167407,240511,83698,
368,0.0,83,91,277,542,109930,7193,434139,0.08509874493410104,156813,551,0.09131187832064054,4463,66,44,0,110,12207,0.024494189081567117,2730,0,22,0,0.22168041209677294,0,4046,0,944,281,0,5271,3102,0.2563330903167407,240511,83698,
368,0.0,83,91,277,542,109930,7193,434139,0.08509874493410104,156813,551,0.09131187832064054,4463,66,44,0,110,12207,0.024494189081567117,2730,0,22,0,0.22168041209677294,0,4046,0,944,281,0,5271,3102,0.2563330903167407,240511,83698,
368,0.32633053221288516,83,91,277,542,109930,7193,434139,0.08509874493410104,156813,551,0.09131187832064054,4463,151,53,25,229,12207,0.024494189081567117,2730,10,98,25,0.32863523045603305,35,4046,0,944,281,15,5271,3102,0.2563330903167407,240511,83698,
368,0.32633053221288516,83,91,277,542,109930,7193,434139,0.08509874493410104,156813,551,0.09131187832064054,4463,151,53,25,229,12207,0.024494189081567117,2730,10,98,25,0.32863523045603305,35,4046,0,944,281,15,5271,3102,0.2563330903167407,240511,83698,
368,0.32633053221288516,83,91,277,542,109930,7193,434139,0.08509874493410104,156813,551,0.09131187832064054,4463,151,53,25,229,12207,0.024494189081567117,2730,10,98,25,0.32863523045603305,35,4046,0,944,281,15,5271,3102,0.2563330903167407,240511,83698,
368,0.2903244400527009,83,91,277,542,109930,7193,434139,0.08509874493410104,156813,551,0.09131187832064054,4463,262,55,66,383,12207,0.024494189081567117,2730,19,207,13,0.2824565656726959,96,4046,64,944,281,-6,5271,3102,0.2563330903167407,240511,83698,
368,0.2903244400527009,83,91,277,542,109930,7193,434139,0.08509874493410104,156813,551,0.09131187832064054,4463,262,55,66,383,12207,0.024494189081567117,2730,19,207,13,0.2824565656726959,96,4046,64,944,281,-6,5271,3102,0.2563330903167407,240511,83698,
368,0.2219298245614035,83,91,277,542,109930,7193,434139,0.08509874493410104,156813,551,0.09131187832064054,4463,669,90,23,782,12207,0.024494189081567117,2730,2,579,6,0.2107012264144799,11,4046,3,944,281,4,5271,3102,0.2563330903167407,240511,83698,
368,0.2219298245614035,83,91,277,542,109930,7193,434139,0.08509874493410104,156813,551,0.09131187832064054,4463,669,90,23,782,12207,0.024494189081567117,2730,2,579,6,0.2107012264144799,11,4046,3,944,281,4,5271,3102,0.2563330903167407,240511,83698,
368,0.1788075836395164,83,91,277,542,109930,7193,434139,0.08509874493410104,156813,551,0.09131187832064054,4463,918,125,23,1066,12207,0.024494189081567117,2730,5,793,56,0.21852699749816484,67,4046,6,944,281,51,5271,3102,0.2563330903167407,240511,83698,
368,0.15436241610738255,83,91,277,542,109930,7193,434139,0.08509874493410104,156813,551,0.09131187832064054,4463,427,181,72,680,12207,0.024494189081567117,2730,0,246,23,0.12462532458464341,23,4046,0,944,281,23,5271,3102,0.2563330903167407,240511,83698,
368,0.15436241610738255,83,91,277,542,109930,7193,434139,0.08509874493410104,156813,551,0.09131187832064054,4463,427,181,72,680,12207,0.024494189081567117,2730,0,246,23,0.12462532458464341,23,4046,0,944,281,23,5271,3102,0.2563330903167407,240511,83698,
368,0.20406112036147825,83,91,277,542,109930,7193,434139,0.08509874493410104,156813,551,0.09131187832064054,4463,299,144,24,467,12207,0.024494189081567117,2730,35,155,18,0.15513678099555847,54,4046,1,944,281,-17,5271,3102,0.2563330903167407,240511,83698,
368,0.20406112036147825,83,91,277,542,109930,7193,434139,0.08509874493410104,156813,551,0.09131187832064054,4463,299,144,24,467,12207,0.024494189081567117,2730,35,155,18,0.15513678099555847,54,4046,1,944,281,-17,5271,3102,0.2563330903167407,240511,83698,
57,0.0,32,9,48,98,109930,7193,434139,0.025146198830409354,156813,551,0.09131187832064054,4463,49,0,0,49,12207,0.024494189081567117,2730,0,49,0,0.051188982832093256,0,1288,0,338,63,0,1689,950,0.13251758284396856,240511,83698,
57,0.03333333333333333,32,9,48,98,109930,7193,434139,0.025146198830409354,156813,551,0.09131187832064054,4463,88,5,0,93,12207,0.024494189081567117,2730,1,83,1,0.14549187755961432,2,1288,0,338,63,0,1689,950,0.13251758284396856,240511,83698,
57,0.03333333333333333,32,9,48,98,109930,7193,434139,0.025146198830409354,156813,551,0.09131187832064054,4463,88,5,0,93,12207,0.024494189081567117,2730,1,83,1,0.14549187755961432,2,1288,0,338,63,0,1689,950,0.13251758284396856,240511,83698,
57,0.03333333333333333,32,9,48,98,109930,7193,434139,0.025146198830409354,156813,551,0.09131187832064054,4463,88,5,0,93,12207,0.024494189081567117,2730,1,83,1,0.14549187755961432,2,1288,0,338,63,0,1689,950,0.13251758284396856,240511,83698,
57,0.343859649122807,32,9,48,98,109930,7193,434139,0.025146198830409354,156813,551,0.09131187832064054,4463,813,270,51,1134,12207,0.024494189081567117,2730,8,543,56,0.22375999363610524,96,1288,32,338,63,48,1689,950,0.13251758284396856,240511,83698,
57,0.343859649122807,32,9,48,98,109930,7193,434139,0.025146198830409354,156813,551,0.09131187832064054,4463,813,270,51,1134,12207,0.024494189081567117,2730,8,543,56,0.22375999363610524,96,1288,32,338,63,48,1689,950,0.13251758284396856,240511,83698,
57,0.343859649122807,32,9,48,98,109930,7193,434139,0.025146198830409354,156813,551,0.09131187832064054,4463,813,270,51,1134,12207,0.024494189081567117,2730,8,543,56,0.22375999363610524,96,1288,32,338,63,48,1689,950,0.13251758284396856,240511,83698,
57,0.343859649122807,32,9,48,98,109930,7193,434139,0.025146198830409354,156813,551,0.09131187832064054,4463,813,270,51,1134,12207,0.024494189081567117,2730,8,543,56,0.22375999363610524,96,1288,32,338,63,48,1689,950,0.13251758284396856,240511,83698,
26,0.0,0,9,17,35,109930,7193,434139,0.021590622242933982,156813,551,0.09131187832064054,4463,207,10,17,234,12207,0.024494189081567117,2730,0,197,0,0.19600391592721564,0,1311,0,256,88,0,1655,1055,0.13928778097993677,240511,83698,
26,0.0,0,9,17,35,109930,7193,434139,0.021590622242933982,156813,551,0.09131187832064054,4463,207,10,17,234,12207,0.024494189081567117,2730,0,197,0,0.19600391592721564,0,1311,0,256,88,0,1655,1055,0.13928778097993677,240511,83698,
26,0.04891304347826087,0,9,17,35,109930,7193,434139,0.021590622242933982,156813,551,0.09131187832064054,4463,33,22,16,71,12207,0.024494189081567117,2730,2,11,7,0.19383238154653357,9,1311,0,256,88,5,1655,1055,0.13928778097993677,240511,83698,
26,0.0,0,9,17,35,109930,7193,434139,0.021590622242933982,156813,551,0.09131187832064054,4463,206,12,7,225,12207,0.024494189081567117,2730,0,194,0,0.16004104946257117,0,1311,0,256,88,0,1655,1055,0.13928778097993677,240511,83698,
26,0.1875,0,9,17,35,109930,7193,434139,0.021590622242933982,156813,551,0.09131187832064054,4463,272,119,28,419,12207,0.024494189081567117,2730,1,153,2,0.16190235617014168,3,1311,0,256,88,1,1655,1055,0.13928778097993677,240511,83698,
26,0.0,0,9,17,35,109930,7193,434139,0.021590622242933982,156813,551,0.09131187832064054,4463,100,1,0,101,12207,0.024494189081567117,2730,0,99,0,0.06744746554191458,0,1311,0,256,88,0,1655,1055,0.13928778097993677,240511,83698,
